>>>	S_0
importer	,importation	
mensuel	,mois	
passé	,passé	
rétablir	,rétablissement	
broyer	,broiement	,broyage	
s’endormir	,endormissement	
environnemental	,environnement	
se concentrer	,concentration	
comparatif	,comparaison	
incliner	,inclination	
cardiaque	,cœur	
festif	,fête	
suspendre	,suspension	
balayer	,balayage	
médiatique	,médias	
mimer	,mime	
Compliments	,compliment	
prêter	,prêt	
déterminer	,détermination	
provoquer	,provocation	
curial	,curé	
se coucher	,coucher	,coucher	
peindre	,peinture	
vacciner	,vaccination	
nocturne	,nuit	
ecclésial	,église	
comploter	,complot	
intégrer	,intégration	
se désertifier	,désertification	
se suicider	,suicide	
empoisonner	,empoisonnement	
aéroporter	,aéroportage	
pourrir	,pourriture	
poursuivre	,poursuite	
adapter	,adaptation	
remplacer	,remplacement	
contribuer	,contribution	
aérien	,aviation	
dire	,discours	
interroger	,interrogation	
apprendre	,apprentissage	
inspiratoire	,inspirer	
envahissement	,envahir	
céleste	,ciel	
proverbial	,proverbe	
vérifier	,vérification	
se réveiller	,réveil	
raccompagner	,raccompagnement	
maniaque	,manie	
s’étirer	,étirement	
>>>	A_2Perf
décider	,décidé	
entasser	,entassé	
élaborer	,élaboré	
obtenir	,obtenu	
détacher	,détaché	
munir	,muni	
entourer	,entouré	
aider	,aidé	
ajouter	,ajouté	,ajouté	
remplir	,rempli	
pardonner	,pardonné	
fonder	,fondé	
contraindre	,contraint	
décoration	,décoré	,décoré	
hospitaliser	,hospitalisé	
ouvrir	,ouvert	
imaginer	,imaginé	
décoller	,décollé	
amputer	,amputé	
insulter	,insulté	
gonfler	,gonflé	
diminuer	,diminué	
inonder	,inondé	
domestiquer	,domestique	
déterminer	,déterminé	
garnir	,garni	
enlever	,enlevé	,enlevé	
goudron	,goudronné	
voiler	,voilé	
réveiller	,réveillé	
éteindre	,éteint	
allonger	,couché	
abonner	,abonné	
entendre	,entendu	
nationaliser	,nationalisé	
enrouler	,enroulé	
étrangler	,étranglé	
envoi	,envoyé	
vider	,vidé	;vide	
dresser	,dressé	
voir	,vu	
disposer	,disposé	
contrainte	,contraint	
diminution	,diminué	
punir	,puni	
inscrire	,inscrit	
fendre	,fendu	
empoisonner	,empoisonné	
épouvanter	,épouvanté	
orienter	,orienté	
>>>	Syn_∩
malaise	;maladie	
insistant	,pressant	
payer	,verser	,régler	
couche	,placard	,tapis	,lit	
voleter	,voler	,voler	,flotter	
massif	,gros	
en-cas	,repas	
image	,figure	,métaphore	
allergène	,allergisant	
animalier	,animal	
s’incliner	,se pencher	
extorsion	,chantage	
salement	,comme un cochon	
tout	,entier	,complètement	,totalité	
thorax	,coffre	
intentionnel	,volontaire	
foncé	,sombre	
confectionner	,tailler	
triangle pédagogique	,triangle didactique	
y	,ici	,là	;quelque part	
céder	,laisser	
s’élever	,survenir	
créateur	,générateur	,père	
bouleverser	,bousculer	,chambarder	
douceur	,bonté	,gentillesse	
promesse	,assurance	
cochon	,salaud	
homicide	,criminel	,criminel	,crime	
poster	,envoyer	
mur	,paroi	,rideau	
autrement	,différemment	
renommé	,réputé	
verre	,coup	,coup	,pot	
endommagé	,délabré	,détérioré	
soigner	,bichonner	,traiter	
fermer	,lacer	,arrêter	,éteindre	,couper	
insulte	,injure	
particulier	,déterminé	,spécial	
sportif	,pénible	;fair-play	
manger	;s’alimenter	,se nourrir	,consommer	;se restaurer	;se mettre _N derrière la cravate	;se mettre sous la dent	,nourriture	,s’alimenter	,se nourrir	;becter	,casser la croûte	,casser la graine	;grailler	;se sustenter	,tortorer	,mordiller	,attaquer	;bouffer	;piquer	,cacher	,dissimuler	,remporter	,détériorer	;attaquer	,ronger	;éroder	;creuser	,avaler	,lécher	,mordiller	,empiéter	,avaler	,écraser	,se taper	;subir	,avaler	,utiliser	,avaler	
mafia	,famille	,club	
disparaître	,se lever	
acceptable	,tolérable	
vitesse	,rapidité	,train	
frontières	;limite	,confins	
terne	,fade	
rangement	,placard	
enlever	,ôter	,retirer	,ôter	,retirer	;quitter	;tomber	
mineur	,enfant	
silence	,mutisme	
>>>	Anti
patience	,impatience	
nez	,arrière	
avoir tort	,avoir raison	
embellir	,enlaidir	,s’enlaidir	
irresponsabilité	,responsabilité	
poli	,impoli	
amont	,aval	
égal	,inégal	
impudeur	,pudeur	
crado	,impeccable	
invraisemblable	,vraisemblable	
brancher	,débrancher	
imprécis	,précis	
ranger	,déranger	
planter	,déplanter	
impair	,pair	,pair	,pair	
gratitude	,ingratitude	
horizontalement	,verticalement	
se terminer	,commencer	
baisse	,hausse	
loin	,près	
lâche	,courageux	
lexical	,grammatical	
moins	,plus	
authentique	,inauthentique	
conscient	,inconscient	,inconscient	
définitif	,provisoire	
propre	,sale	,sale	,sale	,sale	,sale	,polluant	,sale	,sale	
éligible	,inéligible	
synonyme	,antonyme	
flexible	,inflexible	,inflexible	
stupidité	,intelligence	
désavantager	,avantager	
rapidement	,lentement	
charger	,décharger	
désenchaîner	,enchaîner	
meilleur	,pire	
indansable	,dansable	
inconscience	,conscience	,conscience	
honnêtement	,malhonnêtement	
démonter	,monter	
intérieur	,extérieur	,extérieur	
confort	,inconfort	
majuscule	,minuscule	
nouer	,dénouer	
désagréable	,agréable	
lent	,rapide	
disjoindre	,joindre	
petit	,grand	,grand	,grand	,grand	,grand	,grand	,grand	,grand	,grand	
connaissable	,inconnaissable	
>>>	Syn_⊃
ami	,petit ami	
boucher	,charcutier	,charcutier	
s’enfiler	,boire	;manger	
vieux	,père peinard	
valeur	,prix	
dilapider	,manger la grenouille	
déplacement	,transport	
lieu	,endroit	;lieu	
journaliste	,correspondant	;pigiste	;reporter	,correspondante	;pigiste	;reporter	
caca	,cigare	,colombin	
vide	,néant	
marcher	,flâner	,traîner	
liste	,catalogue	;répertoire	
apprécier	,adorer	
course à pied	,jogging	
cradingue	,dégueu	,dégueulasse	
femme politique	,politicarde	
compétition	,combat	
déception	,déconvenue	,désappointement	
s’envoyer	,boire	;manger	
plume	,écrivain	,écrivaine	
croupion	,bonnet d’évêque	
jardin	,potager	
déplacer	,attirer	,avancer	
trois-quarts	,manteau	
antenne	,capteur	,récepteur	;émetteur	
insectes	,vermine	
danser	,dansoter	
coupé	,haché	
rêve	,cauchemar	
subir	,accuser le coup	,en voir de toutes les couleurs	
prononciation	,accent	
découpage	,découpure	
trépasser	,s’éteindre	,succomber	,passer l’arme à gauche	
douzaine	,douze	
entaille	,rainure	
rémunération	,salaire	
fronts	,combat	
carte	,figure	
adopter	,voter	
refuser	,ne pas l’entendre de cette oreille	
perdre la vie	,succomber	,passer l’arme à gauche	,s’éteindre	
lumineux	;éblouissant	
requin	,squale	;chien de mer	
manche	,set	,cigare	,phallus	
commandant	,commandante	
véhicule	,véhicule flottant	,véhicule roulant	,véhicule volant	
se déplacer	,marcher	;avancer	,s’avancer	,reculer	;entrer	,progresser	,se déporter	,se décaler	,s’écarter	,glisser	;voler	,voyager	,se situer	
Corée du Sud	,Pays du Matin calme	
écharpe	,cache-nez	
>>>	S_1
poirier	,poire	
débrouillardise	,débrouillard	,débrouillarde	
police	,policier	,policière	
métro	,passager	,passagère	;voyageur	,voyageuse	,usager	,usagère	,métro	
voyager	,voyageur	,voyageuse	
rame	,papier	
stratégie	,stratège	,stratège	
adopter	,adoptant	,adoptante	
cristal	,matière	
village	,villageois	,villageoise	
courriel	;auteur	,expéditeur	,expéditrice	
jeunesse	,jeune	,jeune	
colis	,expéditeur	,expéditrice	
table	,client	,cliente	,personnel	
expérience	,expérimentateur	
appartenir	,propriété	
patins	,patineur	,patineuse	
voyage	,voyageur	,voyageuse	
fauteuil	,administrateur	
poursuivre	,poursuivant	,poursuivante	
miel	,abeille	
conception	,concepteur	,conceptrice	,concepteur	,conceptrice	
noyer	,noix	
mammifère	,mammifères	
cratère	,volcan	
crime	;auteur	,auteure	;criminel	,criminelle	,criminel	,criminelle	;auteure	,auteur	
bagué	,doigt	;main	
tombeau	,cadavre	,corps	,mort	,morte	;squelette	
commérage	,commère	,concierge	,pipelette	,bavard	
dérailler	,train	;wagon	
nettoyer	,nettoyeur	,nettoyeuse	,nettoyeur	,nettoyeuse	,nettoyant	,nettoyeur	
maladie	,malade	,malade	
signer	,signataire	
en robe des champs	,pomme de terre	
fleuve des Enfers	,mort	
posséder	,possesseur	;propriétaire	,propriétaire	
entêtement	,entêté	,entêtée	
pharmacie	,pharmacien	,pharmacienne	
accompagner	,accompagnateur	,accompagnement	
automobile	,ouvrier	,ouvrière	
doigt	,gants	
aînesse	,aînée	,aîné	
repas	,organisateur	,organisatrice	
baignade	,baigneur	,baigneuse	;nageur	,nageuse	
envelopper	,enveloppe	
diriger	,directeur	,directrice	,dirigeant	,dirigeante	,dirigeant	,dirigeante	
grimper	,plante	
enveloppe	,expéditeur	,expéditrice	,montant	,valeur	
exploiter	,exploitant	
épaule	,viande	,raquette	
>>>	A_0
intérieurement	,intérieur	
vent	,éolien	
hanches	,coxal	
ouvrière	,ouvrier	
chaud	,chaud	
schématiquement	,schématique	
également	,égal	
lessive	,lessiviel	,lessivier	,lessiviel	
continuellement	,continuel	
rythmiquement	,rhytmique	
batellerie	,batelier	
vase	,vaseux	
contradictoirement	,contradictoire	
chèrement	,cher	
souplement	,souple	
Russie	,russe	
Allemagne	,allemand	
masse	,massique	
coton	,cotonnier	
médias	,médiatique	
grandeur	,grand	
religion	,religieux	
suicidaire	,suicidaire	,suicidaire	
fleur	,floral	
futur	,futur	
proprement	,propre	,propre	,propre	,propre	,propre	
univers	,universel	
langage	,langagier	
Belgique	,belge	
Soleil	,solaire	
soir	,vespéral	
mère	,maternel	,maternel	
continûment	,continu	
graisse	,gras	
vraisemblablement	,vraisemblable	
spécialement	,spécial	
forme	,formel	,formel	
fièrement	,fier	
multiplier	,multiplicatif	
information	,informationnel	
savon	,savonnier	
islam	,islamique	
bénévolement	,bénévole	
document	,documentaire	
herbe	,herbacé	
publicité	,publicitaire	
paralytique	,paralysie	
différemment	,différent	
avocat	,avocassier	
violet	,violet	
>>>	Able_1
colère	,coléreux	,colérique	
obéir	,obéissant	
convaincre	,convaincant	
partager	,partageur	
voleur	,voleur	
attirer	,attractif	
rire	,rieur	
dormir	,somnolent	
observer	,observateur	
sale	,salissant	
mordre	,mordeur	
charité	,charitable	
combattre	,combattant	
pleurer	,pleureur	
changer	,changeant	
causer	,causant	,causeur	
résister	,résistant	
envahir	,envahissant	
incendie	,incendiaire	
aventure	,aventureux	,aventurier	
détruire	,destructif	
angoisse	,angoissé	
blague	,blagueur	
éruption	,éruptif	
bavarder	,bavard	
exiger	,exigeant	
distinguer	,distinctif	
sport	,sportif	
s’évaporer	,évaporable	
s’entêter	,têtu	<entêté	
soupçonner	,soupçonneux	
jouer	,joueur	
permettre	,permissif	
amuser	,amusant	
anxiété	,anxieux	
voyage	,voyageur	
en imposer	,imposant	
désobéir	,désobéissant	
ruse	,rusé	
alarmer	,alarmant	
casser	,cassant	
tempête	,exposé	
flamber	,inflammable	
entreprendre	,entreprenant	
pécher	,peccable	
inspirer	,inspirant	
tenter	,tentateur	;tentant	
suspecter	,suspicieux	
ramper	,rampant	,rampant	
sommeil	,somnolent	
>>>	Able_2
manger	,mangeable	,comestible	
annuler	,annulable	
contestation	,contestable	
récolter	,récoltable	
raccommoder	,raccommodable	
labourer	,labourable	,arable	
sympathie	,sympathique	,sympa	
déterminer	,déterminable	
prononcer	,prononçable	
critiquer	,critiquable	
habiter	,habitable	
décoller	,décollable	
accéder	,accessible	
vaccin	,vaccinable	
trier	,triable	
diffuser	,diffusible	,diffusable	
mesurer	,mesurable	
attraper	,attrapable	
incliner	,inclinable	
gouverner	,gouvernable	
adopter	,adoptable	
ajuster	,ajustable	
promouvoir	,promouvable	
comprendre	,compréhensible	
déplier	,dépliable	,dépliant	
explorer	,explorable	
transporter	,transportable	,transportable	
rembourser	,remboursable	
ordonner	,ordonnable	
accepter	,acceptable	
recycler	,recyclable	
glisser	,glissant	
exprimer	,exprimable	
juger	,jugeable	
libérer	,libérable	
modifier	,modifiable	
soupçonner	,soupçonnable	;suspect	
déformer	,déformable	
raconter	,racontable	
occuper	,occupable	
vélo	,cyclable	
inonder	,inondable	
scier	,sciable	
supprimer	,supprimable	
exécuter	,exécutable	
atteindre	,atteignable	
enseigner	,enseignable	
louer	;louable	
danser	,dansable	
organiser	,organisable	
>>>	Anti_∩
aventureux	,prudent	
rareté	,profusion	
coup de chaleur	,coup de froid	
jeune	,âgé	,vieux	,vieux	
fiancé	,célibataire	
émetteur	,récepteur	,capteur	
économiser	,gaspiller	
s’achever	,commencer	
confiance	,méfiance	
civil	,militaire	,religieux	
défenseur	,ennemi	
demeurer	,quitter	
idéalité	,réalité	
exigu	,spacieux	
se noyer	,avoir pied	
dénoncer	,taire	,cacher	
liquide	,gazeux	,solide	
identiquement	,différemment	
descendre	,monter	,monter	,monter	,soulever	
minuscule	,immense	,énorme	,géant	,spacieux	
fleuve	;bref	;concis	;éclair	
paralytique	,valide	
malade	,debout	,valide	
tuable	,immortel	
nager	,aller	
distant	,proche	
peu	,très	,bien	
riche	,pauvre	
en compagnie	,sans	
ivre	,sobre	
manger	,jeûner	,articuler	
toujours	,parfois	,longtemps	
aigu	,grave	
jeûner	,manger	,bouffer	
mal	,bien	,bien	,correctement	,convenablement	,honnêtement	
naître	,mourir	
couleur	,noir et blanc	
à l’abri	,sous	
léger	,gros	
méfiance	,confiance	
épouse	,célibataire	
coiffeur	,titulaire	
vert	,rouge	
se redresser	,se baisser	
joie	,tristesse	,chagrin	,peine	
partisan	,ennemi	
non	,oui	
embellie	,tempête	,tempête	
fierté	,honte	
adversaire	,ami	
>>>	V_0
se déplacer	,se déplacer	
différent	,différer	
amaigrissement	,maigrir	
placement	,placer	
surveillance	,surveiller	
coopératif	,coopérer	
tremblement	,trembler	
bagarre	,se bagarrer	,se bagarrer	
préparation	,préparer	
formation	,se former	,former	
pourriture	,pourrir	
confidence	,se confier	
prolongation	,prolonger	
désobéissance	,désobéir	
perçage	,percer	
extension	,étendre	
comparaison	,comparer	
cigare	,fumer	
reproduction	,se reproduire	,reproduire	
signification	,signifier	
examen	,examiner	
tir	,lancer	
craquement	,craquer	
louange	,louer	
considération	,considérer	
détestation	,détester	
émigration	,émigrer	
tutoiement	,tutoyer	
injure	,injurier	
hurlement	,hurler	,hurler	,hurler	
dénonciation	,dénoncer	
union	,unir	
flânerie	,flâner	
accueil	,accueillir	
défaite	,perdre	
encerclement	,encercler	
intégration	,s’intégrer	
jetage	,jeter	
recommencement	,recommencer	
dégagement	,dégager	
kidnappage	,kidnapper	
contestataire	,contester	
accélération	,s’accélérer	,accélérer	
étalage	,étaler	
présentation	,présenter	
déjeuner	,déjeuner	
administration	,administrer	,administrer	
amélioration	,améliorer	,s’améliorer	
suggestion	,suggérer	
têtu	,tête dure	
>>>	S_3
arracher	,arracheuse	
qualifier	,qualificatif	
bombarder	,bombe	,bombardier	
envoi	,destinataire	,destinataire	
accentuer	,accent	,accent	
théâtre	,public	
bus	,arrêt	
comprimé	,substance active	
cuir	,article	
exposer	,public	
payer	,paiement	
hôpital	,patient	,patiente	
boîte aux lettres	;courrier	
boulangère	,client	,cliente	
pansement	,pansement	
colis	,destinataire	,destinataire	
roi	,sujette	
apprendre	,élève	,élève	,étudiante	,étudiant	
restaurant	,clientèle	;client	,cliente	
bandit	,victime	
clinique	,soins	
vendre	,acheteur	;acheteuse	
débiteur	,dette	
député	,circonscription	
compensation	,compensation	
ministre	,gouvernement	,état	
hypermarché	,client	,cliente	,clientèle	
dieu	,culte	
détacher	,détachant	
accès	,accès	
boucher	,client	,cliente	
ordonnance	,médicament	
discuter	,sujet	,thème	
film	,acteur	,actrice	,comédien	,comédienne	
plateau	,tir	;ball-trap	
piocher	,pioche	
épicerie	,client	,cliente	
marche	,auditeur	,auditrice	
courriel	,contenu	
couleur	,poker	
procès	,affaire	
vocabulaire	,langue	
tailler	,vêtement	
bagage	,domaine	,discipline	
débitrice	,dette	
similitude	,similitude	,point commun	
compenser	,compensation	
enveloppe	,destinataire	,destinataire	,bénéficiaire	
pâtisserie	,cliente	,client	
numéroter	,numéro	
>>>	A_1
glace	,glacé	
griffes	,griffu	
drogue	,drogué	
apparaître	,apparent	;visible	
tombeau	,mort	
déclarer	,déclarant	
fortune	,fortuné	
adopter	,adoptant	
Espagnol	,espagnol	
adoration	,en	<dans	
ramper	,rampant	,rampant	
situation	,situé	
éliminer	,éliminatoire	
ivrognesse	,ivrogne	
ronger	,rongeur	
ennemi	,ennemi	
émigrer	,émigrant	
appartement	,en	
préoccuper	,préoccupant	
aggraver	,aggravant	
délinquance	,délinquant	
trembler	,tremblant	,trembleur	
saigner	,saignant	
grincer	,grinçant	
beauté	,beau	
Espagnole	,espagnol	
gazouiller	,gazouillant	,gazouilleur	
découragement	,découragé	
dent dure	,à	
insister	,insistant	
nombre	,nombreux	
laine	,laineux	
chanter	,chantant	
milliardaire	,milliardaire	,milliardaire	
pudeur	,pudique	
maladie	,malade	
orgueil	,orgueilleux	
parole	,parlant	
trébuchement	,trébuchant	
affaiblir	,affaiblissant	
égarement	,égaré	
fleurir	,fleurissant	
droitier	,droitier	
violence	,violent	
saleté	,sale	
illusoirement	,illusoire	
liquidité	,liquide	
éloge	,élogieux	
grelotter	,grelottant	
importance	,important	
>>>	S_2^prototyp
filet	,tennis	
parrain	,mafia	
pâte	,pain	,pizza	,gâteau	,tarte	,biscuit	,beignet	
bracelet	,chevilles	;poignet	
petit chien	,accouchement	
embarquer	,véhicule	
visé	,accusation	
gratter	,guitare	,gratte	
fumeuse	,cigare	,cigarette	,pipe	;tabac	
avion	,passager	,passagère	,voyageur	,voyageuse	;cargaison	,fret	
couché	,lit	,lit	
station	,bus	,métro	
boulangère	,pain	;viennoiserie	
tube	,pâte	
raquette	,tennis	
bitume	,ville	
bonbec	,sucre	
pharmacie	,médicament	
pâté	,lapin	,volaille	
porteur	,chèque	
passer	,passage	
champ	,blé	
rôti	,bœuf	,porc	
apprendre	,savoir	;discipline	
tempête	,protestation	
traite	,vache	
aéroporté	,avion	,hélicoptère	
éclairé	,lampe	
élément de langage	,politicien	,politicienne	
ceinture	,pantalon	,jupe	,robe	,manteau	,véhicule	,agglomération	
plan	,film	
vider	,poisson	,volaille	
averse	,neige	;grêle	;pluie	;cendre	
lacer	,lacet	;chaussures	,souliers	
allonger	,café	,gueule	,mine	,tête	,tronche	,visage	
cadre	,entreprise	,parti	,armée	
victime	,maladie	;accident	;catastrophe	
respirer	,air	
arrêt	,bus	
fumeur	,cigare	,cigarette	,pipe	;tabac	
fonder	,famille	
panier	,basket	
facteur	,courrier	,lettre	;colis	,paquet	,clavecin	;flûte	;orgue	;piano	
brosser	,ballon	,balle	
terre	,culture	
poitrine	,bœuf	,porc	,veau	,mouton	;poulet	,canard	,volaille	
traire	,vache	
éléments de langage	,politicien	,politicienne	
marcher	,carburant	,électricité	,vapeur	
placarder	,avis	,affiche	
>>>	Syn_⊃^sex
ostréiculteur	,ostréicultrice	
barman	,barmaid	
météorologiste	,météorologiste	
rêveur	,rêveuse	
auditeur	,auditrice	
homme politique	,femme politique	
pêcheur	,pêcheuse	
solitaire	,solitaire	
avocaillon	,avocaillonne	
lycéen	,lycéenne	
athlète	,athlète	
dévoreur	,dévoreuse	,dévoreuse	
traducteur	,traductrice	
député	,députée	
accoucheur	,accoucheuse	
xénophobe	,xénophobe	
réalisateur	,réalisatrice	
candidat	,candidate	
unijambiste	,unijambiste	
procréateur	,procréatrice	
touriste	,touriste	
salarié	,salariée	
emprunteur	,emprunteuse	
ours	,ourse	
formateur	,formatrice	
rat	,rate	
trieur	,trieuse	
truand	,truande	
batelier	,batelière	
compagnon de route	,compagne de route	
cambrioleur	,cambrioleuse	
empereur	,impératrice	
Belge	,Belge	
boxeur	,boxeuse	
coupeur de cheveux en quatre	,coupeuse de cheveux en quatre	
cousin	,cousine	
canard	,cane	
orateur	,oratrice	
auteur	,auteure	
guide	,guide	
motocycliste	,motocycliste	
compatriote	,compatriote	
pharmacien	,pharmacienne	
prince	,princesse	
soldat du feu	,soldate du feu	
chat	,chatte	
aîné	,aînée	
concertiste	,concertiste	
tueur	,tueuse	
industriel	,industrielle	
>>>	Adv_0
paternel	,paternellement	
constant	,constamment	
intelligent	,intelligemment	
régulier	,régulièrement	
pratique	,pratiquement	
mois	,mensuellement	
comparer	,comparativement	
infini	,infiniment	
danger	,dangereusement	
sérieux	,sérieusement	
géographie	,géographiquement	
temps	,temporellement	
supplément	,supplémentairement	
continuel	,continuellement	
difficile	,difficilement	
tonnerre	,dans	
partie	,partiellement	
dynamique	,dynamiquement	
pauvre	,pauvrement	
juste	,justement	
discret	,discrètement	
profession	,professionnellement	
nouveau	,nouvellement	
extraordinaire	,extraordinairement	
féroce	,férocement	
origine	,originellement	
région	,régionalement	
commercial	,commercialement	
supérieur	,supérieurement	
second	,secondement	
précis	,précisément	
continuité	,continûment	
naïveté	,naïvement	
propre	,proprement	,proprement	,proprement	,proprement	,proprement	,proprement	
démocratique	,démocratiquement	
merveilleux	,merveilleusement	
confidentiel	,confidentiellement	
prudent	,prudemment	
illusion	,illusoirement	
illisible	,illisiblement	
impeccable	,impeccablement	
père	,paternellement	
certain	,certainement	
urgent	,urgemment	
splendide	,splendidement	
cher	,chèrement	
corporel	,corporellement	
utile	,utilement	
banal	,banalement	
trompeur	,trompeusement	
>>>	Syn_⊂
pharynx	,gorge	
noyer	,tuer	
pique-nique	,repas	
lavage	,nettoyage	
maman	,mère	,mère	
se tuer	,mourir	
lieu	,lieu	
sauce	,averse	,pluie	
potager	,jardin	
nombre	,quantité	
boire	,avaler	,ingérer	,écouter	
muscle	,chair	,muscle	
écart	,distance	,espace	
saveur	,goût	
trône	,siège	,siège	
grappe	,ensemble	
fonction	,relation	
rugby	,partie	,match	
millier	,mille	
crade	,sale	
mess	,cantine	
siffler	,boire	
marcher sur la tête	,gagner	
jambe	,tige	;soutien	,appui	,support	
orthodontiste	,dentiste	,dentiste	
voltiger	,voler	
inclinaison	,position	
s’empiffrer	,manger	
crapoter	,fumer	
creux	,vide	
proximité	,distance	
sulky	,voiture	
mère	,génitrice	,procréatrice	,religieuse	,nonne	,femme	
analogue	,analogue	,équivalent	,équivalent	
deux-roues	,véhicule	,véhicule roulant	
havane	,cigare	
transport	,déplacement	
penderie	,placard	
blonde	,cigarette	
auberge	,hôtel	
éblouissant	,lumineux	,beau	
préférer	,aimer bien	
morceau	,partie	,partie	,œuvre	
socquettes	,chaussettes	
accorder	,régler	
pression	,bière	
grignoter	,manger	
balai	,baguettes	
aéronef	,véhicule	
air	,apparence	
>>>	Syn
croupe	,cul	,derrière	,panier	,arrière-train	,postérieur	,séant	,miches	,pétard	,croupion	,fessier	,popotin	,derche	,lune	
s’enlaidir	,enlaidir	
capote	,préservatif	,condom	
Saint-Père	,pape	,souverain pontife	
fringue	,vêtement	
mail	,e-mail	,courriel	
océanique	,océane	
caresser les oreilles	,frotter les oreilles	
fendard	,ben	,bénard	,falzar	,froc	,fute	,futal	,culotte	,pantalon	
margraviat	,marche	
biclo	,bécane	,biclou	,petite reine	,bicyclette	,vélo	
sèche	,cancéreuse	,cibiche	,cigarette	,clope	,garo	,tige	,schmer	
approprié	,adéquat	
pendant	,durant	
coiffeur	,coupe-tif	,merlan	
gargamelle	,gorge	,kiki	,gaviot	
toilettage	,toilette	
alto	,violon alto	
appel	,coup de téléphone	,coup de bigophone	,coup de fil	
pudeur	,pudicité	
hélicoptère	,hélico	
costard	,costume	
autobus	,bus	
mater	,daronne	,mère	
petit endroit	,petit coin	
adolescent	,ado	
dictionnaire	,dico	
père	,dab	,daron	,pater	,paternel	,Dieu	
promis	,fiancé	
poisson	,poiscaille	
aire	,superficie	
ballon rond	,football	,soccer	
rengaine	,musique	,refrain	
enfant	,gamin	,gosse	,gamine	,gosse	
en dessus	,au-dessus	
phallus	,cigare	
ripatons	,arpion	,panards	,pieds	
yogourt	,yaourt	,yaourt	
kidnappage	,kidnapping	
mignon	,mimi	
appareil téléphonique	,téléphone	
caboche	,boule	,carafe	,cigare	,crâne	,poire	,pomme	,chef	,tête	,cafetière	,ciboulot	,cigare	,cerveau	,cervelle	,crâne	,tête	
pleuvoir	,flotter	
taillage	,taille	
homo	,homosexuel	
se dégarnir	,se déplumer	
femme soldat	,soldate	,soldat	
petit-déjeuner	,petit-déj	
fiancé	,promis	
jumeau	,double	
>>>	S_1Pred
autochtone	,autochtone	,autochtone	
criminel	,crime	,crime	,crime	
timide	,timide	,timide	
lâche	,lâche	,lâche	
inconscient	,inconscient	,inconsciente	
québécois	,Québécois	,Québécoise	
tentateur	,tentateur	,tentatrice	
débrouillard	,débrouillard	,débrouillarde	
suisse	,Suisse	,Suisse	,Suissesse	
féminin	,femme	
mineur	,mineur	,mineure	
espagnol	,Espagnol	,Espagnole	
handicapé	,handicapé	,handicapée	
alcoolique	,alcoolique	
acquéreur	,acquéreur	
organique	,organisme	
myope	,myope	,myope	
veuf	,veuf	,veuve	
innocent	,innocent	,innocente	
belge	,Belge	,Belge	
cul-de-jatte	,cul-de-jatte	,cul-de-jatte	
bizarre	,bizarrerie	
millionnaire	,millionnaire	,millionnaire	
xénophobe	,xénophobe	,xénophobe	
aîné	,aîné	,aînée	
merveilleux	,merveille	
français	,Français	,Française	
femelle	,femelle	
anonyme	,anonyme	
pair	,nombre	;chiffre	
célibataire	,célibataire	,célibataire	
indiscret	,indiscret	,indiscrète	
héroïque	,héros	,héroïne	
anglais	,Anglais	,Anglaise	
agressé	,agressé	,agressée	
laid	,laid	,laide	
fouetteur	,fouetteur	,fouetteuse	
hospitalisé	,hospitalisé	,hospitalisée	
vivant	,vivant	;vivante	
arabe	,Arabe	,Arabe	
symptomatique	,symptôme	
chauve	,chauve	
victorieux	,vainqueur	
fidèle	,fidèle	
portugais	,Portugais	,Portugaise	
ordinaire	,ordinaire	
solide	,solide	
nul	,nul	,nulle	
têtu	,têtu	,têtue	<entêté	,entêtée	;cabochard	,cabocharde	,tête de mule	,tête de cochon	
pauvre	,pauvre	,pauvre	
>>>	S_2
choix	,choix	
se distraire	,distraction	
se battre	,adversaire	,adversaire	
église	,fidèle	
masse	,masse	
cheval	,cheval	
baguettes	,instrument à percussion	
contribuable	,impôt	,impôt	
guichet	,client	,cliente	
dentifrice	,dent	
dégager	,enveloppe	
graine	,semeur	
dater	,date	
durer	,durée	
jambon	,porc	
table	,client	,cliente	
promesse	,promesse	
couleur	,couleur	
nationalisme	,nation	
comprimé	,maladie	,trouble	
épicerie	,marchandise	
contenir	,contenu	
chirurgienne	,chirurgie	
visiter	,hôte	,hôte	,hôtesse	
odorat	,odeur	
tisane	,tisane	,tisane	
dimanche	,semaine	
mouche	,poisson	
messe	,fidèle	
enterrer	,mort	,morte	;cadavre	
samedi	,semaine	
défaite	,gagnant	,gagnante	;vainqueur	
maman	;enfant	
suggérer	,suggestion	
facteur	,courrier	
air	,chanteur	,chanteuse	,paroles	
bonbec	,ingrédient	
chirurgien	,chirurgie	
rajouter	,rajout	
fierté	,fierté	;objet	
parler	,langue	
otage	,ravisseur	,ravisseur	
appareiller	,bateau	
ameublement	;meuble	
pension	,pensionné	,pensionnée	
aéroport	,avion	
regret	,regret	
dette	,dette	;argent	
médecin	,patient	,patiente	,patient	,patiente	
instituteur	,élève	,élève	
>>>	S_res
entassement	,entassement	
étude	,résultat	
enquête	,résultat	,résultat	
réaliser	,réalisation	
épouvanter	,épouvante	
se décourager	,découragement	
déchirer	,déchirure	
éplucher	,épluchure	
négociation	,résultat	
enfler	,enflure	
coup de foudre	,amour	
match	,résultat	
s’éloigner	,éloignement	
s’affaiblir	,faiblesse	
constater	,constat	
vote	,résultat	
test	,résultat	
décalage	,décalage	
sondage	,résultat	
trébucher	,chute	
enfermer	,enfermement	
souffler	,souffle	
s’endormir	,sommeil	
copier	,copie	
incliner	,inclinaison	
klaxonner	,klaxon	
enrouler	,enroulement	
cracher	,crachat	
juger	,jugement	
interdire	,interdiction	
tempête	,houle	
se fracturer	,fracture	
constatation	,constat	
confondre	,confusion	
vieillir	,vieillesse	
scrutin	,résultat	
expérimentation	,résultat	
affaiblir	,faiblesse	
élection	,résultat	
doubler	,double	
examen	,résultat	
chanter	,chant	
mélanger	;mélange	
épuiser	,épuisement	
écrire	,écriture	
encadrer	,encadrement	
envelopper	,enveloppement	
caresser	,caresse	
lavis	,lavis	
s’éprendre	,amour	
>>>	S_1^usual
goûter	,goûteur	,goûteuse	
pizza	,pizzaiolo	,pizzaiola	
panser	,panseur	,panseuse	
mouton	,berger	,bergère	;éleveur	,éleveuse	
sport	,sportif	,sportive	
météo	,météorologiste	,météorologiste	,météorologue	,météorologue	
malchance	,malchanceux	,malchanceuse	
lavage	,laveur	,laveuse	
chant	,chanteur	,chanteuse	
commenter	,commentateur	,commentatrice	
sauce	,saucier	
dépanner	,dépanneur	,dépanneuse	
espionner	,espion	,espionne	
poule	,éleveur	,éleveuse	
chanter	,chanteuse	,chanteur	,chanteur	,chanteuse	
cultiver	,cultivateur	,cultivatrice	
manier	,manieur	,manieuse	
bus	,chauffeur	,conducteur	,conductrice	
réparer	,réparateur	,réparatrice	
alto	,altiste	,altiste	
museau	,arme à feu	
gueuler	,gueulard	,gueularde	
contrôler	,contrôleur	,contrôleuse	
spongieux	,éponge	
chèvre	,éleveur	,éleveuse	;chevrier	,chevrière	
s’entêter	,têtu	,têtue	<entêté	,entêtée	
station-service	,pompiste	
jardin	,jardinier	,jardinière	
karaté	,karatéka	,karatéka	,karatékate	
pleurer	,pleureur	,pleureuse	
scier	,scieur	,scieuse	
ivre	,ivrogne	,ivrognesse	
carotte	,cultivateur	,cultivatrice	
surveiller	,surveillant	,surveillante	
semoule	,semoulier	
séducteur	,séducteur	,séductrice	
tricherie	,tricheur	,tricheuse	
tambour	,joueur	,joueuse	,tambour	
taxi	,chauffeur	
se résigner	,résigné	,résignée	
balayer	,balayeuse	,balayeur	
mathématiques	,mathématicien	,mathématicienne	
skier	,skieur	,skieuse	
diagnostic	,diagnosticien	,diagnosticienne	,diagnostiqueur	,diagnostiqueuse	
volaille	,aviculteur	,avicultrice	;éleveur	,éleveuse	
rugby	;joueur	,joueuse	,rugbyman	,rugbyman	,rugbywoman	
poser	,installateur	,installatrice	
enseigner	,enseignant	,enseignante	
ail	,cultivateur	,cultivatrice	
élever	,éleveur	,éleveuse	
>>>	A_2
observer	,observé	
couleurs	,à	
exposer	,exposé	,exposé	
débat	,en	
désespérer	,désespéré	
électricité	,électrique	
s’appauvrir	,appauvrissant	
héliporter	,héliporté	
déchirer	,déchiré	
antenne	,à	,sur	,en ondes	
agresser	,agressé	
consentement	,consenti	
dominer	,dominé	
agacer	,agacé	
victoire	,vaincu	
pension	,pensionné	
air	,sur	
béton	,bétonné	
tissu	,musculaire	
éclairer	,éclairé	
miel	,mellifère	,mellifique	
suspecter	,suspect	
garnir	,garni	
plaisir	,plaisant	
éprouvé	,éprouvant	
réfléchir	,réfléchi	
parfumer	,parfumé	
Enfer	,damné	
attrait	,attrayant	
éducation	,éducateur	
surveiller	,surveillé	
exploiter	,exploité	
habitation	,habité	
bénévolat	,bénévole	
remplir	,rempli	
vents	,à	
préoccuper	,préoccupé	
accusation	,visé	,en butte	
électronique	,électronique	
épreuve	,éprouvé	
étouffer	,étouffé	
essouflé	,essouflant	
intention	,intentionnel	
lac	,noyé	
recouvrir	,recouvert	,recouvert	
exporter	,exporté	
défaite	,gagnant	;vainqueur	;victorieux	
devoir	,dû	
brûlure	,brûlé	
faute	,fautif	
>>>	S_0Pred
gentille	,gentillesse	
gratuit	,gratuité	
triste	,tristesse	
incompréhensible	,incompréhensibilité	
tenace	,tenacité	
racé	,race	
protecteur	,protection	
gourmand	,gourmandise	
objectif	,objectivité	
élastique	,élasticité	
vainqueur	,victoire	
chauve	,calvitie	
intime	,intimité	
intense	,intensité	
parfait	,perfection	
dynamique	,dynamisme	
sourd	,surdité	
égal	,égalité	
intuitif	,intuition	
traître	,trahison	
vulgaire	,vulgarité	
rare	,rareté	
étrange	,étrangeté	
discipliné	,discipline	
fluvial	,fluvialité	
généreux	,générosité	
discret	,discrétion	
grave	,gravité	
propre	,propreté	,propreté	,propreté	
disponible	,disponibilité	
statique	,statisme	
impair	,imparité	
supérieur	,supériorité	
divers	,diversité	
inconscient	,inconscience	,inconscience	
fantastique	,fantastique	
clair	,clarté	
enceinte	,grossesse	
précoce	,précocité	
impatient	,impatience	
absent	,absence	
uniforme	,uniformité	
tendre	,tendreté	
ingrat	,ingratitude	
veuf	,veuvage	
mobile	,mobilité	
optimiste	,optimisme	
rude	,rudesse	
liquide	,liquidité	
important	,importance	
>>>	S_1^prototyp
joues	,marteau	
décoller	,avion	,hélicoptère	
spirale	,cahier	
battre	,cœur	,pouls	
flocon	,laine	
skis	,motoneige	;véloski	
rideau	,boutique	,magasin	
parole	,locuteur	
serviette	,femme	
foudroyer	,éclair	
moustique	,catégorie	,poids	
maillot	,sportif	,sportive	,nageur	,nageuse	,nageur	,nageuse	
nettoyer	,nettoyeur	
reproductible	,expérience	
antennes	,insecte	
page	,livre	,carnet	,cahier	
voler	,véhicule volant	
tremper	,crime	,crime	
pendule	,horloge	
dru	,neige	,pluie	
aube	,religieux	
nager	,poisson	
soute	,bateau	
sillonner	,éclair	
objectif	,appareil photo	
soutif	,femme	
couvent	,moine	,religieux	,religieuse	
fesse	,navire	
gueule	,arme à feu	;fusil	
éléments de langage	,communicant	
pont	,bateau	
glace	,cuisinier	
majorité	,électeur	,électrice	
amputé	,membre	
pompes	,cérémonie	
escalope	,bœuf	,veau	;poulet	
coffre	,voiture	
abbaye	,religieuse	,religieux	
fusillade	,tireur	,tireuse	
cadran	,montre	
bâton	,skieur	
apprendre	,enseignant	,enseignante	,professeur	,professeure	,instituteur	,institutrice	,maître	,maîtresse	;instructeur	,instructrice	;formateur	,formatrice	
cigarette	,pantalon	;robe	;jupe	;jean	
réfléchi	,lumière	
vitaminé	,légume	
répertoire	,musicien	,musicienne	
pelouse	,parc	
messe	,prêtre	,curé	
baril	,pétrole	
dents	,scie	,fourchette	;fourche	;râteau	;peigne	
>>>	Contr
sortie	,entrée	
vouvoiement	,tutoiement	
aquatique	;aérien	
motrice	,voiture	
premier	,dernier	,dernier	
visage	,corps	
sel	,poivre	
demain	,hier	,aujourd’hui	,aujourd’hui	,hier	
analogie	,homologie	
horizontal	,vertical	
odorat	,goût	
forme	,fond	,contenu	
maritime	;aérien	
aujourd’hui	,hier	,demain	
maintenant	,après	,avant	,plus tard	
ensuite	,d’abord	
abdomen	,thorax	,thorax	
violon	,alto	,violon alto	
bruit	,silence	
volé	,voleur	
nez	,oreilles	,yeux	
théorie	,pratique	
mental	,écrit	
au revoir	,bonjour	
âme	,corps	
minuit	,midi	
double	,simple	
priser	,chiquer	
je	,tu	
atterrir	,décoller	
droit	,obligation	,devoir	
véhicule	,deux-roues	
musique	,texte	,paroles	;livret	;chorégraphie	
plaine	,colline	;vallée	
corps	,âme	,esprit	,bras	;jambes	;tête	,visage	,tête	
raison	;cœur	
couteau	,cuillère	;fourchette	
ovale	,rond	
Enfer	,paradis	;purgatoire	
tribord	,bâbord	
expliquer	,comprendre	
fellation	,cunnilingus	
grammaire	,lexique	
s’allonger	,se lever	
défendre	,attaquer	
vinaigre	,huile	
pipe	,cigare	;cigarette	
jeunesse	,vieillesse	
vanille	,chocolat	
face	,pile	
>>>	Mero
rame	,voiture	
navire	,coque	,pont	,cale	,hublot	,soute	;proue	,étrave	;poupe	,étambot	
cheveu	,naissance	;racine	;bulbe	
théâtre	,scène	
fleuve	,méandres	;amont	,aval	;embouchure	;estuaire	;bouche	;berge	,bord	,rive	
bateau	,coque	,quille	,passerelle	,pont	;cabine	,carré	,cockpit	,mess	,poste d’équipage	,écoutille	,hublot	;cale	,ballast	,soute	,mât	;cheminée	;proue	,étrave	;bord	,bâbord	,tribord	;poupe	,étambot	
rivière	,méandres	;amont	,aval	;berge	,bord	,rive	;gué	,fermoir	
colline	,bas	,pied	;flanc	,versant	;haut	<sommet	
semaine	,week-end	
banc	,dossier	,siège	
museau	,museau	
route	,chaussée	,voie	;bord	;revêtement	
avenue	,chaussée	,voie	;trottoir	
iceberg	,glace	
haricot	,haricot	,haricot	
tabouret	,pied	,siège	
thorax	;côte	
verglas	,glace	;eau	
lac	,bord	,rive	
table	,plateau	,pied	;bord	,bout	,centre	,milieu	,coin	
vinaigrette	,vinaigre	,huile	
toilette	,miroir	,table	
tramway	,tramway	
soutien-gorge	,bonnet	
cheval	,crinière	
chemise	,col	;manche	
chaise	,dossier	,patte	,siège	
cou	,gorge	,gorge	
soutif	,bonnet	
train	,locomotive	;voiture	,wagon	,essieu	,roue	,pneu	
gueule	,museau	
fleur	,pétales	
main	,dos	
volcan	,cheminée	;caldera	;flanc	,versant	;cratère	
nuage	,vapeur	
pieds	,plante	
rue	,chaussée	,voie	;trottoir	
chemin de fer	,rails	,train	,chemin de fer	
voie ferrée	,rails	
canapé	,dossier	
air	,oxygène	
nez	,bout	;dos	;narines	,trou de nez	;racine	;os	;aile	
fauteuil	,bras	,dossier	,oreilles	,patte	,pied	,siège	
abattant	,couvercle	,lunette	
siège	,dossier	,pied	,siège	
aspirateur	,brosse	,suceur	;tuyau	;sac	;fil	
avion	,aile	,hélice	,moteur	;cockpit	;siège	,ceinture	;soute	;queue	
arbre	,branche	,tronc	;feuille	,feuillage	
muscle	,fibre	;tissu	
poitrine	,lard	
>>>	Gener
coiffeuse	,métier	,profession	,meuble	
cheval	,animal	,viande	,activité	
gratitude	,sentiment	
sardine	,poisson	
bonnet	,pièce d’habillement	
baggy	,vêtement	
observer	,regarder	
étang	,plan d’eau	
mouchoir	,pièce d’habillement	
Soleil	,astre	,corps céleste	;étoile	
hippopotame	,animal	
destructeur	,appareil	
carreau	,couleur	
dégoût	,sentiment	
carburant	,substance	
éléphant	,animal	
amandier	,arbre	
mélangeur	,appareil	
sportive	,moto	;voiture	
organisme	,être vivant	
juillet	,mois	
février	,mois	
allée	,voie	
vêtement	,pièce d’habillement	,secteur	
football canadien	,sport	
meurtre	,crime	
parcelle	,quantité	
barge	,bateau	
stop	,panneau	
instrument à percussion	,instrument de musique	
spaghetti	,pâtes	
astre	,corps céleste	
huître	,mollusques	
tragédie	;œuvre	
basket	,sport	
rouge	,couleur	,boisson	
merle	,oiseau	
autocar	,véhicule	
aiguisoir	,outil	
zigzag	,forme	
loques	,vêtements	
vache de mer	,animal	
valeur	,qualité	
caoutchouc	,matière	
sport	,activité	;discipline	
patate	,légume	
cycliste	,vêtement	
flèche	,projectile	
pétrolier	,bateau	
paquet	,contenant	
>>>	S_loc
repas	,salle à manger	;cantine	;restaurant	
villageoise	,village	
poire	,poirier	
rugby	,terrain	;stade	
banane	,bananier	
basket	,terrain	
assiette	,assiette	
boxe	,ring	
framboise	,framboisier	
boulanger	,fournil	
environnement	,Terre	
cheval	;box	
football	,terrain	;stade	
diable	,Enfer	
volley-ball	,terrain	
tasse	,tasse	
rideau	,scène	
crime	,lieu	,scène	
citadine	,ville	
ananas	,ananas	
exemple	,exemplier	
corail	,mer	
raisin	,vigne	
imprimer	,imprimerie	
valises	,yeux	;visage	
thé	,théier	
abeille	,nid	,ruche	
pomme	,pommier	
couché	,lit	
cigare	,bureau de tabac	,tabac	,débit de tabac	
se laver	,salle de bain	,salle de douche	,salle d’eau	
coiffeur	,salon	
lait	,seins	
pompier	,caserne	,caserne	
melon	,melon	
voter	,bureau de vote	
lombric	,terre	
lointain	,lointain	
fleuve	<lit	
éléphant de mer	,mer	
oiseau	,nid	
vote	,urne	
emprisonné	,prison	
corps	,caserne	
Allemagne	,en	
Belgique	,en	
coton	,cotonnier	
haleine	,bouche	
amande	,amandier	
cuisine	,cuisine	
>>>	Cf
pluie	,nuage	
tête	,cou	;visage	
serviette	,nappe	,tampon	
store	,rideau	
paume	,tennis	,paume	
susceptibilité	,colère	
victime	,coupable	,coupable	
iceberg	,glaçon	
escargot	,limace	
couché	,assis	,endormi	,assis	
buisson	,arbre	
manger	,boire	
dizaine	,dix	
escabeau	,échelle	
café	,thé	,thé	
briquet	,allumette	
frère	,sœur	
tendon	,muscle	
limace	,escargot	
équerre	,règle	
sien	,mien	
gramme	,kilogramme	,kilo	;tonne	
lièvre	,lapin	
yaourt	,fromage blanc	
se lever	,s’asseoir	,se réveiller	
tampon	,serviette	
kilo	,gramme	,tonne	
prémolaire	,molaire	
un	,le	
plume	,stylo	
social	,économique	
triple	,double	,double	
bœuf	,bœuf	,vache	
soi	,moi	
évier	,lavabo	
urine	,excréments	
rivière	,voie navigable	
navire	,engin de navigation	
avoir	,être	;aller	
lavage	,rinçage	,séchage	,rinçage	,séchage	,repassage	,rinçage	,essorage	,séchage	
fête	,anniversaire	
tonne	,gramme	;kilo	,kilogramme	
muscle	,tendon	
lapin	,lièvre	
foudre	,orage	;tonnerre	
obstacle	,barrière	
abeille	,bourdon	;frelon	,guêpe	
parquet	,plancher	
timbre	,son	,cloche	
costume	,tailleur	
>>>	Mult
saucisse	,chapelet	
oiseau	,volée	
sous-vêtement	,sous-vêtement	
branche	,branchage	
journaliste	,équipe	,groupe	;horde	,meute	;équipe	,groupe	;horde	,meute	
marche	,escalier	,marches	
fibre	,tissu	
comprimé	,boîte	
arme	,armement	
employé	,personnel	
bandit	,bande	,gang	,horde	
enfant	,enfance	
banane	,régime	
skis	,paire	
fleur	,grappe	
bataille	,guerre	,conflit	
appareil	,appareillage	
vents	,ensemble	
guêpe	,colonie	,essaim	,horde	;nuage	,nuée	
homme	,humanité	
ennemi	,ennemi	
éléphant	,troupeau	
courrier	,courrier	
jambes	,paire	
mât	,mâture	
oignon	,botte	
membre	,membrure	,groupe	
musicienne	,ensemble	,groupe	
racaille	,racaille	
muscle	,musculature	
rayon	,rayonnage	
volcan	,chaîne	
jumelle	,jumelles	
outil	,outillage	
loi	,code	
corbeau	,bande	,colonie	;nuée	,bande	,colonie	;nuée	
mouton	,troupeau	,cheptel	
bœuf	,cheptel	;troupeau	;bétail	
banc	,rangée	
cheveu	,chevelure	,cheveux	,cheveu	
clé	,trousseau	,jeu	
assiette	,pile	
abeille	,colonie	,essaim	;horde	,nuage	,nuée	
chaussettes	,paire	
poisson	,banc	
patron	,patronat	
chèque	,carnet	,chéquier	
enveloppe	,paquet	
poireau	,botte	
terme	,terminologie	
>>>	Sing
outillage	,outil	
terre	,motte	
rayonnage	,rayon	
chevelure	,cheveu	
bouteille	,verre	
aviation	,avion	
membrure	,membre	
tabac	,pied	,pot	
judo	,combat	<compétition	,tournoi	<championnat	
groupe	,membre	
branchage	,branche	
mobiler	,meuble	
pharmacopée	,médicament	
champagne	,verre	
riz	,grain	
jambon	,tranche	
voirie	,voie	
ski	,championnat	,compétition	
miel	,pot	
savon	;bloc	,bout	,goutte	,morceau	,pain	,savon	
moutarde	,pot	,verre	
chemin de fer	,ligne	
feuillage	,feuille	
corolle	,pétales	
racaille	,racaille	
klaxon	,coup	
lentilles	,boîte	
marches	,marche	
glace	;glaçon	;bloc	
cheveu	,cheveu	
gendarmerie	,gendarme	,gendarme	,gendarmette	
vent	,brin	
saleté	,saleté	
sueur	,goutte	
humanité	,homme	
ping-pong	,match	,partie	,ping-pong	<compétition	,tournoi	
vin	,verre	<bouteille	
mayo	,pot	
parc	,arbre	;pelouse	;allée	
volley-ball	,match	,partie	,volley-ball	<compétition	,tournoi	<championnat	
pluie	,gouttelette	<goutte	
averse	,goutte	
mâture	,mât	
denture	,dent	
sable	,grain	
dentition	,dent	
armement	,arme	
yaourt	,pot	,yaourt	<boîte	
football	,match	,partie	,football	<compétition	,tournoi	<championnat	
terminologie	,terme	
>>>	Syn_⊂^sex
émigrée	,émigré	
Française	,Français	
clodo	,clodo	
défenseuse	,défenseur	,défenseur	,défenseur	
survivante	,survivant	
trompettiste	,trompettiste	
Arabe	,Arabe	
agressée	,agressé	
malfaitrice	,malfaiteur	
plongeuse	,plongeur	
reporter	,reporter	,reporteur	
entrepreneuse	,entrepreneur	
partenaire	,partenaire	
Russe	,Russe	
principale	,principal	
hôtesse	,hôte	
ambitieuse	,ambitieux	
folliculaire	,folliculaire	
débrouillarde	,débrouillard	
démolisseuse	,démolisseur	
vivante	,vivant	
pharmacienne	,pharmacien	
recordwoman	,recordman	
médecin	,médecin	
soldat	,soldat	
Asiatique	,Asiatique	
contradictrice	,contradicteur	
démissionnaire	,démissionnaire	
blagueuse	,blagueur	
résidante	,résidant	
responsable	,responsable	
pompier	,pompier	
enquêtrice	,enquêteur	,enquêteur	
rêveuse	,rêveur	
coopérante	,coopérant	
écolière	,écolier	
vinicultrice	,viniculteur	
veuve	,veuf	
jeune	,jeune	
employée	,employé	
factrice	,facteur	,facteur	
étudiante	,étudiant	
admiratrice	,admirateur	
cultivatrice	,cultivateur	
raconteuse	,raconteur	
correspondante	,correspondant	,correspondant	
lâche	,lâche	
kidnappeuse	,kidnappeur	
lycéenne	,lycéen	
footballeuse	,footballeur	
