>>>	S_0
diabolique	,diable	
divorcer	,divorce	
se moquer	,moquerie	
broyer	,broiement	,broyage	
se suivre	,suite	
rincer	,rinçage	
automnal	,automne	
s’endormir	,endormissement	
fondre	,fonte	
auditif	,audition	;ouïe	
douanier	,douane	
réaliser	,réalisation	,réalisation	
espérer	,espoir	,espoir	
aggraver	,aggravation	
avancer	,avancée	
universitaire	,université	
éclater	,éclatement	
moucher	,mouchage	
criminel	,crime	
pleuvoir	,pluie	
féminin	,femme	
ventral	,ventre	;ventre	
formel	,forme	,forme	
multiplier	,multiplication	,multiplication	,multiplication	
géométriquement	,géométrie	
commercial	,commerce	
éclabousser	,éclaboussement	
nasal	;nez	,nez	
s’entendre	,entente	
nouvellement	,nouveau	
travailler	,travail	,travail	
organiser	,organisation	
voter	,vote	,suffrage	
haïr	,haine	
après coup	,après-coup	
se hâter	,hâte	
oublier	,oubli	,oubli	
révéler	,révélation	
se disposer	,disposition	
pratiquement	,pratique	
pécher	,péché	
rhytmique	,rythme	
politique	,politique	,politique	,politique	
rafraîchir	,rafraîchissement	
suspendre	,suspension	
cauchemardesque	,cauchemar	
laver	,lavage	,lavage	,lavage	
se diffuser	,diffusion	
graver	,gravure	
s’affoler	,affolement	
>>>	A_2Perf
ouvrir	,ouvert	
réveiller	,réveillé	
empoisonner	,empoisonné	
contraindre	,contraint	
promettre	,promis	
allumer	,allumé	,allumé	,allumé	
autoriser	,autorisé	
étourdir	,étourdi	
appauvrir	,pauvre	
salissant	,sale	
enregistrer	,enregistré	
souligner	,souligné	
habiller	,habillé	
abonner	,abonné	
élaborer	,élaboré	
fendre	,fendu	
étrangler	,étranglé	
nettoyer	,nettoyé	,nettoyé	,nettoyé	,nettoyé	,nettoyé	,nettoyé	,nettoyé	,nettoyé	,nettoyé	,nettoyé	
envoi	,envoyé	
insulter	,insulté	
diminution	,diminué	
installer	,installé	
afficher	,affiché	
accepter	,accepté	
charger	,chargé	
voiler	,voilé	
contrainte	,contraint	
détourner	,détourné	,détourné	
écrire	,écrit	
adopter	,adoptif	
imprimer	,imprimé	
exercer	,exercé	
développer	,développé	
punir	,puni	
oublier	,oublié	
allonger	,couché	
hospitaliser	,hospitalisé	
enlever	,enlevé	,enlevé	
soulager	,soulagé	
griller	,grillé	
encercler	,encerclé	
accuser	,accusé	
soumettre	,soumis	,soumis	
inscrire	,inscrit	
domestiquer	,domestique	
disposer	,disposé	
enchaîner	,enchaîné	
entamer	,entamé	
raidir	,raide	
épuiser	,épuisé	
>>>	Syn_∩
coteau	,bord	
rebelle	,contestataire	
fleuve	,rivière	;ruisseau	,torrent	,rivière	,torrent	,vague	,forêt	;prolixe	,à rallonge	,rivière	,torrent	,lac	,mer	,flux	
chirurgien	,chirurgien-dentiste	
écologie	,univers	
baigneur	,nageur	
héliport	,aéroport	,hélistation	
se retenir	,se contenir	;s’interdire	
soigner	,bichonner	,traiter	
voler dans les plumes	,engueuler	,laver la tête	
éloquence	,conversation	;verve	
plan	,horizontal	
gauche	,maladroit	
frais	,coût	
ratiboiser	,tondre	,raser	
picoler	,s’alcooliser	
trajet	,route	,parcours	,voyage	;course	
flou	,vague	
colis	,paquet	
délivrer	,libérer	
connard	,salaud	;fumier	,ordure	,pourriture	,vache	
coup de ciseau	,suppression	
pipe	,calumet	;narguilé	
effectuer	,exécuter	,faire	
savoir	,connaître	,connaissance	
chauvinisme	,xénophobie	
rendez-vous	,rencontre	
se préoccuper	,s’intéresser	
Bonne route !	,Bon voyage!	
espionne	,antennes	,oreilles	
chef d’orchestre	,organisateur	
postérieur	,fesses	
barboter	,patauger	;nager	
fracturé	,cassé	;froissé	
dépenser	,boire	
rugissement	,hurlement	,hurlement	
page	,feuille	
jadis	,hier	
préjuger	,décider	
immensité	,vastitude	
rumeur	,bruit	,vacarme	
minet	,chat	,minou	
tout à fait	,parfaitement	
tablée	,table	
entreprendre	,se lancer	
dévastateur	,destructeur	
groupe	,club	
flot	,torrent	,pluie	
vélo d’appartement	,vélo elliptique	
habiter	,vivre	,être	
>>>	Anti
inactif	,actif	
clair	,foncé	;sombre	
méchante	,gentille	
vraisemblable	,invraisemblable	
plaire	,déplaire	
accélérer	,ralentir	,décélérer	,freiner	;ralentir	,ralentir	,retarder	
capable	,incapable	
aval	,amont	
agréable	,désagréable	
inexact	,exact	
insuccès	,succès	
dynamique	,statique	
embarrasser	,débarrasser	
meilleur	,pire	
pertinent	,impertinent	
coincer	,décoincer	
inégal	,égal	
mains sales	,mains propres	
désenfler	,enfler	
dénouer	,nouer	
importable	,exportable	
défaveur	,faveur	
ordonner	,désordonner	
à long terme	,à court terme	
décéder	,naître	
lexical	,grammatical	
dégonfler	,gonfler	,gonfler	
éloigné	,proche	,proche	
moral	,immoral	
matutinal	,vespéral	
modéré	,immodéré	
définitif	,provisoire	
trépasser	,naître	
passé	,futur	,futur	
incroyable	,croyable	
objectivité	,subjectivité	
réveillé	,endormi	
se détendre	,se contracter	
discret	,indiscret	
avoir froid	,avoir chaud	
indiscipline	,discipline	
impolitesse	,politesse	
coup de vieux	,coup de jeune	
sans	,avec	,avec	,avec	,avec	
organiser	,désorganiser	
décrocher	,accrocher	
large	,étroit	
xénophilie	,xénophobie	
malsain	,sain	
dedans	,dehors	,dehors	
>>>	Syn_⊃
fessu	,callipyge	
chibre	,cigare	,phallus	
sexe	;pénis	,verge	
similitude	;ressemblance	;analogie	;point commun	
lieu	,endroit	;lieu	
ameublement	,meuble	
criminel	,escroc	,truand	;bandit	,gangster	,voyou	
jumeau	,clone	,sosie	
volley-ball	,volley de plage	,beach-volley	,volley de plage	,beach-volley	
parlementaire	,député	,députée	
table	,restaurant	
dentiste	;stomatologue	;orthodontiste	
zob	,cigare	,phallus	
nouer	,lacer	
antenne	,capteur	,récepteur	;émetteur	
addition	,coup de fusil	
peuple	,petit peuple	
déplacement	,transport	
ennemi public	,ennemi public numéro un	
dent	,chicot	,crocs	
échec	,bide	
mille	,millier	
verge	,cigare	,phallus	
mère	,maman	,mémère	,maman	
père	,papa	,papa	,pépère	
commandant	,commandante	
fort	,assourdissant	
information	,tuyau	
tomber	,pleuvoir	
rouge	;lie-de-vin	
cap	,nez	
caca	,cigare	,colombin	
vent	,air	
cri	,rugissement	
voie	,bande de circulation	
désirer	;désirer	
punition	,savon	
météorologique	,météo	
domaine	,pré carré	
Prenez garde au chien	,Chien méchant	
distance	;écart	
flotte	,flottille	
français	,franchouillard	
détacher	,dénouer	
moineau	,cigare	,phallus	
total	,somme	
organe	,émonctoire	
foulard	,carré	
absence	,lapin	,défaut	
pistolet	,revolver	
>>>	S_1
noisetier	,noisette	
enlever	,ravisseur	
médicament	,malade	,malade	
vérifier	,vérificateur	,vérificatrice	;vérifieuse	,vérifieur	
dette	,débiteur	,débitrice	
se divertir	,divertissement	
gaspiller	,gaspilleur	,gaspilleuse	
s’évader	,évadé	,évadée	
théier	,thé	
goulot	,bouteille	
pommier	,pomme	
salon	,client	,cliente	,clientèle	
boulangerie	,boulanger	,boulangère	,boulanger	,boulangère	
crime de guerre	,criminel de guerre	
peigne	,animal	
Belgique	,Belgique	
chantier	,constructeur	,constructrice	
apprendre	,apprenant	,apprenante	,expérience	
rayon	,abeille	
corps à corps	,combat	
danser	,danseuse	,danseur	;danseur	,danseuse	
provoquer	,provocateur	,provocatrice	
parrainage	,marraine	,parrain	
Portugal	,Portugal	
rédiger	,rédacteur	,rédactrice	
crime	;auteur	,auteure	;criminel	,criminelle	,criminel	,criminelle	;auteure	,auteur	
adoptant	,adoptant	,adoptante	
pâtisserie	,pâtissière	,pâtissier	
Corée du Sud	,Corée du Sud	
hélicoptère	,pilote	
adolescence	,adolescent	,adolescente	
environner	,environnement	
piège	,piégeur	,piégeuse	
racisme	,raciste	,raciste	
semelles	,chaussures	
fleuve des Enfers	,mort	
ignorer	,ignorant	,ignorante	
tuer	,tueur	,tueuse	
protester	,protestataire	,protestataire	
protestataire	,protestataire	,protestataire	
vélo	,cycliste	,cycliste	,cycliste	,cycliste	
peau	,animal	
chien	,maître	,maîtresse	;propriétaire	,propriétaire	,tarot	
imiter	,imitateur	,imitatrice	
débit	,cours d’eau	,fleuve	,rivière	
contradiction	,contradicteur	,contradictrice	
paume	,main	,gants	
désert de cartes	,joueur	,joueuse	
cinéma	,spectateur	,spectatrice	
diffuser	,diffuseur	
>>>	A_0
textile	,textile	,textile	
nage	,natatoire	
douane	,douanier	
chat	,félin	
paternellement	,paternel	
jaune	,jaune	
chair	,charnel	
dîner	,dînatoire	,dînatoire	
urgemment	,urgent	
informatiquement	,informatique	
absolument	,absolu	
kilomètre	,kilométrique	
spécialement	,spécial	
piétonne	,piéton	,piétonnier	
ombilic	,ombilical	
matin	,matinal	,matutinal	
Soleil	,solaire	
animalité	,animal	,animal	
commercialement	,commercial	
Russie	,russe	
diversement	,divers	
bassement	,bas	
analogie	,analogique	
miracle	,miraculeux	
orageusement	,orageux	
blanc	,blanc	
réflexe	,réflexe	
tactique	,tactique	,tactique	
corporellement	,corporel	
lessive	,lessiviel	,lessivier	,lessiviel	
collège	,collégien	
préhistoire	,préhistorique	
ministre	,ministériel	
meurtre	,meurtrier	
fréquemment	,fréquent	
hexagone	,hexagonal	
contredire	,contradictoire	
institution	,institutionnel	
immensité	,immense	
autoroute	,autoroutier	
pertinemment	,pertinent	
tombe	,tombal	
marine	,marinier	
météo	,météorologique	,météo	
rudement	,rude	
illisiblement	,illisible	
père	,paternel	,paternel	
lèvres	,labial	
direction	,directeur	
évidemment	,évident	
>>>	Able_1
coopérer	,coopératif	
partager	,partageur	
changer	,changeant	
exiger	,exigeant	
inspirer	,inspirant	
anxiété	,anxieux	
agresser	,agressif	
colère	,coléreux	,colérique	
sommeil	,somnolent	
tracasser	,tracassier	
alarmer	,alarmant	
pécher	,peccable	
observer	,observateur	
tolérer	,tolérant	
écœurer	,écœurant	
casser	,cassant	
dommages	,dommageable	
oublier	,oublieux	
désobéir	,désobéissant	
dormir	,somnolent	
étouffer	,étouffant	
éruption	,éruptif	
exploser	,explosible	
causer	,causant	,causeur	
rire	,rieur	
sport	,sportif	
tenter	,tentateur	;tentant	
permettre	,permissif	
flamber	,inflammable	
compensation	,compensatoire	
bavarder	,bavard	
absorber	,absorbant	
déplacement	,mobile	
caprice	,capricieux	
bagarre	,bagarreur	
accélérer	,accélérateur	
s’enflammer	,inflammable	
crier	,criard	
sale	,salissant	
distinguer	,distinctif	
blague	,blagueur	
voleur	,voleur	
distraire	,distrayant	
inventer	,inventif	
cogner	,cogneur	
combattre	,combattant	
se soumettre	,soumis	
ramper	,rampant	,rampant	
crainte	,craintif	
convaincre	,convaincant	
>>>	Able_2
allergie	,allergène	,allergisant	
anxiété	,anxiogène	
transporter	,transportable	,transportable	
franchir	,franchissable	
constatation	,constatable	
détacher	,détachable	
adopter	,adoptable	
ordonner	,ordonnable	
supprimer	,supprimable	
élire	,éligible	
pardonner	,pardonnable	
recycler	,recyclable	
imiter	,imitable	
améliorer	,améliorable	
absorber	,absorbable	
scier	,sciable	
décrire	,descriptible	
mesurer	,mesurable	
douter	,douteux	
manger	,mangeable	,comestible	
récolter	,récoltable	
calcul	,calculable	
exporter	,exportable	
acheter	,achetable	
décoller	,décollable	
digérer	,digérable	
nettoyer	,nettoyable	,nettoyable	,nettoyable	,nettoyable	
communication	,communicable	
maîtriser	,maîtrisable	
défendre	,défendable	
attaquer	,attaquable	
éviter	,évitable	
administrer	,administrable	,administrable	
labourer	,labourable	,arable	
traverser	,traversable	
analyser	,analysable	
réaliser	,réalisable	
calculer	,calculable	
prouver	,prouvable	
connaissance	,connaissable	
vacciner	,vaccinable	
exécuter	,exécutable	
supposer	,supposable	
multiplier	,multipliable	
exploiter	,exploitable	
contrôler	,contrôlable	
juger	,jugeable	
détruire	,destructible	,destructible	
distribuer	,distribuable	
réalisation	,réalisable	,réalisable	
>>>	Anti_∩
contraste	,analogie	,analogie	,similarité	
s’initer	,arrêter	
honnêtement	,mal	
noir et blanc	,couleur	
fragilement	,solidement	
étrangère	,autochtone	
quitter l’habit	,prendre la robe	
ignorance	,connaissance	
coiffeur	,titulaire	
frêle	,solide	
célibat	,couple	
élargissement	,rétrécissement	
clarté	,obscurité	
debout	,assis	,couché	,couché	,délabré	;détérioré	;endommagé	,couché	,horizontalement	,malade	,assis	,couché	
honte	,fierté	
angoissant	,rassurant	
demeurer	,quitter	
toujours	,parfois	,longtemps	
veste	,victoire	
analogie	,différence	,contraste	;opposition	,contradiction	,différence	,dissemblance	,contraste	;dissimilarité	
ami	,ennemi	;époux	,mari	,adversaire	,opposant	,comme chien et chat	
épouse	,célibataire	
déplacé	,convenable	,comme il faut	
aventureux	,prudent	
coup d’arrêt	,coup d’accélérateur	
déjà	,enfin	
marcher	,décliner	
mourir	,naître	
nationaliser	,privatiser	
prendre la robe	,quitter l’habit	
remplaçant	,titulaire	
nager	,aller	
liquide	,gazeux	,solide	
se découvrir	,se cacher	
comme chien et chat	,ami	
flexible	,têtu	
encadrer	,désencadrer	
étranger	,autochtone	
allusivement	,franchement	
convenablement	,mal	,incorrectement	
protecteur	,ennemi	
accélérer	,ralentir	
se noyer	,avoir pied	
se fermer	,s’ouvrir	
naître	,mourir	
fort	,faible	
coup d’accélérateur	,coup d’arrêt	
sûr de son coup	,hésitant	
couleur	,noir et blanc	
personne	,chacun	
>>>	V_0
arrachage	,arracher	
condition	,conditionner	
pompage	,pomper	
effaçage	,effacer	
manque	,manquer	
aide	,aider	
sculptural	,sculpter	
tranchage	,trancher	
insulte	,insulter	
râlement	,râler	
abonnement	,abonner	
invention	,inventer	
empoisonnement	,empoisonner	
pesée	,peser	
attentat	,attenter	
ronflements	,ronfler	
démolition	,démolir	
retrait	,retirer	
dépliement	,déplier	
lavage de cerveau	,laver le cerveau	
règlement	,régler	
jonction	,joindre	
export	,exporter	
consentement	,consentir	,consentir	
inspiration	,inspirer	,inspirer	
prière	,prier	
autorisation	,autoriser	
sortie	,sortir	
pilotage	,piloter	
agacement	,s’agacer	
virage	,virer	
enculage de mouches	,enculer les mouches	
dispute	,se disputer	
amusement	,amuser	
peinture	,peindre	
imaginatif	,imaginer	
mouvement	,bouger	,se mouvoir	
vrombissement	,vrombir	
abus	,abuser	
attendrissement	,s’attendrir	,attendrir	
jeûne	,jeûner	
modification	,modifier	
démontage	,démonter	
interrogation	,interroger	
tintement	,tinter	
critique	,critiquer	,critiquer	
récompense	,récompenser	
commerce	,commercer	
croissance	,croître	;grandir	
traitement	,traiter	
>>>	S_3
bouchère	,client	,cliente	
bijouterie	,client	,cliente	
numéroter	,numéro	
député	,circonscription	
habiller	,habits	,vêtements	
accusation	,objet	;motif	
boîte aux lettres	;courrier	
cirer	,cire	
décharger	,chargement	
tirage	,tirage	
tailler	,vêtement	
film	,acteur	,actrice	,comédien	,comédienne	
empoisonner	,poison	
remplaçant	,compétition	
qualifier	,qualificatif	
différence	,différence	
analogie	,analogie	,point commun	
clinique	,soins	
autopsie	,résultat	
addition	,client	,cliente	
expédier	,destinataire	,destinataire	
charcuterie	,client	,cliente	
dater	,date	,datage	
différer	,différence	
plein	,véhicule	
facture	,client	,cliente	
comprimé	,substance active	
cuir	,article	
timbre	,colis	;enveloppe	,lettre	
papeterie	,papier	
compte	,banque	
travailler	,employeur	,employeuse	,patron	,patronne	;employeur	
armer	,arme	;armement	
améliorer	,amélioration	
panser	,pansement	
hypermarché	,client	,cliente	,clientèle	
course	,taxi	;fiacre	
colis	,destinataire	,destinataire	
bagage	,domaine	,discipline	
administrable	,administrateur	
admiration	,objet	,source	
piocher	,pioche	
théâtre	,public	
procès	,affaire	
louer	,locataire	,locataire	
fusil	,projectile	,balle	,plomb	
enveloppe	,destinataire	,destinataire	,bénéficiaire	
bombarder	,bombe	,bombardier	
bandit	,victime	
conversation	,sujet	,thème	
>>>	A_1
monstre	,monstrueux	
parité	,pair	
allergie	,allergique	
admiration	,transporté	<soulevé	,rempli	,admiratif	<plein	,en	
goût	,sapide	;à	
détruire	,destructeur	
correction	,correct	
vieillir	,vieillissant	
trébucher	,trébuchant	
parole	,parlant	
saleté	,sale	
dents longues	,à	
équilibre	,en	
s’appuyer	,appuyé	
construire	,constructeur	
glace	,glacé	
majorité	,majeur	
appartement	,en	
pêcher	,pêcheur	
se disposer	,disposé	
admirer	,admiratif	
perturber	,perturbateur	
désert	,désert	
Grec	,grec	
survivre	,survivant	
lenteur	,lent	
encombrer	,encombrant	
mécontentement	,mécontent	
exploser	,explosif	
consentir	,consentant	
pauvreté	,pauvre	
affaiblir	,affaiblissant	
saigner	,saignant	
tambour	,à	
désinteressement	,désinteressé	
nuage	,nuageux	
concert	,en	
hâte	,hâtif	
barbe	,barbu	
liberté	,libre	
banalité	,banal	
gêner	,gênant	
supplier	,suppliant	
douche	,sous	
merveille	,merveilleux	
déclarer	,déclarant	
venger	,vengeur	,vengeur	
éblouir	,éblouissant	
dégoûter	,dégoûtant	
gonfler	,gonflant	
>>>	S_2^prototyp
tramway	,terminus	
vestiaire	,cliente	,client	
jambe	,porc	;bœuf	
joue	,bœuf	
traire	,vache	
peindre	,peinture	
envoi	,colis	,lettre	
prier	,Dieu	
ébloui	,lumière	
amputer	,membre	
élève	,enseignant	,enseignante	,professeur	,professeure	,maître	,maîtresse	,instituteur	,institutrice	;prof	,prof	,instit	,instit	,enseignant	,enseignante	,professeur	,professeure	,maître	,maîtresse	,instituteur	,institutrice	,prof	,prof	,instit	,instit	
pharmacie	,médicament	
avion	,passager	,passagère	,voyageur	,voyageuse	;cargaison	,fret	
dresser	,table	,table	
nager	,eau	
fibre	,muscle	,tissu	
conducteur	,voiture	,véhicule	,automobile	,moto	,auto	,autobus	,autocar	,bus	,camion	,car	,métro	,train	,tramway	
siège	,ville	
balayer	,nuage	
piste	,aéroport	
respirer	,air	
assis	,siège	,fauteuil	,chaise	
infirmerie	,patient	,patiente	,malade	,malade	
machine à coudre	,tissu	
traite	,vache	
éclairé	,lampe	
boucher	,viande	
battre	,adversaire	,adversaire	,compétitrice	,compétiteur	;record	
métro	,terminus	
visé	,accusation	
dans	,habit	,vêtement	
tabac	,tabac	
parapluie	,pluie	
s’allonger	,lit	
théâtre	,accident	;drame	
parc	,se promener	,courir	;promenade	,jogging	
péage	,autoroute	
paille	,boisson	
chaussée	,véhicule roulant	,véhicule	
mobiler	,pièce	
station	,bus	,métro	
lire	,livre	;magazine	
piloter	,avion	,avionnette	,hélicoptère	,auto	,automobile	,voiture	;bateau	
tablette	,chocolat	
rôti	,bœuf	,porc	
casque	,ordinateur	,télévision	,baladeur	
fromage	,brebis	,chèvre	,vache	
pâte	,pain	,pizza	,gâteau	,tarte	,biscuit	,beignet	
tube	,pâte	
passement	,bras	;jambes	
>>>	Syn_⊃^sex
futé	,futée	
messager	,messagère	
joggeur	,joggeuse	
riche	,riche	
pigiste	,pigiste	
anormal	,anormale	
chien	,chienne	,chienne	
marcheur	,marcheuse	
médecin-expert	,médecin-expert	
crémier	,crémière	
vêto	,véto	
journaliste	,journaliste	
inventeur	,inventrice	
fournisseur	,fournisseuse	
analyste	,analyste	
ébéniste	,ébéniste	
meilleur	,meilleure	
campagnard	,campagnarde	
reporter	,reporter	,reportrice	
célibataire	,célibataire	
chômeur	,chômeuse	
consommateur	,consommatrice	
laveur	,laveuse	
solitaire	,solitaire	
vieillard	,vieillarde	
comédien	,comédienne	
riverain	,riveraine	
président	,présidente	,présidente	
docteur	,docteure	,docteure	,doctoresse	
médecin-conseil	,médecin-conseil	
animateur	,animatrice	,animatrice	
provocateur	,provocatrice	
arrivant	,arrivante	
avocat	,avocate	,avocate	
muet	,muette	
émigrant	,émigrante	
citateur	,citatrice	
blagueur	,blagueuse	
contribuable	,contribuable	
immigré	,immigrée	
serveur	,serveuse	
pensionné	,pensionnée	
dessinateur	,dessinatrice	
dormeur	,dormeuse	
patient	,patiente	
fugitif	,fugitive	
couturier	,couturière	
passionné	,passionnée	
imaginatif	,imaginative	
hospitalisé	,hospitalisée	
>>>	Adv_0
facile	,facilement	
haut	,haut	
torrentiel	,torrentiellement	
miel	,mielleusement	
lamentable	,lamentablement	
poésie	,poétiquement	
probable	,probablement	
ingratitude	,ingratement	
précis	,précisément	
trompeur	,trompeusement	
prudent	,prudemment	
curieux	,curieusement	
fier	,fièrement	
impeccable	,impeccablement	
précoce	,précocement	
vaste	,vastement	
héros	,héroïquement	
insuffisance	,insuffisamment	
territoire	,territorialement	
extrême	,extrêmement	
stratégie	,stratégiquement	
obligatoire	,obligatoirement	
national	,nationalement	
entier	,entièrement	
hygiénique	,hygiéniquement	
intuition	,intuitivement	
cruel	,cruellement	
bien	,bien	
injuste	,injustement	
origine	,originellement	
géométrie	,géométriquement	
commencer	,depuis	
sinistre	,sinistrement	
constance	,constamment	
véritable	,véritablement	
commercial	,commercialement	
étrange	,étrangement	
humble	,humblement	
intérieur	,intérieurement	
agréable	,agréablement	
individu	,individuellement	
merveilleux	,merveilleusement	
gratuit	,gratuitement	
intense	,intensément	
anonyme	,anonymement	
nature	,naturellement	
rapide	,rapidement	
vif	,vivement	,vivement	,vivement	
assurer	,assurément	
sérieux	,sérieusement	
>>>	Syn_⊂
trop	,beaucoup	
bâtiment	,construction	
vendre	,céder	
récupérer	,prendre	
coup de tabac	,tempête	
boucher	,meurtrier	
maîtresse	,propriétaire	,maître	,enseignante	
acheminer	,transporter	
brune	,cigarette	
se fendre la pipe	,rire	
guéable	,traversable	,franchissable	
géométrique	,régulier	
avancer	,se déplacer	,placer	
bac	,récipient	
cache-nez	,écharpe	
balai	,baguettes	
mère	,génitrice	,procréatrice	,religieuse	,nonne	,femme	
se goinfrer	,manger	
rugby	,partie	,match	
se remettre	,se mettre	
engager	,mettre	
équipe	,groupe	
endroit	,lieu	
crachin	,pluie	
manger dans la même écuelle	,partager	
stupéfier	,étonner	
goûter	,manger	,bouffer	
frusques	,vêtements	
défaut	,absence	
sprinter	,courir	,coureur	
finir	,consommer	
objet	,chose	,machin	
quart-temps	,période	
véhiculer	,transporter	
rond de jambe	,mouvement	
baguettes	,baguette	
grésil	,averse	
affreux	,moche	
coup double	,victoire	
ski de piste	,skis	,ski	
marché	,accord	
flottille	,flotte	
bavarde	,robinet	
bouse	,excréments	
rabattre	,déplacer	
couloir	,passage	
en ce moment	,maintenant	
enrhumé	,malade	
s’éteindre	,mourir	,décéder	,disparaître	,périr	,perdre la vie	,casser sa pipe	,clamser	,crever	,trépasser	
narine	;orifice	;conduit	
>>>	Syn
tocante	,montre	
rugbywoman	,rugbyman	
hélicoptère	,hélico	
travailler	,bosser	
grande boucle	,Tour de France	
pucier	,paddock	,pageot	,pieu	,plumard	,lit	
petit endroit	,petit coin	
réfrigérateur	,frigidaire	,frigo	
musico	,musicien	
table de chevet	,table de nuit	
alcoolisme	,alcool	,boisson	
gamin	,gosse	,enfant	
fleurissement	,floraison	
valoche	,valise	
nez	,blair	,blase	,nase	,naseaux	,pif	,tarin	,odorat	,olfaction	
planche à repasser	,table à repasser	
pendant	,durant	
bague	,bagouse	
bourricot	,bourriquet	,bourrique	,âne	,baudet	
se dégarnir	,se déplumer	
lave-pont	,balai-brosse	
de la tête aux pieds	,de la nuque aux orteils	
plantation	,plantage	
ancêtre	,aïeul	,aïeule	
travail	,emploi	
perdre	,paumer	
estudiantin	,étudiant	
cannes	,jambes	,gambettes	,guibolles	,pattes	
vide	,désert	
petit-déjeuner	,petit-déj	
tente	,guitoune	
lolos	,nénés	,nibards	,nichons	,roberts	,roploplos	,seins	
photocopieur	,photocopieuse	
jogging	,survêtement	,survêt	
cigare	,boule	,caboche	,carafe	,crâne	,poire	,pomme	,chef	,tête	,caboche	,cafetière	,ciboulot	,cerveau	,cervelle	,crâne	,tête	,phallus	,colombin	
angoisser	,s’angoisser	
colimaçon	,limaçon	,escargot	
cabinet d’aisances	,commodités	,lieux d’aisances	,cabinets	,petit coin	,pipi-room	,tinettes	,tartisses	
croupion	,cul	,derrière	,panier	,arrière-train	,postérieur	,séant	,miches	,pétard	,croupe	,fessier	,popotin	,derche	,lune	
volley de plage	,beach-volley	,beach-volley	
aire	,superficie	
poule	,cocotte	
robinet	,zizi	
labo	,laboratoire	
petit coin	,cabinets	,pipi-room	,tinettes	,tartisses	,cabinet d’aisances	,commodités	,lieux d’aisances	,petit endroit	
planète rouge	,Mars	
modif	,modification	
expirer	,mourir	
turlute	,pipe	,pompier	,fellation	
automobile	,auto	,voiture	,bagnole	,caisse	,auto	
>>>	S_1Pred
féminin	,femme	
arabe	,Arabe	,Arabe	
coupable	,coupable	,coupable	
têtu	,têtu	,têtue	<entêté	,entêtée	;cabochard	,cabocharde	,tête de mule	,tête de cochon	
imbécile	,imbécile	,imbécile	
puni	,punie	
bon	,bon	
italien	,Italien	,Italienne	
vivant	,vivant	;vivante	
lâche	,lâche	,lâche	
infirme	,infirme	,infirme	
tentateur	,tentateur	,tentatrice	
espagnol	,Espagnol	,Espagnole	
solide	,solide	
symptomatique	,symptôme	
organique	,organisme	
mort	,mort	,morte	
impair	,nombre	;chiffre	
mauvais	,mauvais	
aveugle	,aveugle	,aveugle	
timide	,timide	,timide	
autochtone	,autochtone	,autochtone	
veuf	,veuf	,veuve	
aîné	,aîné	,aînée	
merveilleux	,merveille	
végétarien	,végétarien	,végétarienne	
cul-de-jatte	,cul-de-jatte	,cul-de-jatte	
myope	,myope	,myope	
américain	,Américain	,Américaine	
titulaire	,titulaire	
bizarre	,bizarrerie	
mâle	,mâle	
faible	,faible	
original	,original	,original	
européen	,Européen	,Européenne	
célibataire	,célibataire	,célibataire	
jeune	,jeune	,jeune	
suisse	,Suisse	,Suisse	,Suissesse	
vieux	,vieux	,vieille	
protestant	,protestant	,protestante	
gentil	,gentil	,gentille	
russe	,Russe	,Russe	
français	,Français	,Française	
fouetteur	,fouetteur	,fouetteuse	
femelle	,femelle	
ordinaire	,ordinaire	
héroïque	,héros	,héroïne	
adulte	,adulte	,adulte	
laid	,laid	,laide	
ingrat	,ingrat	,ingrate	
>>>	S_2
exploité	,exploitant	
menuisière	,meuble	
dimanche	,semaine	
malade	,maladie	,maladie	
combat	,adversaire	,adversaire	
se prénommer	,prénom	
emploi	,employé	,employée	;salarié	,salariée	
entreprendre	,entreprise	
autocar	,passager	,passagère	,usager	,usagère	,voyageur	,voyageuse	
sinistre	,sinistré	,sinistrée	
chiffre	,nombre	,chiffre	
exiger	,exigence	
adoration	,objet	
gagner	,gain	,argent	,compétition	
camion	,fret	,chargement	,cargaison	
miracle	,miraculé	,miraculée	
orgueil	;objet	
cauchemar	,cauchemar	
honte	,honte	
produit	,facteur	
aîné	;cadette	,puînée	,puîné	,cadet	
s’occuper	,occupation	
tisser	,réseau	;lien	
courir	,marathon	,course	,rallye	,danger	,risque	,péril	
week-end	,semaine	
parler	,langue	
guichet	,client	,cliente	
réalisateur	,film	
ambulancière	,ambulance	
appartenir	,propriétaire	,propriétaire	
baguettes	,instrument à percussion	
ressentir	,émotion	,sentiment	;sensation	
charcuterie	,charcuterie	
député	,électeur	,électrice	
animer	,antenne	
se diriger	,direction	
voiture	,passager	,passagère	,passager	,passagère	,voyageur	,voyageuse	,occupant	,occupante	;cargaison	,chargement	;marchandise	
protecteur	,protégé	
bétail	,éleveur	,éleveuse	
éplucheuse	,légume	
hériter	,héritage	
mère	;enfant	,congrégation	;couvent	
car	,passager	,passagère	,usager	,usagère	;voyageur	,voyageuse	
mercredi	,semaine	
crime	,victime	,victime	
suspecter	,suspect	,suspecte	
plateau	,fusil	;carabine	
papa	;enfant	
thermomètre	,température	
enlever	,victime	
>>>	S_res
décaler	,décalage	
dessiner	,dessin	;figure	
élection	,résultat	
caresser	,caresse	
muscler	,muscles	
orienter	,orientation	
s’éloigner	,éloignement	
mélanger	;mélange	
vote	,résultat	
s’endormir	,sommeil	
envelopper	,enveloppement	
trouer	,trou	
chanter	,chant	
entasser	,entassement	
s’éprendre	,amour	
condamner	,condamnation	
juger	,jugement	
se décaler	,décalage	
vieillir	,vieillesse	
lavis	,lavis	
tournoi	,résultat	
cracher	,crachat	
se décourager	,découragement	
doubler	,double	
arranger	,arrangement	,arrangement	
tomate	,tomate	
souffler	,souffle	
décalage	,décalage	
s’affaiblir	,faiblesse	
gonfler	,gonflage	
sondage	,résultat	
enquête	,résultat	,résultat	
épouvanter	,épouvante	
se fracturer	,fracture	
incliner	,inclinaison	
constater	,constat	
affaiblir	,faiblesse	
épuiser	,épuisement	
étourdir	,étourdissement	
effort	,résultat	
scrutin	,résultat	
tempête	,houle	
réaliser	,réalisation	
examen	,résultat	
s’enrhumer	,rhume	
blesser	,blessure	
évaluation	,résultat	
course	,résultat	
klaxonner	,klaxon	
se déplacer	,déplacement	
>>>	S_1^usual
rugby	;joueur	,joueuse	,rugbyman	,rugbyman	,rugbywoman	
jouer	,musicien	,musicienne	,musicien	,musicienne	
montrer	,montreur	,montreuse	
cuisiner	,cuisinier	,cuisinière	
jugeable	,juge	
fournir	,fournisseur	,fournisseuse	
planer	,oiseau	
photo	,photographe	
coiffage	,coiffeur	,coiffeuse	
ambulance	,ambulancière	,ambulancier	
pois	,cultivateur	,cultivatrice	
agneau	,éleveur	,éleveuse	
guichet	,guichetier	,guichetière	
papeterie	,papetier	
sardine	,sardinier	
colère	,coléreuse	,coléreux	,colérique	,colérique	
cheval	,éleveur	,éleveuse	
former	,formateur	,formatrice	
skier	,skieur	,skieuse	
saucisse sèche	,charcutier	,charcutière	
judo	,judoka	,judoka	,judokate	
porc	,éleveur	,éleveuse	;porcher	,porchère	
pensionné	,pensionné	,pensionnée	
autocar	,chauffeur	,conducteur	,conductrice	
voiture	,cocher	
chou	,cultivateur	,cultivatrice	
volley-ball	;joueur	,joueuse	,volleyeur	,volleyeuse	
camping	,campeur	,campeuse	
étourderie	,étourdi	,étourdie	
anxiété	,anxieux	,anxieuse	
exagérateur	,exagérateur	,exagératrice	
chirurgie	,chirurgien	,chirurgienne	
caricature	,caricaturiste	,caricaturiste	
ail	,cultivateur	,cultivatrice	
poulet	,éleveur	,éleveuse	
mine	,mineur	
se résigner	,résigné	,résignée	
cloche	,sonneur	
roue	,véhicule	
nettoyeur	,nettoyeur	,nettoyeuse	
balayer	,balayeuse	,balayeur	
volaille	,aviculteur	,avicultrice	;éleveur	,éleveuse	
raccommoder	,raccommodeur	,raccommodeuse	
goudron	,goudronneur	
éplucher	,éplucheur	,éplucheuse	
ivre	,ivrogne	,ivrognesse	
savonneux	,savon	
coiffer	,coiffeur	,coiffeuse	
découper	,découpeur	,découpeuse	
violent	,violent	
>>>	A_2
dominer	,dominé	
sinistre	,sinistré	
électronique	,électronique	
plaisir	,plaisant	
électricité	,électrique	
bénévolat	,bénévole	
surveiller	,surveillé	
conservation	,conservé	
miracle	,miraculé	
origine	,originaire	
découragement	,décourageant	
étouffer	,étouffé	
entretenir	,entretenu	
savoir	,su	,su	
serrer	,serré	
suspecter	,suspect	
épreuve	,éprouvé	
exposer	,exposé	,exposé	
désirer	,désirable	
attrait	,attrayant	
composer	,composé	
air	,sur	
lac	,noyé	
Enfer	,damné	
éducation	,éducateur	
éblouir	,ébloui	
vents	,à	
habitude	,habituel	
essouflé	,essouflant	
pension	,pensionné	
raisonner	,raisonné	
exploiter	,exploité	
remplir	,rempli	
supplément	,supplémentaire	
tissu	,musculaire	
poison	,empoisonné	
exercer	,exercé	
éclairer	,éclairé	
cercueil	,mort	
parfumer	,parfumé	
déchirer	,déchiré	
livrer	,livrable	
intention	,intentionnel	
occupation	,occupé	
connaître	,connu	
réfléchir	,réfléchi	
désespérer	,désespéré	
considération	,considéré	
brûlure	,brûlé	
habitation	,habité	
>>>	S_0Pred
cruel	,cruauté	
chaud	,chaleur	
nu	,nudité	
blanc	,blancheur	
probable	,probabilité	
fréquent	,fréquence	
compliqué	,complication	
ambigu	,ambiguïté	,ambiguïté	
xénophobe	,xénophobie	
débrouillard	,débrouillardise	
élégant	,élégance	,élégance	
méchant	,méchanceté	
extrême	,extrême	
fragile	,fragilité	
uniforme	,uniformité	
autonome	,autonomie	
facile	,facilité	
idéal	,idéalité	
célibataire	,célibat	
régulier	,régularité	
bas	,bassesse	
frais	,fraîcheur	,fraîcheur	
hypocrite	,hypocrisie	
vrai	,vérité	
similaire	,similarité	
sale	,saleté	,saleté	
timide	,timidité	
patient	,patience	
difficile	,difficulté	
triangulaire	,triangle	
talentueux	,talent	
tiède	,tiédeur	
abattu	,abattement	
réel	,réalité	
chagrin	,chagrin	
vraisemblable	,vraisemblance	
voluptueux	,volupté	
vengeur	,vengeance	
pair	,parité	
riche	,richesse	
possible	,possibilité	
accessible	,accessibilité	
solide	,solidité	,solidité	
orgueilleux	,orgueil	
tranquille	,tranquilité	
idiot	,idiotie	
parfait	,perfection	
indépendant	,indépendance	
ridicule	,ridicule	
alcoolique	,alcoolisme	
>>>	S_1^prototyp
lacet	,chaussures	,souliers	
haut-parleur	,téléviseur	;radio	
tempête	,neige	;vent	;grêle	;pluie	
paragraphe	,texte	
soutif	,femme	
dru	,neige	,pluie	
roulement	,tambour	
seins	,femme	
abdiquer	,empereur	,souverain	,roi	,monarque	
paupière	,judas	;œilleton	
au torchon	,cuisson	;jambon	
fenêtre	,enveloppe	
remboursable	,dette	
toilette	,boucher	,bouchère	,boucher-charcutier	,bouchère-charcutière	,cuisinier	,cuisinière	
corps	,professeur	,professeure	;enseignant	,enseignante	;fonctionnaire	,fonctionnaire	;médecin	,médecin	,état	,doctrine	;théorie	,vin	;liqueur	
déplier	,membre	,membre	
versant	,colline	;montagne	;vallée	
gueule	,arme à feu	;fusil	
jupe	,voiture	,automobile	,voiture	,wagon	,locomotive	
spirale	,cahier	
mouche	,catégorie	,poids	
sonneur	,cloche	
griffu	,patte	
gros dos	,chat	,chatte	
nuage	,pluie	;neige	;grêle	,lait	;crème	,point	;mot	
rue	,sans domicile fixe	;clochard	,clocharde	
sillonner	,éclair	
galop	,cheval	
cabine	,bateau	
serviette	,femme	
dents	,scie	,fourchette	;fourche	;râteau	;peigne	
tampon	,femme	
courant	,fleuve	,rivière	,ruisseau	
dent	,feuille	;timbre	
escale	,bateau	,avion	
reproductible	,expérience	
menu	,entrée	,plat	,dessert	
coude	,cours d’eau	
vitaminé	,légume	
répertoire	,musicien	,musicienne	
abbaye	,religieuse	,religieux	
rage	,chien	
poil	,tapis	,brosse	,pinceau	,pinceau	
fruit	,arbre	,plante	
analogie	,organe	
pompes	,cérémonie	
hélice	,avion	;bateau	
page	,livre	,carnet	,cahier	
flaque	,eau	
parole	,locuteur	
>>>	Contr
cœur	,pique	,trèfle	
R.E.R	,métro	
vouvoiement	,tutoiement	
nord	,sud	
grenier	,cave	
violon alto	,violon	
nombre	,genre	
graisse	;muscle	;muscles	
là	;ailleurs	
pain	,brioche	
masculin	,féminin	
monarchie	,démocratie	,république	,démocratie	
bruit	,silence	
violon	,alto	,violon alto	
ramper	,marcher	
acidité	,douceur	
bonjour	,au revoir	
chanter	,parler	
matin	,soir	
cigare	,cigarette	;pipe	
dernier	,premier	,premier	
nuage	,soleil	
analogique	,numérique	
Mademoiselle	,Madame	
cuillère	,couteau	,fourchette	
tribord	,bâbord	
mental	,écrit	
silence	,bruit	
bouche	,gorge	
esclave	,maître	
droit	,obligation	,devoir	
éliminatoire	,finale	
Corée du Nord	,Corée du Sud	
flore	,faune	
poitrine	,dos	
nationalement	,internationalement	
caca	,pipi	
se coucher	,se lever	
après-demain	,avant-hier	
est	,ouest	,ouest	
midi	,minuit	
dernière	,première	
couteau	,cuillère	;fourchette	
théorie	,pratique	
ennemi	,allié	
décoller	,atterrir	
longueur	,largeur	,hauteur	,profondeur	
maison	,appartement	
nez	,oreilles	,yeux	
immigrer	,émigrer	
>>>	Mero
train	,locomotive	;voiture	,wagon	,essieu	,roue	,pneu	
avenue	,chaussée	,voie	;trottoir	
banc	,dossier	,siège	
rue	,chaussée	,voie	;trottoir	
trottoir	,bateau	
voie ferrée	,rails	
rame	,voiture	
table	,plateau	,pied	;bord	,bout	,centre	,milieu	,coin	
autoroute	,chaussée	,voie	,bande de circulation	;bande d’arrêt d’urgence	;péage	;entrée	,sortie	
toilette	,miroir	,table	
cheveu	,naissance	;racine	;bulbe	
jambes	,chevilles	;mollets	;genou	;cuisses	;pieds	
cheval	,crinière	
balai	,manche	,pommeau	
W.-C.	,siège	,trône	,cuvette	,lunette	,abattant	,couvercle	
week-end	,samedi	,dimanche	
gorge	,gosier	,gorge	
théâtre	,scène	
rivière	,méandres	;amont	,aval	;berge	,bord	,rive	;gué	,fermoir	
haricot	,haricot	,haricot	
désert	,sable	,pierre	
seins	,bout	
soutien-gorge	,bonnet	
route	,chaussée	,voie	;bord	;revêtement	
nez	,bout	;dos	;narines	,trou de nez	;racine	;os	;aile	
vinaigrette	,vinaigre	,huile	
soutif	,bonnet	
chemise	,col	;manche	
escargot	,coquille	;antennes	
bateau	,coque	,quille	,passerelle	,pont	;cabine	,carré	,cockpit	,mess	,poste d’équipage	,écoutille	,hublot	;cale	,ballast	,soute	,mât	;cheminée	;proue	,étrave	;bord	,bâbord	,tribord	;poupe	,étambot	
tramway	,tramway	
glaçon	,glace	
métro	,rame	,métro	;métro	,station	,quai	;voie	
colline	,bas	,pied	;flanc	,versant	;haut	<sommet	
siège	,dossier	,pied	,siège	
voiture	,moteur	,réservoir	;coffre	;volant	,tableau de bord	,pédale	;siège	,ceinture	;roue	,train	,compartiment	;siège	,couchette	,brancard	,essieu	,roue	,marchepied	
aspirateur	,brosse	,suceur	;tuyau	;sac	;fil	
verglas	,glace	;eau	
navire	,coque	,pont	,cale	,hublot	,soute	;proue	,étrave	;poupe	,étambot	
fleuve	,méandres	;amont	,aval	;embouchure	;estuaire	;bouche	;berge	,bord	,rive	
nuage	,vapeur	
arbre	,branche	,tronc	;feuille	,feuillage	
volcan	,cheminée	;caldera	;flanc	,versant	;cratère	
abattant	,couvercle	,lunette	
chemin de fer	,rails	,train	,chemin de fer	
thorax	;côte	
rayon	,alvéole	
avion	,aile	,hélice	,moteur	;cockpit	;siège	,ceinture	;soute	;queue	
semaine	,week-end	
air	,oxygène	
>>>	Gener
mécanicienne	,ouvrière	
bar	,poisson	
cousin	,parent	
croquenots	,chaussures	
merlan	,animal	
mollusques	,classe	,espèce	,famille	;animal	
juin	,mois	
gros chat	,fauves	
caravane	,véhicule	
alcool à brûler	,alcool	
table	,meuble	,meuble	
avenue	,voie	
bière	,boisson	,boisson	
additionneur	,dispositif	
carabine	,arme à feu	
éléphant de mer	,animal	
former	,créer	
jambon	,charcuterie	
treize	,nombre	,équipe	
bavardage	,échange verbal	
Corse	,île	
drakkar	,bateau	
maladie de la vache folle	,maladie	
paquebot	,bateau	
éléphanteau	,animal	
manteau	,vêtement	,vêtement	
gruyère	,fromage	
vache de mer	,animal	
juillet	,mois	
bottes	,chaussures	
voie rapide	,voie	
rouge	,couleur	,boisson	
grippe	,maladie	
pantalon	,vêtement	
commandant	,officier	
oiseau des tempêtes	,oiseau	
rate	,animal	,rongeur	
médaille	,bijou	
grande boucle	,compétition	;épreuve	
rue	;voie	
réservoir	,récipient	
lézard	,reptile	
oranger	,arbre	
épinards	,légume	
trompettiste	,musicien	
mammifères	,classe	,espèce	,famille	;ordre	;animal	
ruisseau	,cours d’eau	
R.E.R	,réseau	
carton	,matière	
astre	,corps céleste	
>>>	S_loc
orange	,oranger	
haleine	,bouche	
vache	,étable	,vacherie	
douche	;douche	,salle de douche	,salle de bain	
volley-ball	,terrain	
fleuve	<lit	
cadavre	,cercueil	,bière	
vote	,urne	
cigare	,bureau de tabac	,tabac	,débit de tabac	
abeille	,nid	,ruche	
sandwich	,sandwicherie	
boxe	,ring	
prune	,prunier	
coton	,cotonnier	
coiffeur	,salon	
aube	,matin	
bandit	,repaire	
basket	,terrain	
banane	,bananier	
valises	,yeux	;visage	
enterrer	,cimetière	
gendarme	,gendarmerie	
mère	,couvent	
clémentine	,clémentinier	
père	,couvent	
rideau	,scène	
villageoise	,village	
camper	,camping	
guêpe	,nid	,guêpier	
éléphant de mer	,mer	
assiette	,assiette	
repas	,salle à manger	;cantine	;restaurant	
couché	,lit	
figure	,dans	,en plein	
karaté	,tapis	,tatami	;dojo	,salle	
thé	,théier	
ananas	,ananas	
diable	,Enfer	
oiseau	,nid	
olive	,olivier	
coiffeuse	,salon	
corail	,mer	
fraise	,fraisier	
tasse	,tasse	
bœuf	,étable	
imprimer	,imprimerie	
course	,champ de course	
crime	,lieu	,scène	
rugby	,terrain	;stade	
melon	,melon	
>>>	Cf
seins	,fesses	
plume	,stylo	
le	,un	
manger	,boire	
patins	,chaussons	
paume	,tennis	,paume	
évier	,lavabo	
nœud papillon	,cravate	
grenouille	,crapaud	
susceptibilité	,colère	
allonger	,asseoir	
se lever	,s’asseoir	,se réveiller	
s’échauffer	,muscle	
drap	,couverture	
muscle	,tendon	
fromage blanc	,yaourt	
excréments	,urine	
rivière	,voie navigable	
moutarde	,ketchup	;mayonnaise	
analogie	,métaphore	
chevilles	,pieds	;mollets	
gelée royale	,miel	
fa	,do	,ré	,mi	,sol	,la	,si	
direction	,destination	
majorité	,unanimité	
aller	;avoir	,être	
tête	,cou	;visage	
tonne	,gramme	;kilo	,kilogramme	
kilo	,gramme	,tonne	
bouton	,bourgeon	
short	,pantalon	
porte-monnaie	,portefeuille	
géranium	,pélargonium	
pâtisserie	,viennoiserie	
averse	,orage	;ciel	
course	,marche	
feu	,fumée	
volant	,guidon	,aérien	
tendon	,muscle	
avoir	,être	;aller	
avocate	,juriste	
debout	,réveillé	
dizaine	,dix	
ici	,maintenant	
gorge	,ventre	
source	,eau	
abeille	,bourdon	;frelon	,guêpe	
frère	,sœur	
assis	,couché	,couché	
processus	,évènement	
>>>	Mult
volcan	,chaîne	
assiette	,pile	
navire	,flotte	,flottille	
siège	,rangée	
oignon	,botte	
skis	,paire	
mât	,mâture	
membre	,membrure	,groupe	
oiseau	,volée	
jour	,semaine	<mois	,mois	
vache	,troupeau	;cheptel	
poireau	,botte	
paysanne	,paysannat	,paysannerie	
cliente	,clientèle	
outil	,outillage	
branche	,branchage	
avion	;flotte	
dent	,dentition	,denture	,dentelure	
carte	,jeu	
ennemi	,ennemi	
patron	,patronat	
gendarme	,gendarmerie	
tabouret	,rangée	
pin	,pinède	,pineraie	,pinière	
saleté	,saleté	
verre	,bouteille	
jumelle	,jumelles	
pompier	,caserne	,caserne	
sous-vêtement	,sous-vêtement	
loup	,bande	,horde	,meute	
chaise	,rangée	
lettre	,correspondance	
jambes	,paire	
bataille	,guerre	,conflit	
ministre	,gouvernement	,ministère	,cabinet	
touche	,clavier	
feuille	,feuillage	,papier	
fiche	,fichier	
pétales	,corolle	
radis	,botte	
chaussures	,paire	
terme	,terminologie	
bœuf	,cheptel	;troupeau	;bétail	
punaise	,colonie	
cerise	,poignée	
comprimé	,boîte	
fruit	,grappe	
chaussons	,paire	,paire	
banc	,rangée	
jumeau	,jumeaux	
>>>	Sing
chevelure	,cheveu	
football	,match	,partie	,football	<compétition	,tournoi	<championnat	
correspondance	,lettre	
judo	,combat	<compétition	,tournoi	<championnat	
lentilles	,boîte	
tarte	,part	
neige	,flocons	;boule	
mayo	,pot	
membrure	,membre	
racaille	,racaille	
toison	,cheveu	
mois	,semaine	<jour	
billard	,jeu	,partie	
pelage	,poil	
tissu	,cellule	;fibre	
sport	,compétition	;tournoi	<championnat	
bouteille	,verre	
lessive	,cuillère	,dose	,poignée	;dosette	,pastille	<baril	,boîte	
alcool	,verre	<bouteille	
denture	,dent	
parc	,arbre	;pelouse	;allée	
musculature	,muscle	
pain	,miette	<bout	,morceau	,tranche	
marches	,marche	
volley-ball	,match	,partie	,volley-ball	<compétition	,tournoi	<championnat	
cheval	,compétition	
ping-pong	,match	,partie	,ping-pong	<compétition	,tournoi	
rayonnage	,rayon	
raisin	,grain	
crime	,crime	;crime	
gendarmerie	,gendarme	,gendarme	,gendarmette	
glace	;glaçon	;bloc	
moutarde	,pot	,verre	
saucisson	,rondelle	
sel	,grain	
klaxon	,coup	
chemin de fer	,ligne	
savon	;bloc	,bout	,goutte	,morceau	,pain	,savon	
maladie	,crise	
vent	,brin	
mobiler	,meuble	
guerre	,bataille	
feuillage	,feuille	
mayonnaise	,pot	
karaté	,combat	<compétition	,tournoi	<championnat	
laitue	,feuille	
ski	,championnat	,compétition	
sable	,grain	
sueur	,goutte	
riz	,grain	
>>>	Syn_⊂^sex
ajusteuse	,ajusteur	
rugbyman	,rugbyman	
karatékate	,karatéka	
rêveuse	,rêveur	
petite	,petit	
imaginative	,imaginatif	
infirme	,infirme	
tenniswoman	,tennisman	
titulaire	,titulaire	
délinquante	,délinquant	
vilaine	,vilain	
enquêtrice	,enquêteur	,enquêteur	
écologiste	,écologiste	
commandante de bord	,commandant de bord	
conceptrice	,concepteur	
passante	,passant	
pisseuse de copie	,pisseur de copie	
camarade	,camarade	
portraitiste	,portraitiste	
propriétaire	,propriétaire	
protestataire	,protestataire	
lycéenne	,lycéen	
générale	,général	
machiniste	,machiniste	,machiniste	
avocate	,avocat	,avocat	
agricultrice	,agriculteur	
pianiste	,pianiste	
jument	,cheval	
riveraine	,riverain	
députée	,député	
collégienne	,collégien	
fugitive	,fugitif	
Française	,Français	
sans-emploi	,sans-emploi	
xénophobe	,xénophobe	
familière	,familier	
étrangleuse	,étrangleur	
modeste	,modeste	
basketteuse	,basketteur	
exposante	,exposant	
soldat	,soldat	
sans-abri	,sans-abri	
amie	,ami	,ami	,ami	
parachutiste	,parachutiste	
émigrante	,émigrant	
pocharde	,pochard	
artisane	,artisan	
anxieuse	,anxieux	
habitante	,habitant	
gueularde	,gueulard	
