>>>	Syn_∩
filer	,partir	,administrer	,allonger	,balancer	,coller	,flanquer	,ficher	,foutre	,asséner	,donner	,envoyer	,lancer	
coup de moins bien	,faiblesse	
se sustenter	,manger	;s’alimenter	,se nourrir	;se restaurer	;tortorer	;becter	;bouffer	;casser la croûte	,casser la graine	;grailler	
alors	,donc	,par conséquent	,du coup	,si bien	,ben	,Eh bien	
répandu	,courant	
tristesse	,chagrin	;cafard	,déprime	;mélancolie	,mélancolie	
tourner le dos	,se retourner	,partir	,quitter	,abandonner	,abandonner	,ignorer	
infection	,contamination	
en connaissance de cause	,à ses risques et périls	,consciemment	
passer	,séjourner	,enfiler	,mettre	,endosser	,aller	,se rendre	,s’écouler	,cesser	,virer	,se présenter	,dépasser	;franchir	,traverser	,faire	,mettre	
protéger	,garantir	,abriter	
vexer	,heurter	,blesser	
vecteur	,véhicule	
fauteuil	,poste	,siège	;fonction	
mathématiques	;géométrie	;algèbre	
terminal	,final	,gare	
plateau-repas	,plateau	,repas	;panier-repas	
retenu	,étouffé	,contenu	
se mouiller	,s’impliquer	
couche	,placard	,tapis	,lit	
se succéder	,se suivre	,se suivre	,se suivre	
Bourse	,marché	
rouleau	,cylindre	,vague	,mouton	
lever le cœur	,écœurer	
tapis de plage	,paillasse	
en mettre des tartines	,tartiner	,en faire des tartines	;exagérer	
commode	,rangement	
se séparer	,se scinder	,divorcer	
sans encombre	,facilement	
chanteur	,voix	
voile	,bateau	,étoffe	,nappe	,mystère	
minet	,chat	,minou	
en éveil	,attentif	
grondement	,grognement	
foulure	,entorse	
avoir les fesses qui démangent	,s’agiter	
rencontre	;tête-à-tête	;entretien	,conversation	,entrevue	,dialogue	,discussion	,meeting	,réunion	
s’amaigrir	,maigrir	
clos	,fermé	
en rythme	,en musique	
buanderie	,blanchisserie	
orage	,pluie	,averse	;grêle	;tempête	,nuages	,tourmente	<tempête	<ouragan	
obturer	,boucher	
symétrique	,réciproque	
ranger	,classer	,classer	,aligner	;disposer	
réellement	,vraiment	
dispense	,dérogation	
part	,morceau	,parcelle	,partie	
hypnotisme	,hypnose	
de toute façon	,de toute manière	,quelque part	
coup d’éclat	,coup de théâtre	
président	,chef d’état	
magicienne	,sorcière	
partisan	,ami	
dynastie	,maison	
lit de mort	,agonie	
navette	,fusée	
taille	,dimension	,longueur	
nombril	,centre	
hachoir	,tranchoir	
chez	,à	
égarer	,dérouter	
déchirer	,hanter	,tourmenter	
sur pied	,debout	,valide	,bien	,debout	,levé	
autrement	,différemment	
disgracieux	,laid	,ingrat	
se détourner	,se retourner	,se tourner	
se présenter	,venir	
accéder	,arriver	,atteindre	,se rendre	,arriver	,atteindre	,obtenir	,se connecter	,accepter	,aller	,correspondre	,s’accorder	
rayonnage	,étagère	
se déterminer	,se décider	,décider	,se résoudre	
lieu commun	;poncif	;banalité	;cliché	,stéréotype	
coopérant	,coopératif	
transpirer	,suer	
menu	,petit	,mince	,carte	
ivre	,saoul	,blindé	,cuité	<bourré	,pinté	<beurré	,rond	,plein	,pété	,torché	,déchiré	,raide	,arraché	,transporté	,rempli	
énoncé	,expression	
comptant	,rubis sur l’ongle	
bras droit	;collaborateur	
expliciter	,expliquer	,exposer	
boule-de-neige	,obier	
diable	,démon	
flasque	,tombant	;mou	
commérage	,clabaudage	,potin	,racontar	,ragot	
champagne	,beige	
téléphonage	,appel	
dos crawlé	,dos	,dos brassé	;crawl	,brasse	,brasse-papillon	,nage indienne	
Il y a une limite à tout.	,Il y a des limites.	;Il ne faut pas exagérer.	;Assez !	;Ça suffit.	
signaliser	,marquer	
descendre	,tomber	
testament	,legs	,dernières volontés	
manufacture	,usine	
devise	,formule	,monnaie	
grosso modo	,environ	
pelage	,manteau	,épluchage	
entre deux chaises	,le cul entre deux chaises	
imparfait	,incomplet	
pinceau	,technique	,faisceau	
nageur	,baigneur	
échauffer les oreilles	,casser les oreilles	,rebattre les oreilles	;agacer	
>>>	S_0
tactilement	,toucher	
brachial	,bras	
numéroter	,numérotation	,numérotage	
commencer	,commencement	
ronger	,rongement	
contester	,contestation	
vestimentaire	,vêtements	
semer	,semis	
religieux	,religion	
ralentir	,ralentissement	
recycler	,recyclage	
se radicaliser	,radicalisation	
vouvoyer	,vouvoiement	
hypothétiquement	,hypothèse	
embarquer	,embarquement	
établir	,établissement	
recommander	,recommandation	
s’affaiblir	,affaiblissement	
passer à tabac	,passage à tabac	
huppé	,huppe	
rétablir	,rétablissement	
vérifier	,vérification	
jaillir	,jaillissement	
chasser	,chasse	
abandonner	,abandon	
sexuellement	,sexe	,sexe	
atomique	,atome	
chanter	,chant	,chant	,chant	
universitaire	,université	
dormir	,somme	,sommeil	,sommeil	,léthargie	,torpeur	,sommeil	
distinguer	,distinction	
déboucher	,débouchage	
matraquer	,matraquage	
s’enrouler	,enroulement	
abdiquer	,abdication	,abdication	
tergiverser	,tergiversation	
compatir	,compassion	
louvoyer	,louvoiement	
chatouille	,chatouiller	
bactérien	,bactérie	
râper	,râpage	
rock	,rock	
aplatir	,aplatissement	,aplatissage	
s’adapter	,adaptation	
alphabétique	,alphabet	
sucrer	,sucrage	
monopoliser	,monopole	
sauter	,saut	
amuser	,amusement	
comparatif	,comparaison	
esthétique	,esthétique	
honnêtement	,honnêteté	
abaisser	,abaissement	
raï	,raï	
fermier	,ferme	
garantir	,garantie	
abonner	,abonnement	
féliciter	,félicitations	
percer	,perçage	
sahélien	,Sahel	
palmaire	,paume	
gris	,gris	
bronzer	,bronzette	
boulimique	,boulimie	,boulimie	
familial	,famille	,famille	
ascétique	,ascèse	,ascète	
environnemental	,environnement	
bilanter	,bilan	,bilan	
dire	,discours	
rhumatismal	,rhumatisme	
poursuivre	,poursuite	
dépendre	,dépendance	
naturellement	,nature	
prier	,prière	
essentiel	,essentiel	,essence	
jeûner	,jeûne	
gendarmesque	,gendarme	,gendarme	,gendarmette	
envoyer	,envoi	
fuchsia	,fuchsia	,rose fuchsia	
explorer	,exploration	
s’accorder	,accord	
fournir	,fourniture	
rétrécir	,rétrécissement	,rétrécissement	
natatoire	,natation	
habiter	,habitation	
augmenter	,augmentation	
adapter	,adaptation	
lyonnais	,Lyon	
interrompre	,interruption	
carcéral	,prison	
relationnel	,relation	
décoller	,décollage	,décollage	
jeter	,jet	,jetage	
diaboliquement	,diable	
thoracique	,thorax	
détourner	,détournement	,détournement	
équivaloir	,équivalence	
bancaire	,banque	
rassembler	,rassemblement	
dictatorial	,dictature	
>>>	A_2Perf
soumettre	,soumis	,soumis	
élargir	,élargi	
licencier	,licencié	
goudronner	,goudronné	
restreindre	,restreint	
déchirer	,déchiré	
écrire	,écrit	
envoi	,envoyé	
étirer	,étiré	
écarter	,écarté	
enfoncer	,enfoncé	
développer	,développé	
charger	,chargé	
lisser	,lissé	
salissant	,sale	
emprisonner	,emprisonné	
enchaîner	,enchaîné	
éplucher	,épluché	
décaler	,décalé	,décalé	
afficher	,affiché	
inonder	,inondé	
tordre	,tordu	
laver	,lavé	,lavé	
clouer	,cloué	,cloué	,cloué	,cloué	
imaginer	,imaginé	
déconnecter	,déconnecté	
accentuer	,accentué	,accentué	,accentué	
enfermer	,enfermé	
habiller	,habillé	,habillé	
remplir	,rempli	,rempli	
vaincre	,vaincu	
insulter	,insulté	
définir	,défini	
lacer	,lacé	
épouvanter	,épouvanté	
rabattre	,rabattu	
attacher	,attaché	
décorer	,décoré	,décoré	
déterminer	,déterminé	
se casser	,cassé	
griller	,grillé	
nationaliser	,nationalisé	
convaincre	,convaincu	
fâcher	,fâché	
baser	,basé	
boucher	,bouché	
retraitement	,retraité	
souligner	,souligné	
fendre	,fendu	
animer	,animé	,animé	
enflammer	,enflammé	
extraire	,extrait	
avertir	,averti	
dégoûter	,dégoûté	
entendre	,entendu	
diminuer	,diminué	
enterrer	,enterré	,enterré	
abonner	,abonné	
coudre	,cousu	
ajouter	,ajouté	,ajouté	
explorer	,exploré	
décourager	,découragé	
ouvrir	,ouvert	
enrouler	,enroulé	
brosser	,brossé	,brossé	
entourer	,entouré	
adopter	,adoptif	
hacher	,haché	
détacher	,détaché	
voiler	,voilé	
réaliser	,réalisé	
bourrer	,bourré	
approvisionner	,approvisionné	
voler	,volé	
éloigner	,éloigné	
diplômer	,diplômé	
prénommer	,prénommé	
élaborer	,élaboré	
sécher	,sec	
aérer	,aéré	
lever	,levé	,debout	,levé	,levé	,levé	,levé	
accepter	,accepté	
nettoyer	,nettoyé	,nettoyé	,nettoyé	,nettoyé	,nettoyé	,nettoyé	,nettoyé	,nettoyé	,nettoyé	,nettoyé	
emprunter	,emprunté	
plier	,plié	
déplacer	,déplacé	
abandonner	,abandonné	
accuser	,accusé	
affaiblir	,affaibli	
user	,usé	
domestiquer	,domestique	
décoller	,décollé	
inscrire	,inscrit	
meubler	,meublé	
enlever	,enlevé	,enlevé	
recouvrir	,recouvert	
exposer	,exposé	
blesser	,blessé	
défaire	,défait	,défait	
fonder	,fondé	,fondé	
>>>	Anti
nulle part	,quelque part	
régresser	,progresser	
ingouvernable	,gouvernable	
continu	,discontinu	
maladroit	,adroit	,adroit	
enchaîner	,désenchaîner	
mobile	,immobile	
rentrer	,sortir	
connaissable	,inconnaissable	
politesse	,impolitesse	
arrêter	,démarrer	,commencer	,continuer	
malheureusement	,heureusement	
dénationaliser	,nationaliser	
y	,en	
occupé	,inoccupé	,libre	,inoccupé	
trépasser	,naître	
minuscule	,majuscule	
déficitaire	,bénéficiaire	
manqué	,réussi	
ouvert	,fermé	,fermé	
infranchissable	,franchissable	
monter	,descendre	
matutinal	,vespéral	
décoincer	,coincer	
accusation	,défense	
méchant	,gentil	
dedans	,à l’extérieur	,dehors	,dehors	
avec	,sans	,sans	,sans	,sans	
se désengager	,s’engager	
confirmé	,débutant	
malheur	,bonheur	
inabouti	,abouti	
commode	,incommode	
valide	,invalide	,invalide	
joindre	,disjoindre	
dernier	,prochain	
coincer	,décoincer	
ci-dessus	,ci-dessous	
hypertrophié	,atrophié	
tôt	,tard	,tard	
lentement	,rapidement	
sauvage	,domestique	,domestique	
maladresse	,adresse	
aller	,retour	,retour	
correct	,incorrect	
additionner	,soustraire	
provisoire	,définitif	
nationaliser	,dénationaliser	
jamais	,toujours	
doigt	,pouce	
proton	,électron	
indestructible	,destructible	
réparable	,irréparable	
loin	,près	,près	,près	
dételer	,atteler	
indiscipline	,discipline	
tendre	,détendre	
praticable	,impraticable	
approuver	,désapprouver	,désapprouver	
impossible	,possible	
prendre la robe	,quitter la robe	
débutant	,confirmé	
objectif	,subjectif	
inévitable	,évitable	
raccrocher	,décrocher	
expirer	,aspirer	,courir	
semblable	,dissemblable	
égal	,inégal	,inégal	
crépuscule	,aube	
toxique	,atoxique	
disjoindre	,joindre	
infertile	,fertile	
public	,privé	
honnête	,malhonnête	
accepter	,refuser	,refuser	
présent	,absent	
professionnel	,amateur	
incorrect	,correct	
gratitude	,ingratitude	
aveugle	,voyant	,voyante	,voyant	
incapacité	,capacité	
imprécis	,précis	
final	,initial	
antonyme	,synonyme	,synonyme	
comme un poisson	,comme un boulet	,comme un caillou	,comme un fer à repasser	
levant	,couchant	
débarquer	,embarquer	
habile	,malhabile	
homogénéité	,hétérogénéité	,hétérogénéité	
hauturier	,côtier	
répulsif	,attractif	
net	,flou	,brut	
déshabiller	,habiller	
aspirer	,expirer	
inauthentique	,authentique	
indiscipliné	,discipliné	
efficace	,inefficace	
humide	,sec	
lever de soleil	,coucher de soleil	
coudre	,découdre	
>>>	S_res
abonner	,abonnement	
mesurer	,mesure	
humilier	,humiliation	
vote	,résultat	
muscler	,muscles	
collectionner	,collection	
cracher	,crachat	,crachat	
mesure	,mesure	;résultat	
opération	,résultat	,résultat	
interdire	,interdiction	
se brûler	,brûlure	
affaiblir	,faiblesse	
arranger	,arrangement	,arrangement	
résumer	,résumé	
lavis	,lavis	
déchirer	,déchirure	
analyse	,résultat	
décalage	,décalage	
s’engager	,engagement	
érotiser	,érotisme	
souffler	,souffle	
tournoi	,résultat	
glaçage	,glaçage	,glaçage	,glaçage	
division	,quotient	;résultat	
épuiser	,épuisement	
coup de foudre	,amour	
encadrer	,encadrement	
match	,résultat	
soustraction	;différence	;résultat	
condamner	,condamnation	
tempête	,houle	
abonnement	,abonnement	
réunion	,réunion	
klaxonner	,klaxon	
constater	,constat	
aimanter	,aimant	
pluie	,eau	
confondre	,confusion	
examen	,résultat	,résultat	,résultat	
se décaler	,décalage	
s’ioniser	,ion	,anion	,cation	
critique	,critique	,critique	
étude	,résultat	
réaliser	,réalisation	
ioniser	,ion	,anion	,cation	
sondage	,résultat	
déprimer	,déprime	,dépression	
multiplication	,produit	;résultat	
étourdir	,étourdissement	
mélange	,mélange	,mélange	;mélange	
écrire	,écriture	
suer	,sueur	
tordre	,torsion	
élection	,résultat	
négociation	,résultat	
juger	,jugement	
bilan	,bilan	;compte de bilan	,bilan	
chanter	,chant	
jugement	,jugement	
se fracturer	,fracture	
mélanger	,mélange	;mélange	
s’enrhumer	,rhume	
polluer	,pollution	,pollution	
éplucher	,épluchure	
opération escargot	,ralentissement	;bouchon	,embouteillage	
lever de soleil	,jour	
incliner	,inclinaison	
entasser	,entassement	,entassement	
s’affaiblir	,faiblesse	
caresser	,caresse	
entassement	,entassement	,entassement	,entassement	,entassement	
caca	,caca	
chambouler	,désordre	
s’éloigner	,éloignement	
ranger	,rang	,rangée	
dévaster	,dévastation	
vieillir	,vieillesse	
dessiner	,dessin	;figure	
extinction des feux	,extinction des feux	
expérimentation	,résultat	
épouvanter	,épouvante	
zébrer	,zébrure	
compétition	,résultat	
gonfler	,gonflage	
test	,résultat	
se couper	,coupure	
course	,résultat	
envelopper	,enveloppement	
observation	,observation	;résultat	
maquette	,maquette	
effort	,résultat	
s’endormir	,sommeil	
trouer	,trou	
doubler	,double	
copier	,copie	,copie	
enfler	,enflure	
coucher de soleil	,nuit	
politique	,fruit	,résultat	
cadrer	,cadre	;photographie	,prise de vue	,cadre	
laver	,lavis	,aquarelle	,lavis	
>>>	Syn_⊃
nuages	,menace	;malheur	,tourment	,infortune	
plier	,replier	
savon	,savonnette	;savon blanc	,savon d’Alep	,savon de Marseille	,savon noir	
neiger	,neigeoter	
lope	,tante	
moineau	,cigare	,phallus	
peur	,phobie	;terreur	
vert	,olive	;verdâtre	
politicienne	,politicarde	
brun	,marron	,noisette	
manier	,jouer	
couteau	,couteau	,couteau	
être	,demeurer	,rester	
malfaiteur	,délinquant	,malfrat	,racaille	,voyou	;escroc	,truand	;bandit	,gangster	;brigand	;hors-la-loi	
fonctionner	,marcher	
suspecté	,accusé	
se disputer	,se brouiller	
ami	,petit ami	
fumier	,crottin	
tige	,jambe	
allonger	,aliter	,démolir	,massacrer	
glace	,glace	,glaçage	
aquatique	,marin	
toit	,toiture	
montrer	,dévoiler	
tordre	,retordre	
gorge	,canyon	;cluse	,gosier	;pharynx	
similarité	;point commun	;analogie	;parallélisme	
tape	,tapette	
traduction	,mot à mot	
renoncule	,bouton-d’or	
médecin	,spécialiste	
génitrice	,mère	
quote-part	,cote	
nez	,museau	,mufle	,groin	,truffe	;bec	,parfumeur	,parfumeuse	
cradoque	,dégueu	,dégueulasse	,dégueu	,dégueulasse	,dégueu	,dégueulasse	
transférer	,télécharger	
cuisses	,genoux	
épreuve	,placard	
chanteuse	,cantatrice	,diva	;voix	;choriste	
base	,assiette	
utilitaire	,aspirateur	
multiplier	,démultiplier	
collation	,goûter	
crever	,passer l’arme à gauche	,succomber	,s’éteindre	
céder	,vendre	,donner	
eau	,hydrolat	,eau douce	;eau de mer	
vents	,instrument à vent	
politique	,politicard	
étendue d’eau	,pièce d’eau	,plan d’eau	
cricoïdien	,cricoïde	
matière	,substance	
forteresse	,citadelle	
nager	,nager	;nageoter	,surnager	;crawler	
orgue	,positif	
élément du corps	,partie du corps	
état psychique	,état mental	
fusion	,fonte	
gagnante	,championne	
selle	,cigare	,colombin	
parer	,chasser les mouches	
diffuseur	,diffuseur	
enveloppe	,gaine	,budget	
cradingue	,dégueu	,dégueulasse	,dégueu	,dégueulasse	,dégueu	,dégueulasse	
marcher	,flâner	,traîner	;trotter	
débouchage	,débouchement	
copie	,faux	
empreintes	,pas	
vieux	,père peinard	
équin	,chevalin	
siège bébé	,siège auto	
rapport sexuel	,coït	,coup	,étreinte	;devoir conjugal	,relation intime	,relation sexuelle	
volet	,jalousie	
tombeau	,mausolée	
charge	,fardeau	
communiquer	,annoncer la couleur	
évènement sportif	,compétition	;épreuve	
course à pied	,jogging	
couverture	,plaid	
plume	,écrivain	,écrivaine	
maladie	,maladie génétique	;maladie honteuse	,maladie vénérienne	;maladie infantile	;maladie mentale	
bouffer	,déjeuner	;dîner	;goûter	;petit-déjeuner	;souper	;dévorer	
sapide	,goûteux	
tout le monde	,tout ce beau monde	
prêtre	;abbé	;curé	;vicaire	
appliqué	,soigné	
famille	,sous-famille	,triade	
étron	,cigare	,colombin	
opéra	,maison lyrique	
apprécier	,adorer	
corps céleste	,astre	,étoile	
escargot de Bourgogne	,escargots	
homme politique	,politicard	
cercueil	,sarcophage	
faible	,affaibli	,la veuve et l’orphelin	
sucrer les fraises	,trembler	
parler	,abonder	,amuser le tapis	
croître	,grandir	
toison	,triangle	
changer	,se changer	,renouveler	
>>>	S_1
volume	,son	
Italie	,Italie	
abriter	,abri	
drôle	,numéro	
cathédrale	,prêtre	
boucherie	,boucher	,bouchère	,boucher	,bouchère	,boucher	,boucher	
trahir	,traître	,traîtresse	
récolter	,récoltant	,récoltante	,récolteur	,récolteuse	
site	,internaute	,internaute	
collier	,harnais	
clémentinier	,clémentine	
cratère	,volcan	
chantier	,constructeur	,constructrice	
triangle	,joueur	,joueuse	,femme	
irrespirable	,odeur	
poirier	,poire	
attraper	,attrapeur	
distribuer	,distributeur	,distributrice	
nation	,national	
leçon	,professeur	,professeure	,maître	,maîtresse	,instituteur	,institutrice	,enseignant	,enseignante	;prof	,prof	,instit	,instit	
village	,villageois	,villageoise	
hétérosexualité	,hétérosexuel	,hétérosexuelle	
dévorer	,dévoreur	,dévoreuse	,dévoreur	,dévoreuse	
rabbinat	,rabbin	
avion	;aviateur	,aviatrice	;pilote	,pilote	
orgueil	,orgueilleux	,orgueilleuse	
épidémie	,maladie	
syndrome	,symptôme	
collection	,collectionneur	,collectionneuse	
ruelle	,lit	
Allemagne	,Allemagne	
attaquer	,attaquante	,attaquant	
gomme	,arbre	
tabac	;priseur	,priseuse	;chiqueur	,chiqueuse	
collaborer	,collaborateur	,collabo	,collaboratrice	,collabo	
inventer	,inventeur	,inventrice	
affluent	,fleuve	
ballet	,ballet	
épluchure	,fruit	,légume	
ping-pong	,joueur	,joueuse	
numéro atomique	,élément	,atome	
solide	,matière	,substance	,substance	
arbre à chat	,chat	
donner le sein	,mère	;nourrice	
branche	,arbre	
pied	,plante	
civilité	,Madame	,Mademoiselle	,Monsieur	
épaule	,viande	,raquette	
recul	,arme	
ordonnance	,médecin	,docteur	
nager	,nageur	,nageuse	,nageur	,nageuse	
grippe	,malade	,malade	,grippé	,grippée	
vieillesse	,vieux	,vieille	
contenu	,contenant	
aimé	,amoureux	,amoureuse	
élément	,numéro atomique	
salon	,client	,cliente	,clientèle	
fleuve des Enfers	,mort	
vêtement	,ouvrier	,ouvrière	
maison d’arrêt	,prisonnier	
collectionner	,collectionneur	,collectionneuse	
mettre les petits plats dans les grands	,hôte	,hôte	,hôtesse	
posséder	,possesseur	;propriétaire	,propriétaire	
aube	,jour	,journée	
idéal	,idéal	
appartenir	,propriété	,possession	
syntaxe	,langue	
catholicisme	,catholique	,catholique	
gris	,gris	
abandonner	,sportif	,sportive	
rampant	,plante	
amandier	,amande	
hospitalité	,hôte	,hôtesse	
science	,scientifique	,scientifique	;savant	,savante	;chercheur	
récoltant	,récoltant	,récoltante	
imiter	,imitateur	,imitatrice	
complot	,comploteur	
excentricité	,excentrique	,excentrique	,excentricité	
territoire	,animal	
ambition	,ambitieuse	,ambitieux	
débuts	,débutant	,débutante	
carie	,dent	
gymnastique	,gymnaste	,gymnaste	
Grèce	,Grèce	
monture	,lunettes	,cavalier	,cavalière	
boutique	,boutiquier	,boutiquière	
contestataire	,contestataire	,contestataire	
longueur	,nageur	,nageuse	,vin	
apprentissage	,apprenti	,apprentie	
abstinence	,buveur	,buveuse	
tuberculeux	,tuberculeux	,tuberculeuse	
voie	,alpiniste	,alpiniste	
Pays-Bas	,Pays-Bas	
caractériser	,caractéristique	
dénoncer	,dénonciatrice	,dénonciateur	
fond	,discours	,fondeur	,fondeuse	
théier	,thé	
études	,étudiant	,étudiante	
France	,France	
vacances	,vacancier	;vacancière	
>>>	Conv_21
en dessus	,en dessous	
intégrer	,s’intégrer	,s’intégrer	
créancier	,débiteur	
manquer	,manquer	,manquer	,manquer	,manquer	
effet	,cause	
derrière	,devant	
transformer	,subir	
désespérer	,désespérer	,désespérer	,se désespérer	
alarmer	,s’alarmer	
se couvrir	,couvrir	
s’amuser	,amuser	
s’ébahir	,ébahir	
causer	,résulter	,tenir	
se désoler	,désoler	
renverser	,passer	
divertir	,se divertir	
se composer	,composer	
car	,donc	,en conséquence	,par conséquent	
s’inquiéter	,inquiéter	
intéresser	,s’intéresser	
inquiéter	,s’inquiéter	
maintenir	,tenir	
ébahir	,s’ébahir	
revenir	,se souvenir	,se rappeler	
couvrir	,se couvrir	
subir	,transformer	
retentir	,retentir	,retentir	
aîné	,cadet	
désoler	,se désoler	
recevoir	,visiter	
tenir	,maintenir	,tenir	,tenir	
toucher	,connaître	
s’intégrer	,intégrer	,intégrer	
se terminer	,terminer	,terminer	
par conséquent	,car	
manger la laine sur le dos	,se laisser bouffer	
se divertir	,divertir	
colorer	,se colorer	
angoisser	,angoisser	,angoisser	
aller	,avoir	
devant	,derrière	
se souvenir	,revenir	
se laisser bouffer	,manger la laine sur le dos	
quand bien même	,bien que	
appartenir	,posséder	
se piquer	,piquer	
visiter	,recevoir	
postérieur	,antérieur	
à droite	,à gauche	
expliquer	,s’expliquer	
adoptif	,adoptif	,adoptif	
se rappeler	,revenir	
craindre	,effrayer	
conséquence	,cause	
creusé	,creusé	,creusé	
au-dessus	,au-dessous	
affaiblir	,s’affaiblir	
se désespérer	,désespérer	
déprimer	,déprimer	,déprimer	
commencer	,commencer	,ouvrir	,commencer	,s’ouvrir	
terminer	,se terminer	,se terminer	
partir	,avoir	
coucher	,se coucher	,se coucher	,se coucher	,se coucher	
mourir	,tuer	,emporter	
posséder	,appartenir	
antérieur	,postérieur	
cadet	,aîné	
marcher	,faire	,alimenter	
passionner	,se passionner	
agacer	,s’agacer	
en conséquence	,car	
s’abriter	,abriter	
connaître	,toucher	
désintéresser	,se désintéresser	
entrer	,comprendre	
tenir à cœur	,tenir à cœur	,tenir à cœur	
ouvrir	,commencer	
se passionner	,passionner	
cause	,conséquence	,effet	,résultat	
avoir	,aller	,partir	
accueillir	,se trouver	
s’occuper	,occuper	
en dessous	,en dessus	
conduire	,résulter	
se déclencher	,déclencher	
donc	,car	
sensible	,sensible	,sensible	
s’intéresser	,intéresser	
s’affaiblir	,affaiblir	
s’agacer	,agacer	
s’expliquer	,expliquer	
s’alarmer	,alarmer	
résultat	,cause	
alimenter	,marcher	
déclencher	,se déclencher	
piquer	,se piquer	,piquer	,piquer	
au-dessous	,au-dessus	
résulter	,causer	
amuser	,s’amuser	
se désintéresser	,désintéresser	
>>>	A_0
nerf	,nerveux	
respectueusement	,respectueux	
italien	,italien	
odorat	,olfactif	
noir	,noir	
foie	,hépatique	
mère	,maternel	,maternel	
coton	,cotonnier	
araignée	,arachnéen	
satellite	,satellitaire	
délinquance	,délinquant	
Angliche	,angliche	
désert	,désertique	,érémitique	
individu	,individuel	
politiquement	,politique	,politique	
nombre	,numéral	,numérique	,numérique	
commercer	,commercial	
dynamiquement	,dynamique	
football	,footballistique	
Belgique	,belge	
consolidation	,consolidé	
urgemment	,urgent	
vaincu	,vaincu	
continuellement	,continuel	
désespoir	,désespéré	
carré	,carré	,carré	
chatte	,félin	
palais	,palatial	,palatal	,palatin	
kaki	,kaki	
honnêtement	,honnête	
aryténoïde	,aryténoïde	
sentimentale	,sentimental	
toucher	,tactile	
sens	,sensoriel	
effectivement	,effectif	
imbécilement	,imbécile	
torrentiellement	,torrentiel	
géographie	,géographique	
coopérer	,coopératif	
cancer	,cancéreux	
aimer	,amoureux	
Suisse	,suisse	,helvétique	
gencives	,gingival	
fleur	,fleuri	,floral	
rein	,rénal	
superficiellement	,superficiel	,superficiel	
partie	,partiel	
diable	,diabolique	
batellerie	,batelier	
putsch	,putschiste	
chaos	,chaotique	,chaotique	
agoraphobie	,agoraphobe	
séisme	,sismique	
vastement	,vaste	
ion	,ionique	
crâner	,crâneur	
gratuitement	,gratuit	
Chleuh	,chleuh	
vent	,éolien	
élégamment	,élégant	
publicité	,publicitaire	
subtilement	,subtil	
algèbre	,algébrique	
plus blanc que blanc	,plus blanc que blanc	,plus blanc que blanc	
obligatoirement	,obligatoire	
précocement	,précoce	
géométrie	,géométrique	
cérébralement	,cérébral	
rhumatisme	,rhumatismal	
voix	,vocal	
potentiellement	,potentiel	
promptement	,prompt	
natation	,natatoire	
incroyablement	,incroyable	
gène	,génétique	
lumière	,lumineux	
rythmiquement	,rhytmique	
dos	,dorsal	
russe	,russe	
nord	,nord	,septentrional	
évidemment	,évident	
Moyen-Âge	,médiéval	
majorité	,majoritaire	
isotope	,isotopique	
tutelle	,tutélaire	
savon	,savonnier	
marine	,marinier	
quotidiennement	,quotidien	
rond	,rond	
végétal	,végétal	
automne	,automnal	
racine	,racinaire	
malhonnêteté	,malhonnête	
trompeusement	,trompeur	
morale	,moral	
soleil	,solaire	
goudron	,goudronneux	
formellement	,formel	,formel	,formel	,formel	
état	,national	
vaincue	,vaincu	
>>>	Able_1
anglais	,anglophone	
cogner	,cogneur	
distinguer	,distinctif	
oublier	,oublieux	
rudoyer	,rude	
tempête	,exposé	
crier	,criard	
désobéir	,désobéissant	
résister	,résistant	
inventer	,inventif	
compensation	,compensatoire	
voleur	,voleur	
portugais	,lusophone	
tracasser	,tracassier	
ramper	,rampant	,rampant	
obéir	,obéissant	
mordre	,mordeur	
phobie	,phobique	
espagnol	,hispanophone	
casser	,cassant	
service	,serviable	
épouvanter	,épouvantable	
distraire	,distrayant	
craindre	,craintif	
avoir ses limites	,limité	
sale	,salissant	
ébahir	,ébahissant	
calcul	,calculateur	
amuser	,amusant	
se suicider	,suicidaire	
se soumettre	,soumis	
sport	,sportif	
aventure	,aventureux	,aventurier	
causer	,causant	,causeur	
fable	,fabulateur	
rouler	,roulant	
envahir	,envahissant	
sommeil	,somnolent	
allemand	,germanophone	
coopérer	,coopératif	
accélérer	,accélérateur	
entreprendre	,entreprenant	
russe	,russophone	
questionner	,questionneur	
dormir	,somnolent	
trouille	,trouillard	
compenser	,compensatoire	
inspirer	,inspirant	
alarmer	,alarmant	
fabuler	,fabulateur	
exciter	,excitant	
travailler	,bosseur	,travailleur	
éducation	,éducable	
changer	,changeant	
étouffer	,étouffant	
frousse	,froussard	
ruse	,rusé	
pleurer	,pleureur	
en imposer	,imposant	
pécher	,peccable	
dommages	,dommageable	
exiger	,exigeant	
observer	,observateur	
jouer	,joueur	
voyager	,voyageur	
anxiété	,anxieux	
se débrouiller	,débrouillard	
se casser	,cassant	
absorber	,absorbant	
agresser	,agressif	
permettre	,permissif	
coopération	,coopératif	
conserver	,conservateur	
rigoler	,rigoleur	
risque	,risqué	
incendie	,incendiaire	
réaction	,réactif	
tenter	,tentateur	;tentant	
peur	,peureux	
chinois	,sinophone	
réagir	,réactif	
guérir	,guérissant	
angoisse	,angoissé	
astuce	,astucieux	
bavarder	,bavard	
flatter	,flatteur	
mourir	,mortel	
expliquer	,explicatif	
perturber	,perturbant	,perturbant	
crainte	,craintif	
combattre	,combattant	
attirer	,attractif	
s’épuiser	,épuisable	
déplacement	,mobile	
autorité	,autoritaire	
malade	,maladif	
voyage	,voyageur	
s’évaporer	,évaporable	
créer	,créatif	
suspecter	,suspicieux	
>>>	Able_2
déterminer	,déterminable	
cafardeux	,cafardeux	
digérer	,digérable	
régler	,réglable	
voir	,visible	
inonder	,inondable	
sympathie	,sympathique	,sympa	
pardonner	,pardonnable	
mesurer	,mesurable	
somme	,sommable	
remuer	,remuable	
naviguer	,navigable	
critiquer	,critiquable	
adopter	,adoptable	
réaliser	,réalisable	
gouverner	,gouvernable	
boucher	,bouchable	
éviter	,évitable	
respirer	,respirable	
prouver	,prouvable	
ordonner	,ordonnable	
douter	,douteux	
consommer	,consommable	
scier	,sciable	
composer	,composable	
trouver	,trouvable	
loger	,logeable	
orienter	,orientable	
améliorer	,améliorable	
allonger	,allongeable	
nettoyer	,nettoyable	,nettoyable	,nettoyable	,nettoyable	
imagination	,imaginable	
utiliser	,utilisable	
compenser	,compensable	,compensable	
transformer	,transformable	
opposer	,opposable	
paralysie	,paralysant	
oublier	,oubliable	
achetable	,acheter	
accéder	,accessible	
effacer	,effaçable	
détruire	,destructible	,destructible	
glisser	,glissant	
tempête	,exposé	
enseigner	,enseignable	
élire	,éligible	
cafard	,cafardeux	
importer	,importable	
vérifier	,vérifiable	
incliner	,inclinable	
habiter	,habitable	
compensation	,compensable	,compensable	
écouter	,écoutable	
distribuer	,distribuable	
prévoir	,prévisible	
expliquer	,explicable	
compréhension	,compréhensible	
déprimer	,déprimant	
déplier	,dépliable	,dépliant	
confort	,confortable	
danser	,dansable	
acheter	,achetable	
angoisse	,angoissant	
agacement	,agaçant	
raconter	,racontable	
facture	,facturable	
anxiété	,anxiogène	
solution	,soluble	
appliquer	,applicable	,applicable	
deviner	,devinable	
attraper	,attrapable	
vélo	,cyclable	
se passionner	,passionnant	
occuper	,occupable	
communiquer	,communicable	
cultiver	,cultivable	
bicyclette	,cyclable	
décoller	,décollable	
expérimenter	,expérimentable	
mépris	,méprisable	
se marier	,mariable	
constatation	,constatable	
adaptable	,adapter	
maîtriser	,maîtrisable	
épouvante	,épouvantable	
boire	,buvable	
vendre	,vendable	
soupçonner	,soupçonnable	;suspect	
exploiter	,exploitable	
proposer	,proposable	
constater	,constatable	
juger	,jugeable	
récolter	,récoltable	
franchir	,franchissable	
rabattre	,rabattable	
croire	,crédible	,crédible	
consommation	,consommable	
administrer	,administrable	,administrable	
communication	,communicable	
mépriser	,méprisable	
>>>	Anti_∩
humour	,balai dans le cul	
condensable	,évaporable	
géant	,nain	,nain	,minuscule	
nain	,géant	,géant	
tuable	,immortel	
doux	,acide	;amer	,dur	,abrupt	,escarpé	
boire	,marcher à l’eau claire	
jeter de l’huile sur le feu	,arrondir les angles	
lointain	,proche	,proche	
cul-de-sac	,passage	,voie	
emménager	,déménager	
valise	,sac	
complexe	,simple	
déjà	,enfin	
fragiliser	,renforcer	
table	,buffet	,buffet	
se redresser	,se baisser	
rater	,réussir	
rétréci	,élargi	
rapporté	,intégré	
fonctionner	,battre de l’aile	
détruire	,construire	
titulaire	,remplaçant	,coiffeur	
secondaire	,principal	
parfois	,jamais	,toujours	
précédent	,prochain	,prochain	,prochain	
cocagne	,famine	
quitter la robe	,prendre l’habit	
post-	,avant	
sincère	,menteur	
avoir les deux pieds dans le même sabot	,se débrouiller	
avoir ses limites	,suffire	
boiter	,marcher	
couvert	,sans filet	
ignorance	,connaissance	
époux	,célibataire	
frêle	,solide	
de	,à	
stérile	,fécond	,fertile	
coup d’éclat	,coup d’épée dans l’eau	
superficiel	,profond	
svelte	,gros	,obèse	
courbe	,droit	
épouse	,célibataire	
perturbé	,organisé	
vieux	,jeune	
marcher à l’eau claire	,boire	
faux seins	,seins	
tranquilité	,agitation	
éloigné	,près	
fréquence	,rareté	
bonté	,méchanceté	
victoire	,veste	,veste	
ordinaire	,unique	
de terrain	,théorique	
s’empêcher	,autoriser	
reproche	,éloge	
chaud	,froid	
ranger	,bouleverser	,chambarder	,chambouler	
flexible	,têtu	
paraître	,disparaître	
au mois	,aux pièces	
à titre onéreux	,gratuitement	
différence	,ressemblance	,analogie	,similarité	,similitude	,analogie	;point commun	
organisé	,perturbé	
partisan	,ennemi	
tant bien que mal	,bien	
déprimer	,réjouir	
imaginaire	,réel	
écarter	,accepter	,serrer	,choisir	
se tromper	,avoir raison	
blanc	,rouge	
fantastiquement	,irréellement	
réalité	,idéalité	,illusion	
porte de prison	,joyeux drille	,joyeux vivant	
réglementé	,libre	
poliment	,grossièrement	
exonérer	,taxer	
déménager	,emménager	
à l’abri	,sous	,menacé	
personne	,chacun	
différent	,similaire	,analogue	,proche	
tout	,rien	,personne	
langage oral	,langage écrit	,écrit	
dernier	,suivant	
reste	,totalité	
pauvre	,riche	
allonger la sauce	,aller à l’essentiel	;appeler un chat un chat	
passage	,cul-de-sac	
jamais	,parfois	
autour	,loin	
haut en couleur	,incolore	
microscopique	,microscopique	,microscopique	
sonore	,muet	
près	,exactement	,précisément	
fierté	,honte	
glacé	,brûlant	,mat	
droit	,courbe	
rétrécir	,s’allonger	,diminuer	
baisser	,lever	,lever	
>>>	Real_1
W.-C.	,utiliser	,occuper	,se servir	
soupe	,manger	,avaler	
aile	,battre	,voler	;planer	
yaourt	,manger	,manger	
chiffre	,écrire	,tracer	,chiffrer	
histoire	,raconter	
téléphone	,parler	,se servir	,utiliser	,téléphoner	,parler	,se servir	,utiliser	,téléphoner	
guidon	,tenir	;tourner	
passerelle	,traverser	
musique	,écouter	
petit-gris	,élever	;ramasser	
soutien-gorge	,porter	
jogging	,avoir	,porter	
épingle	,épingler	
veste	,avoir	,porter	
dent	,laver	,brossé	,entraîner	,montrer les dents	
vitesse	,passer	
visite	,faire	,participer	
vêtements	,porter	;avoir	
cravate	,avoir	,porter	;porter	;arborer	
vache	,manger	
pots cassés	;payer	,ramasser	;en baver	;passer à la casserole	
pantalon	,avoir	,porter	
politique	,faire	,s’occuper	
courriel	,adresser	,envoyer	,utiliser	,se servir	;communiquer	
escargot	,élever	;ramasser	
serpillière	,passer	
serre-tête	,porter	
robe	,avoir	,porter	,porter	
bureau	,travailler	,travailler	,travailler	
rôle	,remplir	
couleurs	,afficher	;arborer	,porter	
couvre-feu	,observer	,respecter	,suivre	,obéir	
affiche	,afficher	
atome	,maîtriser	;dominer	
camion	,conduire	
couleur	,appliquer	;étaler	;mettre	;teindre	;colorer	;colorier	,porter	
chien	,avoir	,posséder	
frein	,freiner	
métro	,prendre	,emprunter	,prendre	,utiliser	
atmosphère	,respirer	
guitare	,jouer	
fesses	,s’asseoir	
fond	,verser	,servir	,entendre	,sonder	
la pluie et le beau temps	,parler	
peur	,céder	,succomber	,trembler	,pâlir	,s’évanouir	,hurler	
poitrine	,gonfler	,remplir	
marches	,gravir	,monter	;escalader	;descendre	
trottinette	,faire	,jouer	,se déplacer	,rouler	
protection hygiénique	,avoir	,porter	
mouche	,avoir	,porter	,avoir	,porter	
sondage	,sonder	
toboggan	,faire	
champagne	,boire	,déguster	
tabouret	,asseoir	,occuper	
dortoir	,dormir	
dette	;honorer	,régler	;acquitter	,payer	
pédales	,appuyer	
glace	,étendre	;étaler	
lieu commun	,dire	,énoncer	;asséner	,proférer	
chat	,avoir	,posséder	,jouer	
bifteck	,manger	,gagner	
chatte	,avoir	,posséder	
coup	,donner	,mettre	
train	,voyager	,prendre	,assurer	
bancs	,siéger	
film	,filmer	
signature	,honorer	
imprimé	,compléter	,remplir	
exemple	,exemplifier	
escargots	,manger	
pays	,habiter	,vivre	,habiter	,vivre	
maison	,habiter	
bateau	,faire	
chaussons	,avoir	,porter	,avoir	,porter	
citation	,reprendre	;emprunter	
escargot de Bourgogne	,élever	;ramasser	
continent	;demeurer	,habiter	,séjourner	,vivre	
allée	,se promener	
triangle	,faire	,jouer	
tartine	,manger	;grignoter	
chaussures	,avoir	,porter	
jour des Morts	,célébrer	,commémorer	
manteau	,avoir	,porter	
cyclisme	,pratiquer	
tempête	,affronter	,braver	,défier	,lutter	,faire face	
siège	,asseoir	,occuper	,asseoir	,disposer	;occuper	,siéger	,asseoir	,occuper	
office	,remplir	
habits	,avoir	,porter	
personnel	,bosser	,œuvrer	,travailler	,travailler	
seins	,donner	,allaiter	,donner le sein	;montrer	,dévoiler	
musée	,visiter	
chaise	,s’asseoir	,occuper	
soif	,étancher	
volet	,fermer	
mesure	,prendre	
promenade	,se promener	
taraud	,tarauder	
bave	,baver	
marché de Noël	,aller	,visiter	
>>>	V_0
clôture	,clore	
fonte	,fondre	
flânerie	,flâner	
jardinage	,jardiner	
obéissance	,obéir	
énumération	,énumérer	
essai	,essayer	
fourniture	,fournir	
débit	,débiter	
citation	,citer	
pollution	,polluer	,polluer	
entêtement	,s’entêter	
vouvoiement	,vouvoyer	
glissement	,glisser	,glisser	
comparativement	,comparer	
léchage	,lécher	
garage	,garer	
violation	,violer	
frappe	,frapper	,frapper	
énervé	,avoir les abeilles	
détachement	,se détacher	
cauchemar	,cauchemarder	
sifflet	,siffler	
vapotage	,vapoter	
traite	,traire	
publication	,publier	,publier	
attelage	,atteler	
repliage	,replier	
Merci	,remercier	
saut	,sauter	
raisonnement	,raisonner	
accumulation	,accumuler	
raccrochage	,raccrocher	
ressemblance	,ressembler	,ressembler	
poids	,peser	
crevaison	,crever	
sculptural	,sculpter	
confidence	,se confier	
consolation	,consoler	
aggravation	,aggraver	,s’aggraver	
admiration	,admirer	
liage	,lier	
sommeil	,sommeiller	
emprisonnement	,emprisonner	
gémissements	,gémir	
remboursement	,rembourser	
prolongation	,prolonger	
examen	,examiner	
rot	,roter	
démolition	,démolir	
racket	,racketter	
délivrance	,délivrer	
surgissement	,surgir	
séduction	,séduire	
qualification	,qualifier	
blocage	,bloquer	
ramassage	,ramasser	
roulement	,rouler	
dressage	,dresser	
appui	,s’appuyer	,appuyer	,appuyer	,appuyer	
agression	,agresser	
né	,naître	
réintégration	,réintégrer	
approbation	,approuver	,approuver	,approuver	
rectification	,rectifier	,rectifier	
avance	,avancer	
considération	,considérer	
étirement	,s’étirer	
résultat	,résulter	
tendage	,tendre	
pourriture	,pourrir	
binette	,biner	
crawlé	,crawler	
moquerie	,se moquer	
ronchonnement	,ronchonner	
allongement	,s’allonger	,allonger	,allonger	
autorisation	,autoriser	
aveu	,avouer	
grillage	,griller	
trébuchement	,trébucher	
tabac	,fumer	
concession	,concéder	
visée	,viser	
existant	,exister	
sauveur	,sauver	,sauver	
applaudissements	,applaudir	
réduit à zéro	,réduire à zéro	
persuasion	,persuader	
insultant	,insulter	
gâchis	,gâcher	
teinture	,teindre	
sondage	,sonder	
brassé	,brasser	
appartenance	,appartenir	,appartenir	
ronflements	,ronfler	
taxation	,taxer	
coupage de cheveux en quatre	,couper les cheveux en quatre	
amoncellement	,s’amonceler	
gravure	,graver	
recharge	,recharger	
>>>	S_3
botter les fesses	,faute	
pâtisserie	,cliente	,client	
boulangère	,client	,cliente	
autopsie	,résultat	
lectorat	,éditeur	
visiter	,affaires	;charité	
facture	,client	,cliente	
ministre	,gouvernement	,état	
coiffage	,peigne	,brosse	
malade	,partie du corps	,maladie	,maladie	
honneur	,honneur	
courriel	,contenu	
inspecteur	,inspection	
roi	,sujet	,sujette	
rapporter	,rapport	
député	,circonscription	
travailler	,employeur	,employeuse	,patron	,patronne	;employeur	
panser	,pansement	
gommer	,gomme	
péage	,péagiste	,péagiste	
chèque	,bénéficiaire	,bénéficiaire	;porteur	
similarité	,similarité	,point commun	
numéroter	,numéro	
piéger	,piège	
encadrer	,cadre	
fonder	,fondement	
discuter	,sujet	,thème	
bilan	,patient	
cirer	,cire	
charger	,chargement	
loyer	,location	
louange	,louange	
débiteur	,dette	
téléspectatrice	,télévision	
couleur	,poker	
épicerie	,client	,cliente	
multiplier	,multiplicateur	
nommer	,nom	;prénom	,nom	
expédier	,destinataire	,destinataire	
télévision	,téléspectateur	,téléspectatrice	
cuir	,article	
criminel	,victime	
visser	,vis	
arracher	,arracheuse	
réaction	,réaction	,réaction	
coup de feu	,arme à feu	
opéra	,auditeur	,auditrice	,spectateur	,spectatrice	
exposer	,public	
musique	,auditeur	,auditrice	
coiffer	,coiffure	
se lier	,molécule	
consolation	,consolation	
nourrir	,nourriture	
piocher	,pioche	
baser	,base	
apprendre	,élève	,élève	,étudiante	,étudiant	,expérience	
maire	,administré	,administrée	
service	,restaurant	
boîte aux lettres	;courrier	
mesure	,mesure	,mesure	
ordonnance	,médicament	
explication	,explication	
accentuer	,accent	,accent	
charcuterie	,client	,cliente	
trahir	,trahison	
tourner	,acteur	,actrice	
déshabiller	,habits	,vêtements	
menuisier	,bois	
qualifier	,qualificatif	
comprimé	,substance active	
différer	,différence	
victoire	,bataille	;guerre	
pansement	,pansement	
accentuation	,accent	,accent	
médecine	,maladie	
emprunté	,emprunteur	,emprunteuse	
enveloppe	,destinataire	,destinataire	,bénéficiaire	,bénéficiaire	
défendre	,agression	;agresseur	,agresseuse	
conversation	,sujet	,thème	
marche	,auditeur	,auditrice	
vitesse	,conducteur	
addition	,client	,cliente	
juger	,délit	;crime	,jugement	,jugement	;avis	,opinion	
observer	,observation	
timbre	,colis	;enveloppe	,lettre	
subvention	,subvention	
classe	,classe	
similitude	,similitude	,point commun	
bus	,arrêt	
somme	,somme	
colis	,destinataire	,destinataire	
tirer	,arme à feu	,loterie	
grandeur	,unité de mesure	
empoisonner	,poison	
améliorer	,amélioration	
remplaçant	,compétition	
boulanger	,client	,cliente	
alimenter	,aliment	
racket	,victime	
voter	,élection	
>>>	A_1
Sud-Coréenne	,sud-coréen	
se coucher	,couchant	
exporter	,exportateur	
hétérogénéité	,hétérogène	,hétérogène	
extravagant	,extravagant	
dent	,muni	,denté	,dentelé	,à	,dentelé	,à	,denté	
pudeur	,pudique	
bras long	,à	
maigreur	,maigre	
Portugal	,portugais	
appuyer	,appuyé	
ne plus être	,mort	
conversation	,en	<plongé	
expérience	,expérimenté	
discontinuité	,discontinu	
gratuité	,gratuit	
amateur	,amateur	
anxiété	,anxieux	
violence	,violent	,violent	,violent	
sainteté	,saint	,saint	,saint	
caractériser	,caractéristique	
racisme	,raciste	
affaiblir	,affaiblissant	
correction	,correct	
disponibilité	,disponible	
Franc	,franc	
Turc	,turc	
flegme	,flegmatique	
fluvialité	,fluvial	
maladresse	,maladroit	
obésité	,obèse	
pâleur	,pâle	
force	,fort	
retard	,retardataire	
frissonner	,frissonnant	,frissonnant	,frissonnant	
imparité	,impair	
prévenir	,préventif	
contestataire	,contestataire	,contestataire	
agoraphobie	,agoraphobe	
prison	,prisonnier	
voile	,voilé	
grelotter	,grelottant	
correspondance	,correspondant	
Coréenne	,coréen	
flotter	,flottant	
Japon	,japonais	,nippon	
sensibilité	,sensible	,sensible	,sensible	,sensible	,sensible	,sensible	
saigner	,saignant	
désolation	,désolé	
méthode	,méthodique	
connerie	,con	
laine	,laineux	
début	,débutant	
bizarrerie	,bizarre	
construire	,constructeur	
s’intéresser	,intéressé	
variété	,varié	
curiosité	,curieux	,curieux	
matière	,matériel	
stérilité	,stérile	
efficacité	,efficace	
suspense	,à suspense	
mains sales	,à	
merveille	,merveilleux	
tomber	,tombant	
possibilité	,possible	
grâce	,gracieux	
bosse	,bossu	,à	
respecter	,respectueux	
vivre	,vivant	
ovale	,ovale	
admiration	,transporté	<soulevé	,rempli	,admiratif	<plein	,en	
faire face	,face	
agonie	,à	
casser les couilles	,casse-couilles	
enseigner	,enseignant	
monter	,montant	
boule	,en	
dégoûter	,dégoûtant	
contentement	,content	
étanchéité	,étanche	
orgueil	,orgueilleux	
boire	,alcoolique	,alcoolo	
précéder	,précédent	
défendre	,défensif	
délinquance	,délinquant	
barbu	,barbu	
décourager	,décourageant	
pédé	,pédé	
favoriser	,favorable	
dominer	,dominant	
protestataire	,protestataire	,protestataire	
extrême	,extrême	
hésiter	,hésitant	
main verte	,à	
prédateur	,prédateur	
hépatique	,hépatique	,hépatique	
lenteur	,lent	
orpheline	,orphelin	,orphelin	
impossibilité	,impossible	
>>>	S_2^prototyp
conduite	,véhicule	,auto	,train	,moto	,voiture	,automobile	
titulaire	,passeport	;permis	,passeport	,permis	
monopoliser	,antenne	
cercueil	,cadavre	,corps	,défunt	,défunte	,macchab	,macchabée	,mort	,morte	
mobiler	,pièce	
pharmacie	,médicament	
élever	,enfant	,enfant	,petit	
visiter	,musée	
biberon	,nourrisson	,bébé	
lin	,huile	;huile	
moudre	,café	,blé	
s’asseoir	,chaise	,fauteuil	,siège	
tabac	,tabac	
infirmerie	,patient	,patiente	,malade	,malade	
boucher	,viande	
peigner	,cheveux	
fauteuil	,conseil	;conseil d’administration	
métro	,terminus	
cible	,chantage	
boulanger	,pain	;viennoiserie	
bouchon	,bouteille	,bouteille	
lire	,livre	;magazine	
culture	,plante	
consultation	,médecin	,médecin	
petit chien	,accouchement	
averse	,neige	;grêle	;pluie	;cendre	
escalader	,montagne	;rocher	,col	,côte	
foncer	,moule	
vissé	,chaise	
amarre	,bateau	
placarder	,avis	,affiche	
gratter	,guitare	,gratte	
empreinte	,dentiste	,dentiste	
profaner	,tombe	
orbiter	,astre	;étoile	
partie	,chasse	,pêche	
siège éjectable	,avion	
hold-up	,banque	;bijouterie	;magasin	
victime	,maladie	;accident	;catastrophe	
fumeuse	,cigare	,cigarette	,pipe	;tabac	
cailler	,lait	,fesses	,miches	
diète	,médecin	,médecin	,docteur	,doctoresse	,docteure	
chiffon	,poussière	
peindre	,peinture	
forme	,chaussures	,chapeau	,pain	,fromage	,sucre	
main	,jeu	
transmettre	,maladie	,maladie	;microbe	
théâtre	,accident	;drame	
clouer au lit	,malade	,malade	
conducteur	,voiture	,véhicule	,automobile	,moto	,auto	,autobus	,autocar	,bus	,camion	,car	,métro	,train	,tramway	
noyer	,chagrin	
robinet	,eau	;gaz	;fluide	
soufflé	,fromage	,chocolat	
fond de volaille	,sauce	
vestiaire	,cliente	,client	
produire	,papiers	
poteaux	,rugby	
condamner	,accusé	,accusée	
cracher	,chewing-gum	
jambe	,porc	;bœuf	
coton	,plaie	
quai	,gare	;métro	,métro	,train	
se cailler	,fesses	,miches	
champ	,blé	,formulaire	,arme à feu	
réserviste	,armée	,police	
design	,meuble	;site	
machine à coudre	,tissu	
patient	,médecin	,médecin	,docteur	,docteure	
tourner	,film	
gauche	,cœur	
tramway	,terminus	
sirop	,fraise	,menthe	
accident	,véhicule	
pièce d’ameublement	,pièce	;appartement	,maison	
collaboration	,Allemand	
amputation	,membre	
bol	,soupe	
main gauche	,instrument de musique	
couché	,lit	,lit	
menottes	,main	,poignet	,bras	;prisonnier	,prisonnière	
conduire	,auto	,moto	,automobile	,train	,voiture	,véhicule	
dépression	;fluide	;gaz	,liquide	
téléphone	,répondant	,répondante	
recouvert	,tissu	
lait	,nourrisson	;bébé	,enfant	,enfant	,nouveau-né	,nouvelle-née	;petit	,petite	
éplucher	,document	
automobile	,automobile	
fonder	,famille	
se coucher	,lit	
compression	,fluide	;gaz	,liquide	
avoir des nouvelles	,avocat	
clafoutis	,cerise	
définir	,politique	
embarquer	,véhicule	
éléments de langage	,politicien	,politicienne	
conductrice	,moto	,auto	,véhicule	,voiture	,automobile	
éclair	,café	;chocolat	;vanille	
aspirateur	,poussière	
moelleux	,chocolat	,citron	,orange	
patiente	,médecin	,médecin	,docteur	,docteure	
>>>	Syn_⊃^sex
froussard	,froussarde	
abandonné	,abandonnée	
pisseur	,pisseuse	
soldat du feu	,soldate du feu	
malade	,malade	
attaquant	,attaquante	,attaquante	
jeune	,jeune	
absent	,absente	
rhumatisant	,rhumatisante	
imprimeur	,imprimeuse	
chrétien	,chrétienne	
pompiste	,pompiste	
Anglais	,Anglaise	
margrave	,margrave	
Britannique	,Britannique	
destructeur	,destructrice	
hospitalisé	,hospitalisée	
cher et tendre	,chère et tendre	
patineur	,patineuse	
anarchiste	,anarchiste	
tousseur	,tousseuse	
chaussonnier	,chaussonnière	
écologiste	,écologiste	
ministre	,ministre	
auto-stoppeur	,auto-stoppeuse	
meilleur	,meilleure	
folliculaire	,folliculaire	
philosophe	,philosophe	
luthier	,luthière	
participant	,participante	
conservateur	,conservatrice	
orthophoniste	,orthophoniste	
mouton	,brebis	
sentimental	,sentimentale	
écologue	,écologue	
salarié	,salariée	
pleureur	,pleureuse	
saint patron	,sainte patronne	
analyste	,analyste	
viniculteur	,vinicultrice	
accusateur	,accusatrice	
officier	,officière	
journaleux	,journaleuse	
arrivant	,arrivante	
Espagnol	,Espagnole	
vilain	,vilaine	
raté	,ratée	
cornichon	,cornichonne	
inventeur	,inventrice	
appelant	,appelante	
empoté	,empotée	
dirlo	,dirlo	
marchand	,marchande	
cultivateur	,cultivatrice	
pêcheur	,pêcheuse	
écolier	,écolière	
épéiste	,épéiste	
chevrier	,chevrière	
contrôleur	,contrôleuse	,contrôleuse	
blessé	,blessée	
buraliste	,buraliste	
pompier	,pompier	,femme pompier	,pompière	
exécuteur	,exécutrice	
flâneur	,flâneuse	
voisin	,voisine	
guérisseur	,guérisseuse	
agité	,agitée	
initiateur	,initiatrice	
Australien	,Australienne	
frisé	,frisée	
prof	,prof	,professeure	
invité	,invitée	
continental	,continentale	
élève	,élève	
commandant	,commandante	
célibataire	,célibataire	
peau-rouge	,peau-rouge	
cigarier	,cigarière	
inscrit	,inscrite	
finaliste	,finaliste	
têtu	,têtue	
berger	,bergère	
lanceur	,lanceuse	
cochon	,truie	,cochonne	
musulman	,musulmane	
enquêteur	,enquêtrice	,enquêteuse	,enquêtrice	
médecin légiste	,médecin légiste	
nul	,nulle	
dresseur	,dresseuse	
pisse-copie	,pisse-copie	
documentariste	,documentariste	
ancien	,ancienne	,ancienne	
passant	,passante	
parasite	,parasite	
sportif	,sportive	
guichetier	,guichetière	
résidant	,résidante	
roux	,rousse	
témoin	,témoin	
bâtard	,bâtarde	
>>>	Adv_0
banal	,banalement	
vague	,vaguement	
inconscient	,inconsciemment	
continuel	,continuellement	
geste	,gestuellement	
brutal	,brutalement	
sain	,sainement	
formel	,formellement	,formellement	,formellement	,formellement	
sainteté	,saintement	
moléculaire	,moléculairement	
drôle	,drôlement	
volontaire	,volontairement	
torrentiel	,torrentiellement	
lent	,lentement	
partiel	,partiellement	
horizontal	,horizontalement	
concept	,conceptuellement	
facultatif	,facultativement	
molécule	,moléculairement	
tourisme	,touristiquement	
potentiel	,potentiellement	
naïveté	,naïvement	
obligatoire	,obligatoirement	
continuité	,continûment	
contredire	,contradictoirement	
sinistre	,sinistrement	
constant	,constamment	
général	,généralement	
fille	,filialement	
lointain	,loin	
différent	,différemment	
faible	,faiblement	
agile	,agilement	
après-coup	,après coup	
délicieux	,délicieusement	
grossier	,grossièrement	,grossièrement	
particulier	,particulièrement	
innocence	,innocemment	
paresseux	,paresseusement	
sincère	,sincèrement	,sincèrement	
savant	,savamment	,savamment	
ridicule	,ridiculement	
démocratique	,démocratiquement	
toucher	,tactilement	
cérébral	,cérébralement	
possible	,possiblement	
intime	,intimement	
cerveau	,cérébralement	
commerce	,commercialement	
instant	,instantanément	
fils	,filialement	
vaste	,vastement	
synthèse	,synthétiquement	
continu	,continûment	
subtil	,subtilement	
sérieux	,sérieusement	
désagréable	,désagréablement	
drame	,dramatiquement	
odieux	,odieusement	
atomique	,atomiquement	
dynamique	,dynamiquement	
superbe	,superbement	
solide	,solidement	
temporel	,temporellement	
muscle	,musculairement	
sympathie	,sympathiquement	
mois	,mensuellement	
fonctionnel	,fonctionnellement	
luxe	,luxueusement	
art	,artistiquement	
nuage	,en	,par	,sous forme	
digne	,dignement	
tardif	,tard	
infini	,infiniment	
territoire	,territorialement	
authentique	,authentiquement	
lamentable	,lamentablement	
égal	,également	
proverbe	,proverbialement	
conscient	,consciemment	
imaginaire	,imaginairement	
électricité	,électriquement	
collectivement	,collectif	
sexe	,sexuellement	,sexuellement	
innocent	,innocemment	
effectif	,effectivement	
rapide	,rapidement	,rapidement	,rapidement	
allégresse	,allègrement	
médecine	,médicalement	
utile	,utilement	
semblable	,semblablement	
bizarre	,bizarrement	
partie	,partiellement	
hypothèse	,hypothétiquement	
origine	,originellement	
humble	,humblement	
religion	,religieusement	
national	,nationalement	
fond	,foncièrement	,en	,foncièrement	,profondément	,en	
clandestinité	,clandestinement	
>>>	S_instr
condamner	,jugement	,verdict	
vol	,avion	
téléphoner	,téléphone	
respirer	,nez	,narines	,narine	
nourrir	,seins	
voyager	,avion	,autocar	,train	,voiture	
boulanger	;pétrin	;four	
entendre	,oreilles	
voiture	,voiture	
sentir	,nez	;nez	
faire de l’essence	,pompe	
tennis	,balle	;raquette	;filet	
badminton	,volant	;raquette	
distinguer	,oreilles	
crime	,arme	
articuler	,articulateur	
skier	,skis	
triangle	,baguettes	
donner le sein	,seins	
chanter	,corde vocale	,larynx	,larynx	,corde vocale	
orchestre	,instrument de musique	
tourner	,caméra	
chant	,larynx	,corde vocale	
aller	,moyen de transport	
football	,ballon	;buts	,cage	
bain	,baignoire	
trajet	,bus	,tramway	
violon	,archet	
laver	,douche	,baignoire	,lavabo	
communication	,téléphone	
boucher	,couteau	;crochet	,esse	
pieuter	,lit	,pieu	,paddock	,pageot	
zapper	,télécommande	
plein	,pompe	
odorat	,nez	,nez	
klaxonner	,klaxon	
ski	;bâton	;chaussures	;skis	
imaginer	,imagination	
volley-ball	,ballon	;filet	
se baigner	,baignoire	
mécanicien	,outil	
doucher	,douche	
déboucher	,tire-bouchon	
médecin	,stéthoscope	,stéthoscope	
coiffeuse	,ciseaux	;brosse	,peigne	;sèche-cheveux	
coup de couteau	,couteau	
toilette	,gant de toilette	,linge	,objet	,parure	;gel douche	,produit	,savon	;affaires	,nécessaire	
uriner	,urinoir	;toilettes	
mécanicienne	,outil	
bouchère	,couteau	;crochet	
dormir	,lit	
battre	,fouet	,batteuse	
gauche	,main gauche	
prêcher	,sermon	
matraquer	,matraque	
menotter	,menottes	
flûte	,flûte	
renifler	,nez	;nez	
crucifier	,croix	
allaiter	,seins	
ramer	,rame	,rame	
cirer	,cire	,cirage	
harnacher	,harnais	
radio	,radio	
klaxon	,klaxon	
se doucher	,douche	
tout oreilles	,oreilles	
boxeur	,gants	
sucer	,bouche	,lèvres	,bouche	
éventer	,éventail	
goût	,langue	;papilles	;palais	
clôturer	,clôture	
escalade	,bicyclette	,vélo	
voler	,aile	,avion	,avion	
judo	,kimono	,judogi	
empoigner	,main	
dentiste	,davier	;fraise	;roulette	,davier	;fraise	;roulette	
pompier	,camion	;lance	;bouche d’incendie	,camion	;lance	;bouche d’incendie	
escalader	,bicyclette	,vélo	
coup de poing	,coup de poing	
s’éventer	,éventail	
flatter	,compliment	
boulangère	,pétrin	;four	
se moucher	,mouchoir	;doigt	
moudre	,moulin	;moulin à café	
crayonner	,crayon	
basket	,ballon	;panier	
jogging	,baskets	
observer	,microscope	,loupe	,lunette	
plage	;parasol	,paillasse	,tapis de plage	;maillot	,serviette	;bouée	,palmes	,masque	,tuba	
courriel	;boîte mail	;serveur	
hold-up	,arme	
karaté	,kimono	,karatégi	
douche	,douche	;fleur de douche	
se laver	,lavabo	,baignoire	,douche	;savon	,gel douche	
musique	,instrument de musique	,instrument de musique	,instrument de musique	
lavis	,pinceau	
piquer	,seringue	
mesure	,mètre	,règle	;instrument de mesure	
ping-pong	,balle	;raquette	;ping-pong	,table de ping-pong	
>>>	Syn_⊂
truand	,criminel	;malfaiteur	,malfrat	
ressource	,astuce	
parallèle	,droite	
balai	,baguettes	
aux cent coups	,inquiet	
quart-temps	,période	
jouir	,utiliser	
cacher son jeu	,dissimuler	
cave à cigares	,boîte	,réserve	
enveloppe	,revêtement	
objet	,chose	,truc	,bidule	,machin	,entité	,quelque chose	
Conseil d’État	,assemblée	
course à l’armement	,politique	
collation	,repas	
croulant	;vieux	,vioc	
essence de térébenthine	,essence	
fiction	,œuvre	
déchiré	,drogué	
à fond	,vite	
lever	,gonfler	,élever	,élever	,prendre	,élever	,déloger	;chasser	,croître	,grandir	,se développer	
nappe	,étendue	
comme un clou	,très	
auberge	,hôtel	
naviguer	,se déplacer	,se déplacer	
Pâque	,fête	
cachot	,cellule	
boche	,allemand	,allemand	,allemand	
unité de mesure	,unité	
petit-déjeuner	,repas	,manger	,bouffer	,repas	
irrespirable	,désagréable	
étouffer	,empêcher	,empêcher	,gêner	
document	,document	
sosie	,jumeau	
carrosse	,voiture	
enfoncer une porte ouverte	,dire	
lit	,couche	,literie	,couche	
navigateur	,logiciel	
petit ami	,ami	
de la tarte	,facile	
lombric	,ver	
sac	,sac	
ressortissant	,citoyen	
vinasse	,vin	
découpure	,découpage	
méfait	,effet	
rocher	,pierre	
se destiner	,vouloir	
hurler	,crier	,crier	,crier	
aplati	,nonchalant	,détruit	
larguer les amarres	,partir	
garde-robe	,vêtements	
licencié	,sportif	
remettre	,mettre	,mettre	,mettre	
solder	,clôturer	,acquitter	
engager	,mettre	,commencer	
déformation professionnelle	,habitude	
image	,analogie	
terrassé	,touché	
donner sa langue au chat	,ignorer	
recoller	,coller	
glace	,glace	
subdivision	,division	,partie	
coudière	,pièce	
lessive	,nettoyant	,lavage	,solution	,tri	
sexe féminin	,sexe	
tuberculeux	,malade	
plaid	,couverture	
mouton	,nuage	
claudication	,démarche	
en diable	,très	
comme des petits pains	,bien	
kérosène	,combustible	
break	,voiture	,voiture	
coasser	,crier	
juré	,vrai	
main-d’œuvre	,travail	
départ	,lieu	
mère	,génitrice	,procréatrice	,religieuse	,nonne	,femme	
enseigne	,panneau	
microscope	,instrument	
rondelle	,pièce	
s’écarter	,se déplacer	
renardeau	,petit	
coup de chaleur	,indisposition	
électrique	,électrique	
ordonnance	,document	
vermeil	,rouge	
bouche	,goût	
cérémonie	,célébration	
chaud	,température	
bride	,harnais	
corsaire	,pantalon	
siffler	,boire	
enseignant-chercheur	,enseignant	;chercheur	
marcher sur la tête	,gagner	
divaguer	,marcher	,parler	
partie du corps	,élément du corps	
dégueu	,sale	<cracra	,crade	,cradingue	,crado	,cradoque	,craspec	,crasseux	,sale	<cracra	,crade	,cradingue	,crado	,cradoque	,sale	<cracra	,crasseux	,crade	,cradingue	,crado	,cradoque	
béni-oui-oui	,individu	
charcutier	,boucher	,boucher	
>>>	Syn
flotter	,pleuvoir	,fluctuer	
popotin	,paire de fesses	,cul	,derrière	,panier	,arrière-train	,postérieur	,séant	,miches	,pétard	,croupe	,croupion	,fessier	,derche	,lune	
dix	,10	
alpin	,alpestre	
piaule	,chambre	
polluant	,sale	
zizique	,musique	,zique	
arrêt	,arrestation	
cheval-vapeur	,ch	
boxe	,noble art	
philo	,philosophie	
costard	,costume	
impôt sur le revenu	,IR	
vrai	,véritable	
cube de glace	,glaçon	
dada	,cheval	
route nationale	,nationale	
s’acheminer	,se diriger	,se diriger	
jogging	,survêtement	,survêt	
corbeille d’argent	,alysse	
daron	,dab	,pater	,paternel	,père	
ciboulot	,caboche	,cafetière	,cigare	,cerveau	,cervelle	,crâne	,tête	
nichons	,lolos	,nénés	,nibards	,roberts	,roploplos	,seins	
aucunement	,nullement	
noix de coco	,coco	
à fond la caisse	,à fond	,à fond de train	,à fond les ballons	,à fond les manettes	
poésie	,poème	
de la nuque aux orteils	,de la tête aux pieds	
politique	,homme politique	
téléphone	,appareil téléphonique	,bigophone	,numéro	
se rappeler	,se souvenir	
tantouze	,folle	,tante	,tapette	,tata	
eau	,flotte	,flotte	
vieille	,vioque	
deux-pièces	,F2	,T2	
cercueil	,bière	,sapin	
ciné	,cinéma	,cinoche	,cinéma	,cinoche	
pneu	,pneumatique	,bouée	,brioche	,pneumatique	
tartisses	,W.-C.	,goguenots	,gogues	,cagoinces	,chiottes	,pipi-room	,tinettes	,vécés	,wawas	,cabinets	,petit coin	,toilettes	,waters	,water-closet	,cabinet d’aisances	,commodités	,lieux d’aisances	,sanitaires	,goguenots	,gogues	,cagoinces	,chiottes	,cabinets	,toilettes	,W.-C.	,waters	,water-closet	,petit endroit	,tinette	,vécés	,wawas	,cabinet d’aisances	,commodités	,lieux d’aisances	,sanitaires	
piétonnier	,piéton	
pageot	,paddock	,pieu	,plumard	,pucier	,dodo	,lit	
chaise de bébé	,chaise haute	
escargot	,colimaçon	,limaçon	
voussoyer	,vouvoyer	
fleurissement	,floraison	
dans le tuyau de l’oreille	,dans le creux de l’oreille	
soulignage	,soulignement	
paternel	,dab	,daron	,pater	,père	
2 CV	,deux-chevaux	,deuche	,deudeuche	
portion	,ration	
boîte aux lettres	,boîte à lettres	,boîte mail	,boîte à lettres	
caille-lait	,gaillet	
bénard	,ben	,falzar	,fendard	,froc	,fute	,futal	,culotte	,pantalon	
gnôle	,eau-de-vie	
sous	,dessous	
sculptage	,sculpture	
CGI	,Code général des impôts	
T9	,F9	,neuf-pièces	
casser sa pipe	,clamser	,crever	,trépasser	,décéder	,disparaître	,mourir	,perdre la vie	,périr	
Vierge Mère	,Bonne Mère	,Mère de Dieu	,Vierge	
bise	,bisou	
tailler un costume	,tailler une veste	
frites	,pomme frite	
l’air de rien	,sans en avoir l’air	
pétrole	,or noir	
mettre bas	,accoucher	
communiste	,coco	,rouge	,coco	,rouge	,coco	,coco	
qqn	,quelqu’un	
difficulté	,peine	
à poil	,nu	
caca	,merde	,crotte	,étron	,pétrin	
Bon anniversaire	,Joyeux anniversaire	
procréatrice	,génitrice	
tombeau	,sépulcre	
boire	,picoler	,picoler	
instituteur	,instit	
se souvenir	,se rappeler	
membre viril	,membre	
bague	,bagouse	
derrière	,paire de fesses	,cul	,panier	,arrière-train	,postérieur	,séant	,miches	,pétard	,croupe	,croupion	,fessier	,popotin	,derche	,lune	
homosexuel	,homo	
foufoune	,minou	,zézette	,chatte	,moule	,vulve	
couleur	,coloration	,teinture	,coloration	,teinture	,coloration	,teinture	
frotter les oreilles	,caresser les oreilles	
avancée	,avance	
masse moléculaire	,poids moléculaire	
impro	,improvisation	
gaspi	,gaspillage	
drosophile	,mouche du vinaigre	
pape	,Saint-Père	,souverain pontife	
fessier	,paire de fesses	,cul	,derrière	,panier	,arrière-train	,postérieur	,séant	,miches	,pétard	,croupe	,croupion	,popotin	,derche	,lune	
également	,aussi	
mâcher	,mastiquer	
aïeule	,mère-grand	,grand-maman	,mamie	,mémé	,mémère	,bonne-maman	,grand-mère	
haillons	,guenilles	
3	,trois	,trois	,trois	,trois	
râlement	,râle	
CMPU	,coût moyen unitaire pondéré	
hosto	,hôpital	
quasi	,quasiment	
>>>	S_1Pred
nul	,nul	,nulle	
agressé	,agressé	,agressée	
rival	,rival	;rivale	
vieux	,vieux	,vieille	
chrétien	,chrétienne	,chrétien	
mauvais	,mauvais	
symptomatique	,symptôme	,symptôme	
extraterrestre	,extraterrestre	,extraterrestre	
inconscient	,inconscient	,inconsciente	
hospitalisé	,hospitalisé	,hospitalisée	
têtu	,têtu	,têtue	<entêté	,entêtée	;cabochard	,cabocharde	,tête de mule	,tête de cochon	
laid	,laid	,laide	
russe	,Russe	,Russe	
germanique	,Germanique	,Germanique	
espagnol	,Espagnol	,Espagnole	
gentil	,gentil	,gentille	
misogyne	,misogyne	
milliardaire	,milliardaire	,milliardaire	
végétarien	,végétarien	,végétarienne	
pauvre	,pauvre	,pauvre	
indien	,Indien	,Indienne	,Indien	,Indienne	
vivant	,vivant	;vivante	
portugais	,Portugais	,Portugaise	
rouge	,rouge	,rouge	
gazeux	,gaz	
fort	,fort	
accidenté	,accidenté	,accidentée	
américain	,Américain	,Américaine	,Américain	,Américaine	
chauve	,chauve	,chauve	
angliche	,Angliche	,Angliche	
communiste	,communiste	,communiste	
criminel	,crime	,crime	,crime	
acquéreur	,acquéreur	
gallois	,Gallois	,Galloise	
bienheureux	,bienheureux	
hollandais	,Hollandais	,Hollandaise	
court	,vin	
bouddhiste	,bouddhiste	,bouddhiste	
belge	,Belge	,Belge	
favori	,favori	,favorite	
collaborateur	,collaborateur	,collabo	,collaboratrice	,collabo	
xénophobe	,xénophobe	,xénophobe	
fabulateur	,fabulateur	,fabulatrice	
aîné	,aîné	,aînée	
insulaire	,insulaire	,insulaire	
débrouillard	,débrouillard	,débrouillarde	
liquide	,liquide	
enfant	,enfant	,enfant	
tyrannique	,tyran	
franc	,Franc	
japonais	,Japonais	,Japonaise	
organique	,organisme	
excentrique	,excentrique	,excentrique	,excentricité	
carié	,dent	
titulaire	,titulaire	
catholique	,catholique	,catholique	
immortel	,immortel	,immortelle	
allemand	,Allemand	,Allemande	
ingrat	,ingrat	,ingrate	
riverain	,riverain	,riveraine	
francophone	,francophone	,francophone	
couard	,couard	,couarde	
adulte	,adulte	,adulte	
irlandais	,Irlandais	,Irlandaise	
héroïque	,héros	,héroïne	
hétérosexuel	,hétérosexuel	,hétérosexuelle	
miraculé	,miraculé	,miraculée	
futé	,futé	,futée	
russophone	,russophone	,russophone	
féminin	,femme	
prédateur	,prédateur	
garant	,garant	,garante	
pair	,nombre	;chiffre	
sourd	,sourd	,sourde	,bruit	
connerie	,con	
grec	,Grec	,Grecque	
italien	,Italien	,Italienne	
rusé	,rusé	,rusée	
impair	,nombre	;chiffre	
lâche	,lâche	,lâche	
beau	,beauté	
imbécile	,imbécile	,imbécile	
suédois	,Suédois	,Suédoise	
bossu	,bossu	,bossue	
débutant	,débutant	,débutante	
tentateur	,tentateur	,tentatrice	
australien	,Australien	,Australienne	
arabe	,Arabe	,Arabe	
bon	,bon	
protestant	,protestant	,protestante	
long	,vin	
blessé	,blessé	,blessée	
suisse	,Suisse	,Suisse	,Suissesse	
aveugle	,aveugle	,aveugle	
affirmatif	,affirmative	
muet	,muet	,muette	
infirme	,infirme	,infirme	
voyant	,voyant	,voyante	
handicapé	,handicapé	,handicapée	
innocent	,innocent	,innocente	
>>>	S_2
médecin	,patient	,patiente	,patient	,patiente	
sortir	,chien	
épicerie	,marchandise	
cauchemar	,cauchemar	
voter	,candidat	,candidate	
jour des Morts	,année	
représenter	,représentation	
remuscler	,muscle	
fleuri	,fleur	
brebis	,pasteur	
valoir	,valeur	
se caractériser	,caractéristique	
semeur	,semence	;graine	
enregistrer	,enregistrement	
fabuliste	,fable	,fable	
désir	,désir	,objet	
sondage	,sondé	,sondée	
victoire	,vaincu	,vaincue	
toasteur	,pain	;tartine	,toast	
messe de minuit	,fidèle	
parler	,langue	,langue	
boire	,boire	;boisson	
bureau	,personnel	,ordinateur	
valeur symbolique	,symbole	
contenir	,contenu	,contenu	
laver	,lessive	,linge	
cigarettier	,cigarette	
diagnostiquer	,diagnostic	
confidence	,confident	,confidente	
samedi	,semaine	
crime	,victime	,victime	
goût	,goût	
criminel	,crime	
chiqueur	,tabac	
appareiller	,bateau	
as	,couleur	
trayeuse	,lait	
débiteur	,créancière	,créancier	
sous l’effet	,cause	
mettre les petits plats dans les grands	,hôte	,hôte	;visiteur	,visiteuse	;convive	,convive	,visiteur	,visiteuse	
bétail	,éleveur	,éleveuse	
aéroport	,avion	
s’équiper	,équipement	
toaster	,toast	
regretter	,regret	
nager	,100 mètres	,200 mètres	,400 mètres	,1500 mètres	,vêtements	,vêtement	;chaussures	
porter	,enfant	,petit	
se déshabiller	,manteau	,veste	,blouson	
lycée	,lycéen	,lycéenne	
symbolique	,valeur symbolique	
billet	,spectacle	
frapper	,coup	
télévision	,diffuseur	
comprendre	,partie	
Enfer	,damné	,damnée	
Toussaint	,année	
prévision	,prévision	,prévision	
couleur	,couleur	
savonnerie	,savon	
jumeau	,bœuf	
papa	;enfant	
instituteur	,élève	,élève	
parents	;enfant	
jeudi	,semaine	
se prénommer	,prénom	
mot	,langue	
rêve	,rêve	,rêve	
marin	,bateau	
placard	,peau	
urne	,bulletin de vote	
balai	,percussions	
charbonnière	,charbon	
bourreau	,condamné	,condamnée	
rayon	,miel	
baguette	,orchestre	
visa	,détenteur	
avancer	,avance	
restaurant	,repas	,plat	;cuisine	
tomber	,moment	
sémantique	,phrase	,mot	
plateau	,fusil	;carabine	
bus	,passagère	,passager	,usager	,usagère	,voyageur	,voyageuse	
téléspectateur	,télévision	
séchoir	,plante	
portée	,mère	
lexicographie	,lexique	
moto	,passager	,passagère	
nationalisme	,nation	
voyou	,victime	
ambulancière	,ambulance	
produit	,facteur	
chasser	,proie	
destination	,déplacement	,voyage	
citation	,citation	
maman	;enfant	
diriger	,débat	,véhicule	
triangle	,danger	,accident	
lice	,chasse	,compétition	
circulation	,vaisseau	,veine	
tapis	,sport	
>>>	S_1^usual
lavoir	,lavandière	
casser les couilles	,casse-couilles	,casse-couilles	
porte	,meuble	
installer	,installateur	,installatrice	
nettoyage	,chirurgien	,chirurgienne	
dormir	,dormeuse	,dormeur	
pizza	,pizzaiolo	,pizzaiola	
Internet	,internaute	,internaute	
toiletter	,toiletteur	,toiletteuse	
photo	,photographe	,photographe	
fabuler	,fabulateur	,fabulatrice	
nettoyeur	,nettoyeur	,nettoyeuse	
poser	,installateur	,installatrice	
marchandise	,marchand	,marchande	
violent	,violent	
étoilé	,ciel	
devoirs	,élève	,élève	
nettoyeuse	,nettoyeur	,nettoyeuse	
couleur	,coiffeur	,coiffeuse	;coloriste	,coloriste	,coiffeur	,coiffeuse	;coloriste	,coloriste	
bus	,chauffeur	,conducteur	,conductrice	
porc	,éleveur	,éleveuse	;porcher	,porchère	
coupage de cheveux en quatre	,coupeur de cheveux en quatre	,coupeuse de cheveux en quatre	
tamponneur	,auto	
ouest	,Amérique du Nord	
camion	,camionneur	,routier	;chauffeur	,conducteur	,conductrice	
opéra	,cantatrice	,chanteur	,chanteuse	
étourderie	,étourdi	,étourdie	
cloche	,sonneur	
péter	,péteur	,péteuse	
entêtement	,têtu	,têtue	
graver	,graveur	,graveuse	
camping	,campeur	,campeuse	
boiter	,boiteux	,boiteuse	
alto	,altiste	,altiste	
colère	,coléreuse	,coléreux	,colérique	,colérique	
balayer	,balayeuse	,balayeur	
planche	,bois	
guichet	,guichetier	,guichetière	
peur	,peureux	,peureuse	
raser	,barbier	
commenter	,commentateur	,commentatrice	
moutarde	,cultivateur	,cultivatrice	
tennis	;joueur	,joueuse	,tennisman	,tennisman	,tenniswoman	
leçon	,donneur de leçons	,donneuse de leçons	
pois	,cultivateur	,cultivatrice	
mensonge	,menteur	,menteuse	
poule	,éleveur	,éleveuse	
préparer	,cuisinier	,cuisinière	
élever	,éleveur	,éleveuse	
critiquer	,critiqueur	,critiqueuse	
saucisse sèche	,charcutier	,charcutière	
lexicographie	,lexicographe	,lexicographe	
tabac	,planteur	;cultivateur	,cultivatrice	;producteur	,productrice	,buraliste	,buraliste	;débitant	,débitante	;marchand	,marchande	
mentir	,menteur	,menteuse	
fournir	,fournisseur	,fournisseuse	
design	,designer	
résorber	,médecin	,médecin	;chirurgien	,chirurgienne	
gérer	,gestionnaire	,gestionnaire	
reportage	,reporter	,reporter	,reporteur	,reportrice	,reporter	,reporter	,reporteur	,reportrice	
art	,artiste	,artiste	
brosser	,peintre	,peintre	
xylophone	,musicien	,musicienne	,percussionniste	,percussionniste	
collection	,livre	
poème	,poète	,poétesse	
architecture	,architecte	,architecte	
autopsie	,médecin légiste	,médecin légiste	
licencié	,salarié	,salariée	
critique	,critique	,critique	,critique	,critique	
filmer	,caméraman	
trompette	,trompettiste	,trompettiste	
émigrer	,émigré	,émigrée	
caricature	,caricaturiste	,caricaturiste	
roue	,véhicule	
scier	,scieur	,scieuse	
manier	,manieur	,manieuse	
philosophie	,philosophe	,philosophe	
curiosité	,curieux	,curieuse	
toile	,peintre	,peintre	
couper les cheveux en quatre	,coupeur de cheveux en quatre	,coupeuse de cheveux en quatre	
blague	,blagueur	,blagueuse	
carré	,bataillon	
écrire	,écrivaine	,écrivain	
ivre	,ivrogne	,ivrogne	,ivrognesse	
pâtisserie	,pâtissier	,pâtissière	
agneau	,éleveur	,éleveuse	
coiffage	,coiffeur	,coiffeuse	
plumes	,oiseau	
concombre	,cultivateur	,cultivatrice	
rongeur	,rongeur	
basket	;joueur	,joueuse	,basketteur	,basketteuse	
balai	,balayeur	,balayeuse	,percussionniste	,percussionniste	
autocar	,chauffeur	,conducteur	,conductrice	
électronique	,électronicien	,électronicienne	
malchance	,malchanceux	,malchanceuse	
bijouterie	,bijoutier	,bijoutière	
photographier	,photographe	,photographe	
imprimerie	,imprimeur	,imprimeuse	,imprimeur	,imprimeuse	
champ	,paysan	,agriculteur	,agricultrice	,paysanne	
sondage	,sondeur	
dessin	,dessinatrice	,dessinateur	
>>>	Magn
fâché	,hors de ses gonds	
ronflements	,bruyant	,sonore	
aplatir	,comme une crêpe	,comme une crêpe	
goût	,aiguisé	,développé	,boulimie	
liaison	,fort	
criminel	,grand	,tout à fait	,parfaitement	
bandit	,de grand chemin	
s’emporter	,comme une soupe au lait	
se barber	,comme un rat mort	
tir	,puissant	
fable	,à dormir debout	
bête	,à manger du foin	
ressemblance	,grand	,évident	,flagrant	,marqué	,notable	<parfait	,exact	,singulier	,évident	<frappant	,fort	,marqué	,profond	<incontestable	,incroyable	,fou	,extraordinaire	<parfait	,portrait	
maladie	,douloureux	<grave	,malin	<incurable	,inguérissable	<mortel	<foudroyant	,vrai	,grave	,vrai	
cinéma	,vrai	
adaptateur	,universel	
camion	,gros	,lourd	
cheveux	,beaucoup	,épais	,touffu	,masse	
jurer	,sur l’honneur	
nase	,gros	
collaborer	,étroitement	
bière	,fort	
horreur	,saint	
vin	,charpenté	,fort	,vineux	
célébrer	,en grande pompe	
similarité	,grand	,frappant	
s’intéresser	,se passionner	
flot	,geyser	,torrent	
intensité	,fort	
bouffer	,beaucoup	;avidement	;goulûment	;copieusement	;à belles dents	,de bon appétit	,de bon cœur	<à se faire péter la panse	,à se faire péter la sous-ventrière	,se faire péter la panse	,comme quatre	,comme un ogre	,énormément	,tout cru	
en colère	,très	,furieux	
engagement	,sur l’honneur	
intéressant	,passionnant	
vent	,fort	,grand	,soutenu	,puissant	<terrible	,violent	,furieux	,impétueux	,à décorner les bœufs	,à décorner les cocus	;ouragan	,tempête	,tourmente	;typhon	;cyclone	,gros	
insolation	,vif	
insecte	,sale	;sacré	,satané	
dormir	,à poings fermés	,profondément	;comme un loir	,comme une marmotte	,comme une bûche	,comme une masse	,comme une souche	,comme un sonneur	;comme un bébé	
lettre	,long	
lien	,intime	,étroit	
mentir	,comme on respire	,comme un arracheur de dents	
se lier	,fortement	
obéir	,au doigt et à l’œil	
lire	,éplucher	
à ravir	,bien	
avocate	,grand	<ardent	,fervent	
boire	,beaucoup	,sec	<trop	,à tire-larigot	,comme un trou	,jusqu’à plus soif	,beaucoup	,sec	<trop	
réfléchir	,mûrement	
rouge	,ardent	,brillant	,vif	;foncé	,sombre	,ardent	,brillant	,vif	;foncé	,sombre	,tout	;cramoisi	;écarlate	;pourpre	,tout	;comme un coq	,comme un coquelicot	,comme un homard	,comme une écrevisse	,comme une pivoine	,comme une tomate	;cramoisi	;écrevisse	;pourpre	;rougeaud	;rubicond	;écarlate	;sanguin	
skis	,grand	,long	
énervé	,enragé	
avoir	,bien	,complètement	
chargé	,surchargé	
coma	,profond	
sourire	,à belles dents	
klaxon	,fort	
casserole	,vrai	,vrai	
vache	,sale	,gros	
spécialiste	,grand	;expert	
certifer	,sur l’honneur	
ego	,surdimensionné	
chanter	,fort	<à tue-tête	,à pleins poumons	,à pleine voix	
imagination	,fou	,galopant	
tempête	,gros	,fort	,violent	<terrible	,effroyable	,furieux	,gros	,violent	,gros	,fort	,violent	<terrible	,effroyable	,furieux	,violent	
conte	,à dormir debout	,à dormir debout	
analogie	,singulier	,saisissant	,évident	,remarquable	,singulier	<frappant	,saisissant	,évident	,fort	,remarquable	,profond	,grand	<étroit	<absolu	,complet	,parfait	
grave	<gravissime	,très	
évènement historique	,grand	
émotion	,fort	,grand	
chien	,sale	
blesser	,grièvement	,gravement	,profondément	,profondément	
déclarer	,sur l’honneur	
juste bon	,tout	
dépendance	,étroit	
coup de soleil	,fameux	,gros	,méchant	,sacré	,sérieux	,vilain	
éclair	,vif	<aveuglant	,éblouissant	,foudroyant	,fulgurant	,violent	,terrible	;grand	,large	,vif	,brillant	<éblouissant	,aveuglant	,lumineux	
déprime	,dépression	
observer	,attentivement	
à propos	,fort	,très	
observation	,strict	
pluie	,abondant	,dru	,fort	,gros	,intense	<battant	,brutal	,violent	,grain	,rincée	,saucée	,sauce	<torrentiel	,diluvien	,trombe	,cataracte	,tempête	,déluge	,cordes	,abondant	
collaboration	,étroit	
trempé	,comme une soupe	
moment	,court	
vibrer	,fortement	
sale	,bien	;très	,cracra	,crade	,cradingue	,crado	,cradoque	,crasseux	<dégueu	,dégueulasse	;comme un cochon	,comme un peigne	,comme un porc	,comme un pou	,comme une truie	,de la tête aux pieds	,crade	,crado	,cradoque	,crasseux	<dégueulasse	,dégueu	,crasseux	,crado	,cracra	,cradingue	,craspec	,crade	,cradoque	<dégueulasse	,dégueu	,cracra	,crade	,cradingue	,crado	,cradoque	<dégueulasse	,dégueu	,crade	,cradingue	,crado	,cradoque	,craspec	<dégueulasse	,dégueu	,cracra	,crade	,cradingue	,crado	,cradoque	,craspec	<dégueulasse	,dégueu	,dégueulasse	,dégueu	
rebond	,fort	,net	
souci	,gros	,sérieux	<majeur	
ivre	,complètement	,mort	
aboyer	,furieusement	;férocement	
numéro	,fameux	,sacré	,drôle	
dizaine	,bon	,gros	
moyen	,très	,médiocre	
bureau	,de ministre	
soleil	,plein	,éblouissant	
cigare	,gros	<énorme	,gigantesque	,monstrueux	,barreau de chaise	
enfant	,tout	
attester	,sur l’honneur	
nez	,gros	
près	,bien	,très	;tout	,tout	,bien	,tout	,très	
rapidement	,à la vitesse de [Y]	
>>>	A_2
bague	,bagué	
habitude	,habituel	
consentement	,consenti	
miracle	,miraculé	
béton	,bétonné	
exagérer	,exagéré	,exagéré	
défaite	,gagnant	;vainqueur	;victorieux	
émouvoir	,ému	
emprise	,sous	
observer	,observé	,observé	
éblouir	,ébloui	
prendre à la gorge	,pris à la gorge	
rassurer	,rassuré	
composer	,composé	
préoccuper	,préoccupé	
angoisse	,angoissant	
considérer	,considéré	
battre	,battu	
franc	,franc	
imputer	,imputable	
encombrer	,encombré	
consentir	,consenti	
cercueil	,décédé	,défunt	,mort	
origine	,originaire	
amour	,amoureux	
pouvoir	,sous	
s’appauvrir	,appauvrissant	
suspecter	,suspect	
connaître	,connu	
garnir	,garni	
fossette	,creusé	
décalage	,décalé	
tache	,taché	
débat	,en	
entretenir	,entretenu	
conserver	,conservé	
haleter	,haletant	
déchirer	,déchiré	
agresser	,agressé	
connaissance	,connu	
découragement	,décourageant	
savoir	,su	,su	
recouvrir	,recouvert	,recouvert	
se distraire	,distrayant	
cousu main	,cousu main	,cousu main	
génération	,générateur	
accusation	,visé	,en butte	
ébahir	,ébahi	
occuper	,occupé	,occupé	,occupé	,occupé	
éclairer	,éclairé	
menottes	,menotté	
plaisir	,plaisant	
désespérer	,désespéré	
victoire	,vaincu	
bénévolat	,bénévole	
proche	,prochain	
localisation	,localisé	
éducation	,éducateur	
livrer	,livrable	
finir	,final	
dominer	,dominé	
menacer	,menacé	
vice	,vicié	
considération	,considéré	
remplir	,rempli	
fracture	,fracturé	
employer	,employé	
réduire à zéro	,réduit à zéro	
sinistre	,sinistré	
occupation	,occupé	
gauche	,gauche	
devoir	,dû	
épreuve	,éprouvé	
comprendre	,compris	,compris	,inclus	,compris	
écouter	,écouté	
erreur	,erroné	
serrer	,serré	
schéma	,schématique	
essouflé	,essouflant	
déprimer	,déprimé	
manger	,mangé	
agacer	,agacé	
affect	,chargé	,rempli	
lac	,noyé	
pension	,pensionné	
antenne	,à	,sur	,en ondes	
air	,sur	
étouffer	,étouffé	,étouffé	,étouffé	,étouffé	
adorer	,adoré	
vents	,à	
passionner	,passionné	
pollution	,polluant	
désirer	,désirable	
décevoir	,déçu	
exercer	,exercé	
électronique	,électronique	
éprouvé	,éprouvant	
miel	,mellifère	,mellifique	
inquiéter	,inquiet	
conservation	,conservé	
>>>	Contr
poivrière	,salière	
dialogue	,monologue	
réponse	,question	
présent	,passé	
orient	,occident	
verticalité	,horizontalité	
nom de famille	,prénom	
soleil	,lune	;étoile	
en repos	,en activité	
ovale	,rond	
majuscule	,minuscule	
macroscopique	,microscopique	,submicroscopique	
seul	,ensemble	
défendre	,attaquer	
maillot de corps	,slip	
plage avant	,plage arrière	,plage arrière	
tutoyer	,vouvoyer	,voussoyer	
moi	,toi	
patient	,agent	
sans excès	,avec excès	
avant-hier	,après-demain	
équivalence	,implication	
monarchie	,démocratie	,république	,démocratie	,république	
terrestre	,aérien	;aquatique	,marin	,aérien	;maritime	
atterrir	,décoller	
nord	,sud	
aquatique	,terrestre	;aérien	
moteur	,directeur	
masculin	,féminin	
signature	,en-tête	
dernière	,première	
prêt-à-porter	,sur-mesure	
audio	,vidéo	
réactant	,produit	
mobile	,filaire	
biberon	,seins	
liquide	,gaz	,solide	,chèque	
éclair	,tonnerre	
sortie	,entrée	
premier	,dernier	,dernier	
arrière-petit-fils	,arrière-petite-fille	
haut sur pattes	,court sur pattes	,court sur pattes	,court sur pattes	
eau douce	,eau de mer	
Il n’y a pas de quoi	,Merci	
propre	,brouillon	
paternel	,maternel	
caca	,pipi	
au revoir	,bonjour	
minuscule	,majuscule	
qualité	,quantité	
est	,ouest	,ouest	,ouest	
personnel	,direction	,patronat	
moyen	,exceptionnel	,extraordinaire	;nul	
avenue	,boulevard	
chat	,chien	
observation	,expérimentation	
lécher	,sucer	
implication	,équivalence	
démocratique	,monarchique	
qualitatif	,quantitatif	
plafond	,sol	
ceinture	,bretelles	
première	,dernière	
républicain	,monarchique	
matière ordinaire	,matière noire	
bruit	,silence	
plus-value	,moins-value	
Mademoiselle	,Madame	
maternel	,paternel	
motrice	,voiture	
boulevard	,avenue	
demoiselle	,dame	
régime réel normal	,régime réel simplifié	
hier	,aujourd’hui	,demain	,aujourd’hui	,demain	
entamé	,entier	
lexique	,grammaire	
microscopique	,macroscopique	
finale	,éliminatoire	
esprit	,matière	,corps	
cave	,grenier	
poésie	,prose	
grammaire	,lexique	
flore	,faune	
joie	,peine	
pile	,face	
fourchette	,cuillère	;couteau	
se lever	,s’allonger	,se coucher	,se coucher	,s’allonger	
votre	,notre	
genre	,nombre	
dent	,griffes	
filaire	,mobile	
tribord	,bâbord	
volant	,rampant	
chercher	,trouver	
là-bas	,ici	
intégration horizontale	,intégration verticale	
rampant	,volant	
esclave	,maître	
tête	,pieds	;corps	;jambes	,queue	,queue	
Corée du Nord	,Corée du Sud	
>>>	S_0Pred
fiancé	,fiançailles	
victorieux	,victoire	
tolérant	,tolérance	
étrange	,étrangeté	
tenace	,tenacité	
calculateur	,calcul	
fixe	,fixité	,fixité	
chaud	,chaleur	,chaleur	
constant	,constance	
souple	,souplesse	,souplesse	,souplesse	
différent	,différence	
excentrique	,excentricité	,excentricité	,excentricité	,excentricité	,excentricité	,excentricité	
évident	,évidence	
talentueux	,talent	
orgueilleux	,orgueil	
horizontal	,horizontalité	
fertile	,fertilité	
célibataire	,célibat	
frais	,fraîcheur	,fraîcheur	
gratuit	,gratuité	
poli	,politesse	
étourdi	,étourderie	
rude	,rudesse	
con	,connerie	
intelligent	,intelligence	
gentille	,gentillesse	
léger	,légèreté	
homosexuel	,homosexualité	
fier	,fierté	,fierté	
déprimé	,déprime	
compétent	,compétence	
distingué	,distinction	
hétérosexuel	,hétérosexualité	,hétérosexualité	
riche	,richesse	
inconscient	,inconscience	,inconscience	
probable	,probabilité	
innocent	,innocence	,innocence	
lâche	,lâcheté	
contradictoire	,contradiction	
ostentatoire	,ostentation	
vertical	,verticalité	
lent	,lenteur	
inaccessible	,inaccessibilité	
sourd	,surdité	
rapide	,rapidité	,rapidité	,rapidité	
bienveillant	,bienveillance	
idiot	,idiotie	
sûr	,certitude	,sûreté	
incommode	,incommodité	
célèbre	,célébrité	
originel	,origine	
strident	,stridence	
précis	,précision	
vorace	,voracité	
toxique	,toxicité	
pur	,pureté	
tranquille	,tranquilité	
blond	,blondeur	
réel	,réalité	
grave	,gravité	
majoritairement	,majorité	
vrai	,vérité	,vérité	
liquide	,liquidité	
calme	,calme	
extrême	,extrême	
débrouillard	,débrouillardise	
trébuchant	,trébuchement	
obscur	,obscurité	
digne	,dignité	
mélancolique	,mélancolie	,mélancolie	
clandestin	,clandestinité	
humble	,humilité	
aigre	,aigreur	,aigreur	
homosexuelle	,homosexualité	
prioritaire	,priorité	
voluptueux	,volupté	
curieux	,curiosité	
droitière	,droiterie	
impartial	,impartialité	
uniforme	,uniformité	
singulier	,singularité	
intense	,intensité	
jaloux	,jalousie	
satisfait	,satisfaction	
automatique	,automatisme	
imbécile	,imbécillité	
précoce	,précocité	
subtil	,subtilité	
brusque	,brusquerie	
paresseux	,paresse	
veuf	,veuvage	
antérieur	,antériorité	
ridicule	,ridicule	
possessif	,possessivité	
anormal	,anormalité	
timide	,timidité	
transpirant	,transpiration	
discret	,discrétion	
silencieux	,silence	
religieux	,religiosité	
>>>	S_1^prototyp
marcher	,appareil	;véhicule	
découverte	,chercheur	;père	
coin	,rue	
volée	,oiseau	
galbe	,partie du corps	;mollets	,seins	
pluie	,projectile	
zinzinuler	,fauvette	,mésange	
air	,opéra	,montagne	,campagne	,mer	
honneur	,dieu	,Dieu	
plier	,membre	,membre	
s’allonger	,figure	,gueule	,mine	,tête	,tronche	,visage	
taper sur la tête	,soleil	;alcool	
manteau	,chien	
replier	,membre	,membre	
toilette	,boucher	,bouchère	,boucher-charcutier	,bouchère-charcutière	,cuisinier	,cuisinière	
menu	,entrée	,plat	,dessert	
propre	,voiture	,transports	,énergie	
toison	,mouton	,bélier	
cabine	,bateau	
article	,journaliste	,journaliste	
miette	,pain	
braguette	,pantalon	
paragraphe	,texte	
cornes	,cervidés	,escargot	
embouteiller	,vin	
apprendre	,enseignant	,enseignante	,professeur	,professeure	,instituteur	,institutrice	,maître	,maîtresse	;instructeur	,instructrice	;formateur	,formatrice	
fenêtre	,enveloppe	
pâteux	,pâte	,pâte	,bouche	
remboursable	,dette	
champ magnétique	,aimant	,aimant	
quai	,voyageur	,voyageuse	
clé	,robinet	,sol	;fa	
quatre-heures	,enfant	,enfant	
ciel	,ange	,saint	,sainte	;mort	,morte	
quartier	,ville	
gauche	,partie du corps	
gueule	,arme à feu	;fusil	
fleuri	,expression	;langage	,expression	,langage	
fesse	,navire	
soie	,couteau	
vêtement	,couturier	,couturière	
parterre	,fleur	,théâtre	
stéthoscope	,médecin	,médecin	
bouché	,oreilles	
téter	,bébé	;nourrisson	
régime	,moteur	,obèse	,obèse	,verbe	
coude	,cours d’eau	
droite	,boxeur	,boxeuse	
protection hygiénique	,femme	
manger	,prédateur	;ogre	
passerelle	,bateau	
bateau	,chaussures	;col	,décolleté	,encolure	;lit	
dossier	,banc	,canapé	,chaise	,fauteuil	,siège	
s’étirer	,chat	,chatte	
appareil	,tarte	,soufflé	
récepteur	,antenne	
cru	,crudités	
nettoyer	,nettoyeur	
dîner	,dîneur	,dîneuse	
gigot	,agneau	
débrancher	,cheminot	
sommet	,angle	;polygone	,triangle	
mellification	,abeilles	
concurrence	,entreprise	,entreprise	
balayer	,tempête	,tornade	,balai	,balayeuse	
centre	,cercle	
déchirer	,éclair	;cri	
coquille	,mollusques	,coquillage	,noix	,épée	,boxeur	
galop	,cheval	
roulement	,tambour	
seuil	,maison	,porte	
kératine	,ongles	,poil	,cheveu	,ongles	
couvercle	;boîte	,caisse	;casserole	,marmite	
titiner	,mésange	
clouer au lit	,maladie	
rouille	,blé	
capuche	,manteau	,sweat-shirt	
versant	,colline	;montagne	;vallée	
fruitier	,arbre	
haut-parleur	,téléviseur	;radio	
essaimer	,abeille	
dentifrice	,tube	;pâte	,gel	;poudre	,eau	,élixir	
dur	,dur	
cadavre	,bouteille	,canette	
train	,pneu	
corne	,rhinocéros	
vagissement	,crocodile	
amputé	,membre	
hélice	,avion	;bateau	
amas	,nuage	
poil	,tapis	,brosse	,pinceau	,pinceau	
bouclier	,soldat	
menottes	,policier	,policière	
majorité	,électeur	,électrice	
bouclier humain	,prisonnier	;otage	,otage	
analogie	,organe	
traîne	,robe	
poissonneux	,étang	
main verte	,jardinier	,jardinière	
bonnet	,soutien-gorge	
>>>	Redun
serviette	,table	,hygiénique	;périodique	;sanitaire	
coureuse	,automobile	,d’hommes	
plage	,horaire	
réaction	,chimique	,nucléaire	
nombre	,grammatical	
aube	,matinal	
préparation	,alimentaire	,culinaire	
dés	,à jouer	
tomber	,par hasard	
huile	,alimentaire	
excentricité	,orbital	
air	,de musique	
précipitation	,atmosphérique	
serveur	,informatique	
numéro	,téléphone	,périodique	,rue	
point	,final	
étreinte	,sexuel	
partenaire	,sexuel	,sexuel	
Noël	,chrétien	
gare	,ferroviaire	
objet	,céleste	
environnement	,informatique	,logiciel	
pur	,chimiquement	
chaussette	,évacuation	
ensemble	,musical	
réactivité	,chimique	
circulation	,sanguin	
réunion	,sportif	
gymnastique	,intellectuel	
panoplie	,arme	
droite	,politique	
triangle	,pubien	,signalisation	
épreuve	,sportif	
temple	,protestant	,religieux	
chevaux	,fiscal	
Pâque	,juif	
conjoncture	,économique	
escompte	,règlement	
tampon	,hygiénique	
débranchement	,électrique	
boîte aux lettres	,électronique	
communication	,téléphonique	
bilan	,comptable	
partie	,génital	
traduire	,justice	
flûte	,pain	
pot	,fleur	,commun	
dizaine	,chapelet	,chapelet	
formule	,tout fait	
forme	,linguistique	
sentiment	,amoureux	
comme il faut	,bien	
punaise	,sale	
désir	,physique	,sexuel	
procédure	,judiciaire	
chèque	,bancaire	
corps	,sans vie	,constitué	
jumeaux	,deux	
réactant	,chimique	
dégoût	,physique	
champ	,visuel	,vision	,tir	
poitrine	,féminin	
États-Unis	,Amérique	
manteau	,terrestre	
amour	,sexuel	;physique	,physique	
drap	,lit	
instrument	,de musique	
réacteur	,chimique	,nucléaire	
père	,éternel	,céleste	
se cailler	,de froid	
marcher	,au pas	
diversité	,ethnique	
vaisseau	,sanguin	
vapeur	,eau	
voie	,ferré	
carré	,infanterie	
infarctus	,myocarde	
théorie	,scientifique	
poids	,poitrine	
haricot	,vert	
position	,sexuel	
bouteille	,alcool	
coté	,Bourse	
station	,radiophonique	
ticket	,entrée	
matière	,physique	
liaison	,chimique	,amoureux	,intime	
navigateur	,Internet	,Web	
sujet	,syntaxique	;grammatical	
animal	,familier	
élément	,chimique	,chimique	
rive	,toit	
pays d’accueil	,touristique	
blague	,tabac	
brevet	,invention	
figure	,schématique	,littéraire	;style	
retenue	,eau	
compte	,bancaire	
fond	,sonore	
composé	,chimique	
>>>	AntiBon
marcher	,mal	;au ralenti	
bouche	,pâteux	
langage	,baragouin	
figure	,de carême	
air	;lourd	;pollué	,vicié	
nuage	,lourd	,menaçant	,lourd	,menaçant	
atmosphère	,vicié	
bateau	,mauvais	,rafiot	
temps	,mauvais	<de chien	
journaliste	,mauvais	,folliculaire	,journaleux	,plumitif	;pisse-copie	,pisseur de copie	,mauvais	,folliculaire	,journaleuse	;pisse-copie	,pisseuse de copie	
banlieue	,zone	
chaussures	,usé	;éculé	
bouteille	,mauvais	
couple	,malheureux	
écrire	,gribouiller	
tête	,de _N de long	
femme politique	,politicarde	
serviette	,humide	<mouillé	;sale	
assis	,mal	
humeur	,de chien	
recevoir	,comme un chien dans un jeu de quilles	
parler	,baragouiner	,comme une vache espagnole	,baragouiner	
violon	,crin-crin	
lac	,sombre	,impur	,boueux	,fangeux	;noir	,opaque	;houleux	
installé	,mal	
formes	,disgracieux	
sens	,contresens	,mauvais	
dessin	,gribouillage	
film	,navet	
divorce	,pour faute	;aux torts exclusifs	;par assignation	;aux torts partagés	
couteau	,mauvais	
gueule	,de _N de long	
moral	,à zéro	,dans les chaussettes	
courriel	,frauduleux	,hameçonnage	,spam	,pourriel	
personnel	,incompétent	,incompétent	
chien	,indiscipliné	;agressif	,hargneux	,teigneux	<enragé	
élève	,mauvais	,cancre	,mauvais	,cancre	
toilette	,négligé	
chanter	,comme une casserole	
ostensible	,ostentatoire	
jambes	,faible	,mauvais	,faible	,mauvais	
se lever	,se lever du pied gauche	
politique	,mauvais	<catastrophique	,désastreux	,politicard	
s’entendre	,comme chien et chat	
sujet	,chiffon rouge	
avocat	,mauvais	<piètre	;avocaillon	
manger	,mal	,gras	
aller	,mal	
nager	,mal	
thèse	,mauvais	<médiocre	
odeur	,irrespirable	
sentir	,mauvais	
gosse	,sale	;chiard	,sale	
homme politique	,politicard	
manteau	,élimé	,râpé	,usé	
chaussettes	,troué	;usé	
alcool	,bibine	
corps	,difforme	
lit	,grabat	
théatre	,de boulevard	
forme	,petit	<mauvais	,petit	,mauvais	
restaurant	,gargote	
jour	,sans	
politicienne	,politicarde	
chaussons	,usé	,usé	
médecin	,mauvais	;médicastre	,mauvais	;médicastre	
attitude	,gauche	
dormir	,à la dure	,mal	,insuffisamment	
linge	,froissé	,souillé	
vin	,âpre	,gâté	,mauvais	,piqué	,piquette	,vinasse	
crier	,braire	,braire	
théâtre	,de boulevard	
avocate	,mauvais	<piètre	;avocaillonne	
pull	,troué	,usé	
sommeil	,agité	,détraqué	,mauvais	,perturbé	,troublé	
navire	,mauvais	,rafiot	
boisson alcoolisée	,bibine	;pipi de chat	
pluie	,dévastateur	,dévastateur	
colline	,abrupt	
triangle	,infernal	
passager	,clandestin	
tapis	,élimé	,râpé	,pelé	
nappe	,sale	,taché	,contaminé	;pollué	
croûte	,dur	
rouge	,gros	;qui tache	
repas	,immangeable	,indigeste	;gras	
négocier	,chipoter	
rapport	,toxique	
chiffre	,mauvais	
mélange	,mariage de la carpe et du lapin	
vélo	,clou	
finir	,bâcler	
prêcher	,prêcher un converti	
année	,sans	,sans	
vêtement	,usé	;fripé	,râpé	
fond	,bas-fond	,vieux	,mauvais	,méchant	
politicien	,politicard	
bicyclette	,clou	
mouchoir	,sale	
écrivain	,gribouilleur	;pisseur de copie	
>>>	Mero
train	,locomotive	;voiture	,wagon	,essieu	,roue	,pneu	
cours d’eau	,eau	
jambes	,chevilles	;mollets	;genou	;cuisses	;pieds	
pluie	,eau de pluie	
nuage	,vapeur	
bride	,sous-gorge	
tortue marine	,bec	;carapace	;nageoire	
balai	,manche	,pommeau	
museau	,truffe	,museau	
course	,galop	,trot	
lupins	,lupin	
colline	,bas	,pied	;flanc	,versant	;haut	<sommet	
escargot	,coquille	;antennes	,cornes	
rivière	,méandres	;amont	,aval	;berge	,bord	,rive	;gué	,fermoir	
zigzag	,tournant	,virage	
guacamole	,avocat	
mélodie	,mélodie	
crachat	,salive	
piano	,clavier	
gamme	,do	,sol	
trottinette	,roue	;guidon	,roue	;guidon	
concombre	,concombre	
trottoir	,bateau	
flocons	,cristal	
boule de neige	,neige	
tortue	,bec	;carapace	
pomme de terre	,pomme de terre	
bonhomme de neige	,neige	
mère	,bactérie	
siège	,dossier	,pied	,siège	
tramway	,tramway	
abattant	,couvercle	,lunette	
gymnastique	,pompe	
roue à aubes	,aube	
plan comptable général	,bilan	
substance	,particule	
fleuve	,méandres	;amont	,aval	;embouchure	;estuaire	,delta	;bouche	;berge	,bord	,rive	
moto	,guidon	;moteur	;réservoir	;roue	;side-car	
boîte aux lettres	,boîte d’envoi	,boîte de réception	
boulevard	,voie	,chaussée	;trottoir	
gueule	,museau	
mot	,lettre	
lune	,croissant	
courriel	,en-tête	,signature	,pièce jointe	,adresse électronique	
métro	,rame	,métro	;métro	,station	,quai	;voie	
patate	,patate	
soutif	,bonnet	
étang	,bonde	;bord	
rue	,chaussée	,voie	;trottoir	
Système solaire	,Soleil	;Terre	,Mars	;Lune	
semaine	,semaine	,week-end	
arbre	,branche	,tronc	;feuille	,feuillage	,couronne	
sms	,sms	
canapé	,accoudoir	,coussin	,dossier	
églantier	,églantine	
récif corallien	,corail	
désert	,sable	,dune	,pierre	,roche	
forêt	,sous-bois	
avenue	,chaussée	,voie	;trottoir	
couronne	,branche	,feuille	
brosse	,dos	;poil	,fibre	;manche	,poil	,fibre	;manche	,poil	,fibre	
nez	,bout	;dos	;lobe	;narines	,trou de nez	;racine	;os	;aile	
rosier	,rose	
lac	,bord	,rive	
rayon	,alvéole	
rame	,voiture	
cheveu	,naissance	;racine	;bulbe	
soutien-gorge	,bonnet	
fil de lin	,lin	
tabouret	,pied	,siège	
omelette	,œuf	
chicorée	,chicorée	
ciel	,septième ciel	
voiture	,moteur	,réservoir	;coffre	;volant	,tableau de bord	,pédale	;siège	,ceinture	;roue	,train	;habitacle	,compartiment	;siège	,couchette	,brancard	,essieu	,roue	,marchepied	
main	,dos	
Corée	,Corée du Nord	,Corée du Sud	
glaçon	,glace	,glace	
tétons	,tétons	
bateau	,coque	,quille	,passerelle	,pont	;cabine	,carré	,cockpit	,mess	,poste d’équipage	,écoutille	,hublot	;cale	,ballast	,soute	,mât	;cheminée	;proue	,étrave	;bord	,bâbord	,tribord	;poupe	,étambot	
iceberg	,glace	
tomate	,tomate cerise	,cœur de bœuf	
glace	,eau	,sucre	,sucre glace	
bouchon	,liège	
toilette	,miroir	,table	
graine de lupin	,lupin	
autoroute	,chaussée	,voie	,bande de circulation	;bande d’arrêt d’urgence	;péage	;entrée	,sortie	
lin	,fil de lin	,lin	
ongles	,kératine	
viorne	,cheveu-de-la-Vierge	
novembre	,Toussaint	
glaviot	,salive	
route	,chaussée	,voie	;bord	;revêtement	
cube de glace	,glace	
château de cartes	,carte	
terrier	,entrée	,gueule	,ouverture	,trou	;couloir	;cavité	
haricot	,haricot	,haricot	
R.E.R	,R.E.R	
fleur	,pétales	,fleur	
voie ferrée	,rails	
lentilles	,foyer	
>>>	Fact_0
balayeuse	,balayer	
collaborateur	,collaborer	
travailleuse	,travailler	
coureur	,courir	
prédiction	,se réaliser	
train	,rouler	,circuler	,avancer	,se déplacer	
douche	,couler	,fonctionner	
camionnette	,circuler	,rouler	
campeur	,camper	
prévision	,se réaliser	
réactif	,réagir	
vélo	,rouler	;circuler	
bouilloire	,chauffer	
nageur	,nager	
bicyclette	,rouler	,circuler	
soleil	,briller	,luire	
tricycle	,rouler	,circuler	
mouche	,voler	,voleter	,voltiger	
guêpe	,voler	
pâte	,cuire	
cheval	,marcher	;trotter	;galoper	
montgolfière	,s’élever	;voler	
skis	,glisser	
car	,rouler	
aspirateur	,aspirer	
lac	,se déverser	,stagner	;se répandre	,se déverser	,s’étaler	,s’écouler	,se décharger	
navire	,naviguer	
bronzeur	,bronzer	
médecin	,exercer	;consulter	,exercer	;consulter	
campeuse	,camper	
musicien	,jouer	
avocate	,exercer	
draisienne	,rouler	,circuler	,rouler	
coup	,retentir	
autocar	,rouler	
cheveux	,pousser	
hélicoptère	,voler	
dormeur	,dormir	,dormir	
tombeau	,contenir	,renfermer	,receler	
tombe	,contenir	,renfermer	;receler	
boulanger	,boulanger	
numéro	,sortir	,sortir	,paraître	
sorcier	,envoûter	
chimie	,opérer	,opérer	
courriel	,fonctionner	,marcher	
bus	,rouler	;circuler	
avion	,voler	
tramway	,circuler	,se déplacer	,rouler	;fonctionner	,marcher	
volcan	,exploser	,exploser	
marche	,retentir	,sonner	
cœur	,battre	
avocat	,exercer	
figure	,indiquer	,illustrer	,représenter	
collaboratrice	,collaborer	
balai	;balayer	
véhicule volant	,voler	
camion	,circuler	,rouler	
voiture	,rouler	;avancer	,circuler	;se déplacer	,rouler	
cycliste	,pédaler	,pédaler	
tortue	,traîner	
roue	,tourner	,tourner	
oiseau	,voler	
pompier	,intervenir	,intervenir	
métro	,circuler	,rouler	,fonctionner	,marcher	
musicienne	,jouer	
travailleur	,travailler	
boulangère	,boulanger	
plage	,se dérouler	,jouer	
concert	,retentir	
véhicule	,rouler	,se déplacer	;avancer	,circuler	,se déplacer	
alcoolique	,boire	,boire	
fond	,remonter	,remonter	
couleurs	,flotter	
transporteur	,transporter	
archéologue	,fouiller	
chant	,retentir	,retentir	,retentir	
magie	,opérer	
escargot	,ramper	,traîner	
rideau	,cacher	,masquer	,occulter	,séparer	,diviser	;cacher	,masquer	
chien	,percuter	
casserole	,chauffer	
lessive	,sécher	
écureuil	,grimper	,sauter	,conserver	,garder	;économiser	
flocons	,tomber	;voler	;neiger	
bateau	,naviguer	
dormeuse	,dormir	,dormir	
oreilles	,entendre	
cercueil	,contenir	,renfermer	,receler	
rêveuse	,rêver	
collabo	,collaborer	,collaborer	
artiste	,se produire	,se produire	
coureuse	,courir	
couple	,embrasser	;enlacer	
moustique	,voler	
fleuve	<couler	
corps	,fonctionner	
crocodile	,marcher	;nager	;ramper	
cigare	,se consumer	
placard	,annoncer	<clamer	
aéronef	,voler	
>>>	Gener
angliche	,langue	
chaise	,siège	;pièce d’ameublement	
prix	,récompense	
proton	,particule subatomique	,nucléon	
benoîte	,fleur	;plante	
verre	,matériau	,récipient	,boisson	;boisson alcoolisée	
pervenche	,plante	;fleur	,coloré	
blouse	,vêtement	,vêtement	
Bourse	,lieu	
fessier	,muscle	
ourse	,animal	,bête	
duchesse	,meuble	;pièce d’ameublement	
destructeur	,appareil	
rat	,animal	;rongeur	
dimanche	,jour	
épaules	,partie du corps	,partie du corps	
aiguisoir	,outil	
charme	,arbre	
olive	,fruit	,coloré	
batteur	,musicien	
prune	,fruit	
noix	,fruit	
doctorat	,diplôme	
clafoutis	,entremets	;gâteau	
calcéolaire	,plante	,fleur	
averse	,précipitation	
poussin	,oiseau	,oiseau	
mode	,secteur	
coût de revient	,coût	
bottes	,chaussures	
corail	,train	,animal	
jacinthe	,plante	;fleur	
librairie	,secteur	
éloge	,discours	
corps pur	,substance	
papillon	,insecte	,insectes	
tintement	,bruit	
trente	,nombre	
assiette	,pièce de vaisselle	
corbeau	,oiseau	,oiseaux	;corbeau	,oiseaux	
oiseau	,animal	
salle à manger	,pièce	
convertible	,meuble	;pièce d’ameublement	
chaise de bébé	,chaise	
asphodèle	,fleur	;plante	
opération escargot	,mouvement social	
stop	,panneau	
canne	,plante	
poirier	,arbre	
R.E.R	,réseau	,moyen de transport	;train	
ressentiment	,sentiment	
grenouille	,batracien	;amphibiens	,batraciens	
poiscaille	,animal	
serveur	,appareil informatique	
fraction	,nombre	
burin	,outil	
élément	,corps pur	
six-pièces	,habitation	,logement	
bar	,poisson	,poissons	,poisson	
violon	,instrument à cordes	
cotisation	,dépense	
frigidaire	,appareil	,appareil électroménager	
crêpe	,mets	
sachet	,contenu	
syncrétisme	,doctrine	,idéologie	,philosophie	
double	,match	
fierté	,sentiment	
coudée	,mesure	
obligation	,titre	
noyer	,arbre	
bœuf stroganoff	,plat	
cygne	,animal	
bijoutier	,artisan	
société à responsabilité limitée	,société	
maille	,monnaie	
fleuve	,cours d’eau	
meringue	,biscuit	
sept	,nombre	
historien	,scientifique	
musique classique	,musique	,musique	
vêtement	,pièce d’habillement	,secteur	
banc des punitions	,banc	
abricotier	,arbre	
réalisatrice	,professionnelle	;profession	
émeraude	,pierre précieuse	,pierre précieuse	
casse-poitrine	,boisson	;boisson alcoolisée	
saucisson	,charcuterie	
Mars	,planète	;astre	
lit de repos	,pièce d’ameublement	
plaine	,élément du relief	
mandarine	,fruit	
poire	,fruit	
sandale	,chaussures	
piquette	,boisson	;boisson alcoolisée	
enseignement	,secteur	
apéro	,boisson	;boisson alcoolisée	
gros chat	,fauves	
banc public	,siège	,banc	
essence	,substance	
10 000 mètres	,épreuve	;évènement sportif	
>>>	S_loc
voie	,gare	
anémone de mer	,mer	
border	,bateau	,voilier	
prune	,prunier	
lointain	,lointain	
Soleil	,Système solaire	
rouge	,rougeur	
nager	,piscine	;cours d’eau	;étang	,lac	,mer	,océan	;piscine	
cinéma	,studio	
course	,champ de course	,hippodrome	
corail	,mer	;récif corallien	
cercueil	,sépulture	,tombe	,tombeau	
figue	,figuier	
pomme	,pommier	
rugby	,terrain	;stade	
tomate	,tomate	
diable	,Enfer	
poule	,poulailler	
abricot	,abricotier	
boulanger	,fournil	
football	,terrain	;stade	
gymnastique	,salle	;gymnase	,salle	;gymnase	
à l’eau	,eau	,eau	
bronchite	,poumons	
orphelin	,orphelinat	
guêpe	,nid	,guêpier	
soleil	,ciel	
parfum	,flacon	
moustique	,marais	,mare	,marécage	
Occidental	,ouest	
langue	,bouche	
aboutir	,aboutissement	
pompier	,caserne	,caserne	
Wimbledon	,Londres	<Angleterre	,Wimbledon	
Allemagne	,en	
fessier	,fesses	
déchets	,déchetterie	
tortue marine	,mer	,océan	;eau de mer	
uriner	,urinoir	;toilettes	
coton	,cotonnier	
tortue de mer	,mer	,océan	;eau de mer	
basket	,terrain	
faire de l’essence	,station-service	
sport	,salle	;terrain	;palais des sports	
framboise	,framboisier	
lapin	,terrier	
Système solaire	,Voie lactée	
étalage	,étal	
fleuve	<lit	
haleine	,bouche	
serpent de mer	,mer	,mer	,journal	;presse	
avocat	,avocatier	
bandit	,repaire	
promenade	,prison	
sous-bois	,bois	,forêt	
nuage	,ciel	;horizon	
noix de coco	,cocotier	
cadavre	,cercueil	,bière	
rue	,rue	
père	,couvent	
cheval	,écurie	;box	,stalle	;haras	
vache	,étable	,vacherie	
chair de poule	,peau	
café	,caféier	
figue de Barbarie	,figuier de Barbarie	
baignoire	,salle de bain	
eau douce	,cours d’eau	;étang	,lac	
neige	,écran	
articuler	,articulation	
courriel	,adresse électronique	;boîte aux lettres	
valoches	,yeux	;visage	
herbe	,pelouse	
eau	,cours d’eau	;étendue d’eau	
noix	,noyer	
lotus	,yoga	
lièvre	,terrier	
foire	,champ de foire	
imprimer	,imprimerie	
emprisonner	,prison	
prisonnier	,prison	
aube	,matin	
cernes	,yeux	;visage	
fraise	,fraisier	
cigare	,bureau de tabac	,tabac	,débit de tabac	;cave à cigares	
orchestre	,fosse d’orchestre	
rideau	,scène	
encre	,encrier	
cerise	,cerisier	
poire	,poirier	
laver	,lavoir	,laverie	,buanderie	,buanderie	,lavomatique	,douche	,lavabos	,salle de bain	,salle d’eau	,salle de douche	
voter	,bureau de vote	
sans domicile fixe	,rue	;rue	;rue	;rue	
vitrine	,vitrine	
main gauche	,gauche	,gauche	
vaisselle	,vaisselier	
se laver	,salle de bain	,salle de douche	,salle d’eau	
volley-ball	,terrain	
réunion	,salle de réunion	
grappe	,vigne	
bœuf	,étable	,bouverie	
>>>	Oper_1
sensation	,avoir	,éprouver	,ressentir	
boxe	,faire	
basket	,faire	;jouer	,faire	,se faire	
choix	,faire	
allégresse	,éprouver	,ressentir	
cor	,jouer	
colère	,avoir	,éprouver	,ressentir	,piquer	,faire	
bœuf	,faire	
jaunisse	,avoir	,souffrir	
ping-pong	,faire	;jouer	,faire	,se faire	
syndrome des jambes sans repos	,avoir	,souffrir	
caca	,faire	
excuses	,présenter	
cafard	,avoir	,éprouver	,ressentir	
gratitude	,avoir	,éprouver	,ressentir	
ami	,être	,être	,être	
bicross	,faire	
mesure	,effectuer	,prendre	,prendre	
animosité	,avoir	,éprouver	;faire preuve	,manifester	,montrer	,faire preuve	,manifester	,montrer	
coudées franches	,avoir	
don	,faire	
voile	,faire	,mettre	,jeter	
douche	;être	;passer	;prendre	
études	,faire	
rage	,avoir	,souffrir	
vaisselle	,faire	
beaux restes	,avoir	,avoir	,avoir	
injure	,adresser	,dire	,proférer	,lancer	
compassion	,avoir	,éprouver	,ressentir	;faire preuve	,manifester	,montrer	
manque	,éprouver	,ressentir	
tour	,jouer	
sentiment	,avoir	,éprouver	,avoir	,éprouver	,ressentir	;nourrir	,avoir	,avoir	,éprouver	
office	,célébrer	
jeûne	,observer	,faire	;pratiquer	
bonheur	,avoir	,éprouver	,ressentir	;goûter	
chantage	,faire	,exercer	,se livrer	,recourir	,user	,pratiquer	,faire	,exercer	,se livrer	,recourir	,user	,pratiquer	
mère	,être	,être	,être	
les pieds sous la table	,mettre	
bougeotte	,avoir	
colle	,poser	
karaté	,faire	;combattre	
honneurs de la presse	,avoir	,recevoir	
mains sales	,avoir	
mal du pays	,avoir	,éprouver	,ressentir	
empathie	,avoir	,éprouver	,ressentir	;faire preuve	,manifester	,montrer	
mal au cœur	,avoir	,avoir	
journal intime	,tenir	
manche	,actionner	,utiliser	
route	,faire	,faire	,suivre	,poursuivre	,marcher	<avancer	,progresser	,suivre	
saut	,faire	
bâtons dans les roues	,mettre	,jeter	,foutre	
coup de reins	,donner	
fausse route	,faire	,faire	
vélo	,faire	
tuberculose	,avoir	,souffrir	
coup de fourchette	,avoir	
citation	,faire	
badminton	,faire	;jouer	,faire	,se faire	
promesse	,faire	,faire	
pêche	,avoir	
maladie honteuse	,avoir	,souffrir	
vacherie	,faire	,dire	,sortir	
mal de l’air	,avoir	,éprouver	,ressentir	
messe de minuit	,célébrer	,dire	
étonnement	,avoir	,éprouver	,ressentir	
prévision	,faire	
dent	,avoir	
quarantaine	,faire	,suivre	,être	
tandem	,faire	
veste	,prendre	,se prendre	,ramasser	,se ramasser	;essuyer	,subir	,prendre	,se prendre	,ramasser	;se ramasser	,se manger	
aversion	,avoir	,éprouver	,ressentir	
vélo tout chemin	,faire	
environnement	,appartenir	,faire partie	;constituer	
siège	,faire	
ventre	,avoir	
répugnance	,avoir	,éprouver	,ressentir	
foot	,foot	
nausée	,avoir	,éprouver	,ressentir	,avoir	,éprouver	,ressentir	
tennis	,faire	;jouer	,faire	,se faire	
oreille absolue	,avoir	
judo	,faire	
musique	,faire	,jouer	
atomes crochus	,avoir	
longueur	,faire	
petit vélo dans la tête	,avoir	
taureau	,être	
tête dure	,avoir	
volte-face	,faire	,faire	
pneumonie	,avoir	,souffrir	
acte de présence	,faire	
sermon	,prononcer	,faire	
coup de maître	,faire	
le pied au plancher	,avoir	
règles	,avoir	
coup de soleil	,avoir	
lessive	,faire	,faire	
carcinome mammaire	,avoir	,souffrir	
ciné	,se faire	
question	,poser	
frustration	,avoir	,éprouver	,ressentir	
>>>	Cf
do	,ré	,mi	,fa	,sol	,la	,si	
séjour	,salle à manger	
droite	,segment	
lavande	,thym	
œuf	,poule	
conte	,légende	
nappe	,serviette	
paille	,tige	
mule	,âne	
allumette	,briquet	
bourgeon	,bouton	
exercice	,devoirs	
air	;vent	
testicule	,partie	
rumeur	,téléphone arabe	
s’allonger	,s’asseoir	,s’asseoir	
changement chimique	,changement physique	
réactif	,réactif	,réactif	,réactant	
harnais	,selle	
processus	,évènement	
héréditaire	,génétique	
chaîne	,collier	
légende	,conte	
doigts	,aube	
annuel	,mensuel	,trimestriel	
un	,le	
excréments	,urine	
être	,avoir	
presse	,imprimante	
analogie	,métaphore	
marche	,course à pied	
recoucher	,coucher	
anémone de mer	,corail	
répugnance	,hésitation	
tampon	,serviette	
plume	,stylo	
obstacle	,barrière	
oxalide	,oseille	
gelée royale	,miel	
coquille	,carapace	
géranium	,pélargonium	
chipoteur	,méfiant	,avare	,radin	,avare	
abeille	,bourdon	;frelon	,guêpe	
nuque	,tête	;épaules	
jour des Morts	,Toussaint	
oseille	,oxalide	,oxalis	,oseille sauvage	
trio	,trois	,trois	
ré	,do	,mi	,fa	,sol	,la	,si	
tigresse	,furie	
plateau	,plaine	,montagne	,vallée	
tiédeur	,fraîcheur	;chaleur	
nostalgie	,mélancolie	,tristesse	
signature	,paraphe	,signature	
souris	,rat	
ville	,plage	
cœur	,carreau	
tendon	,muscle	
moyen métrage	,court métrage	,long métrage	
limitant	,en excès	
pâquerette	,marguerite	
iceberg	,glaçon	
crapaud	,grenouille	
anniversaire	,fête	
barrette	,peigne	
image	,photo	
nœud papillon	,cravate	
centimètre	,mètre	
déshydraté	,assoiffé	
victime	,coupable	,coupable	
ingambe	,jambes	
mobylette	,moto	,vélo	
nez	,bouche	;gorge	
costume	,tailleur	
lavage	,rinçage	,séchage	,rinçage	,séchage	,repassage	,rinçage	,essorage	,séchage	
allonger	,asseoir	
scanneur	,imprimante	
escargot	,limace	
élocution	,parole	
cervelle	,cerveau	
coupable	,victime	,victime	
corporel	,corps	
ochlophobie	,agoraphobie	
duodecies	,quinquies	;sexies	
figue	,datte	
baignoire	,douche	
buée	,vapeur	
frelon	,guêpe	
explosif	,bombe	
peigne	,barrette	
thym	,lavande	
carapace	,coquille	
xénophobie	,hostilité	;intolérance	
mélange	,corps pur	
stèle	,tombe	
debout	,réveillé	
flûte	,baguette	
putain	,prostituée	
lièvre	,lapin	
pompe	,distributeur	
équerre	,règle	
>>>	Sing
feu	,coup de feu	
farine	,paquet	;sac	
mayo	,flacon	,pot	,tube	
badminton	,match	,partie	
opéra	,air	
droite	,point	
rugby	,match	,partie	,rugby	;rencontre	<compétition	,tournoi	<championnat	
magistrature	,magistrat	,magistrate	
maladie	,attaque	,crise	
cours	,séance	,cours	
dentifrice	,flacon	,tube	,dentifrice	
correspondance	,lettre	
jambon	,tranche	
tarte	,part	
feuillage	,feuille	
judo	,combat	<compétition	,tournoi	<championnat	
basket	,match	,partie	,basket	;rencontre	<compétition	,tournoi	<championnat	
rôti	,tranche	
champagne	,coupe	,flûte	,verre	,champagne	<bouteille	
semaine	,jour	
guerre	,bataille	
or	,pépite	
moutarde	;flacon	,pot	,tube	,verre	
bruyère	,brin	;touffe	
lentilles	,boîte	,paquet	
métro	,ligne	
membrure	,membre	
cartouche	,paquet	,cigarette	
gymnastique	,séance	;gymnastique	,épreuve	<compétition	<championnat	
vinaigre	,bouteille	
averse	,goutte	
soupe	,assiette	,assiettée	;bol	
football	,match	,partie	,football	;rencontre	<compétition	,tournoi	<championnat	
colère	,bouffée	
racaille	,racaille	
batterie	,arme	
cheveu	,cheveu	
raisin	,grain	,raisin	;grappe	
sauciflard	,rondelle	
végétation	,végétal	
mayonnaise	,flacon	,pot	,tube	
musique	,morceau	,pièce	
chéquier	,chèque	
armement	,arme	
flottille	,bateau	
saucisse sèche	,rondelle	
bouteille	,verre	
terre	,motte	
nostalgie	,bouffée	
dentition	,dent	
espèce chimique	,entité chimique	
mobiler	,meuble	
terminologie	,terme	
couettes	,cheveu	
miel	,pot	
sucre	;grain	<cuillerée	,pincée	;morceau	,sucre	<pain	;sachet	
frites	,cornet	,barquette	
encre	,cartouche	
égouts	,égout	
années	,année	
savon	;bloc	,bout	,copeau	,cube	,goutte	,morceau	,paillette	,pain	,savon	;bouteille	,flacon	
aviation	,avion	
terrorisme	,acte	
branchage	,branche	
bol	,coup	
huile	,bouteille	
tabac	,pied	,paquet	,pot	
clientèle	,client	,cliente	
pain	,miette	<bout	,morceau	,tranche	
alphabet	,lettre	
klaxon	,coup	
industrie	,industrie	
crème	,pot	,tube	
volley-ball	,match	,partie	,volley-ball	;rencontre	<compétition	,tournoi	<championnat	
sel	,grain	
muguet	,brin	
beurre	,noisette	,noix	;motte	
parfum	,goutte	<flacon	
graine de lupin	,graine	
billard	,jeu	,partie	
parc	,arbre	;pelouse	;allée	
pain d’épices	,tranche	,morceau	
humanité	,homme	
rabbinat	,rabbin	
marche	,marche	
groupe	,membre	
laser	,rayon	
Voie lactée	,étoile	;corps céleste	,astre	
sueur	,goutte	
laitue	,feuille	
musculature	,muscle	
escalier	,marche	
corolle	,pétales	
courrier	,courrier	
papier	,feuille	
jogging	,jogging	
saleté	,saleté	
ligne de titres	,titre	
yaourt	,pot	,yaourt	<boîte	,pack	,paquet	
tissu	,cellule	;fibre	
>>>	Mult
abeille	,colonie	,essaim	;horde	,nuage	,nuée	
entité chimique	,espèce chimique	
corbeau	,bande	,colonie	;nuée	,bande	,colonie	;nuée	
dent	,dentition	,denture	,dentelure	
jumelle	,jumelles	
fiche	,fichier	
meuble	,mobiler	
fruit	,grappe	
rock	,rock	
banc	,rangée	
jour	,semaine	,semaine	<mois	,mois	
membre	,membrure	,groupe	
herbe	,touffe	
navire	,flotte	,flottille	
mât	,mâture	
cigare	,boîte	
lecteur	,lectorat	
voisin	,voisinage	
Chleuh	,peuple	
famille	,mafia	
enfant	,enfance	
os	,ossature	,squelette	
skis	,paire	
appareil	,appareillage	
feuille	,feuillage	,papier	
pièce de vaisselle	,vaisselle	
radis	,botte	
éléphant	,troupeau	
pompier	,caserne	,caserne	
expert	,comité	,équipe	,groupe	
œuf	,couvée	
lion	,bande	
rabbin	,rabbinat	
carte	,jeu	,paquet	
volcan	,chaîne	
ministre	,gouvernement	,ministère	,cabinet	
chaussons	,paire	,paire	
végétal	,flore	,végétation	
fauteuil	,rangée	
oiseau	,volée	
raisin	,raisin	
outil	,panoplie	,outillage	
ciseaux	,paire	
bruyère	,tapis	
poussin	,couvée	
bandit	,bande	,gang	,horde	
batracien	,batraciens	
muscle	,musculature	
crin	,crinière	
bataille	,guerre	,conflit	
chien	,horde	,meute	
élément	,ensemble	
musicien	,ensemble	,groupe	,troupe	,orchestre	
clé	,trousseau	,jeu	
poil	,pelage	
mouche	,nuage	,nuée	
branche	,branchage	
criminel	,bande	,gang	;crime organisé	,mafia	,milieu	,pègre	,syndicat du crime	
ami	,réseau	
bateau	,flottille	,flotte	
avion	;flotte	
bête à bon Dieu	,nuage	
saucisse	,chapelet	
poisson	,banc	
cheveu	,chevelure	,cheveux	,cheveu	
banane	,régime	
enveloppe	,paquet	
faux ami	,lexique	,vocabulaire	
paysanne	,paysannat	,paysannerie	
employée	,personnel	
client	,clientèle	
trésor	,trésor	
chèvre	,troupeau	
verre	,bouteille	
loup	,bande	,horde	,meute	
paysan	,paysannat	,paysannerie	
personnel	,personnel	
terme	,terminologie	
chiffon	,tas	
pin	,pinède	,pineraie	,pinière	
parent	,famille	
mouton	,troupeau	,cheptel	
assiette	,pile	
moustique	,essaim	;horde	,nuage	,nuée	
arme	,armement	
jambes	,paire	
fleur	,grappe	;inflorescence	;massif	,tapis	;bouquet	
oignon	,botte	;filet	
égout	,égouts	
fibre	,tissu	
coccinelle	,nuage	
vache	,troupeau	;cheptel	
médicament	,pharmacopée	
grappe	,raisin	
sous-vêtement	,sous-vêtement	
voyou	,bande	,gang	,horde	
cigarette	,paquet	<cartouche	
racaille	,racaille	
siège	,rangée	
chaussettes	,paire	
>>>	Hypo
saint	,saint patron	
biscuit	,pâtisserie	
voiture	,voiture-bar	,voiture-restaurant	,wagon-restaurant	;voiture-couchettes	,wagon-couchettes	;voiture-lits	,wagon-lits	
boucle	,boucle articulatoire	
plan d’eau	,étang	,lac	
niveau d’articulation	,première articulation	,deuxième articulation	,troisième articulation	
émonctoire	,narines	
course	;marathon	,semi-marathon	,50 mètres	,100 mètres	,200 mètres	,400 mètres	,800 mètres	,1500 mètres	,5000 mètres	,10 000 mètres	,10 kilomètres	;rallye	
champ de foire	,emplacement	
coordonnées	,mail	
femme de loi	,avocate	,magistrate	
arme blanche	,épée	
navire	,brise-glace	,cargo	,chalutier	,drakkar	,ferry	,frégate	,galère	,navire-usine	,paquebot	,pétrolier	,transbordeur	,yacht	;contre-torpilleur	,cuirassé	,porte-avions	,torpilleur	
escargot	,escargot de Bourgogne	,petit-gris	
crime	,crime	;cambriolage	,vol	;délit	,forfait	;kidnapping	,enlèvement	,rapt	;viol	;fraude	
nombre	,entier	,singulier	,pluriel	,duel	
appendice	,antennes	
volume	,cube	,sphère	
eau	,eau de pluie	
bateau	,bac	,barge	,bateau-citerne	,bateau-mouche	,brise-glace	,cargo	,chalutier	,drakkar	,ferry	,frégate	,galère	,paquebot	,péniche	,pétrolier	,transbordeur	,vedette	,voilier	,yacht	
dispositif	,additionneur	
évènement	,évènement sportif	
véhicule	,automobile	,auto	,voiture	;autocar	,car	,autobus	,bus	;camion	,poids lourd	;camionnette	,fourgonnette	
dent	,canine	;incisive	;molaire	;prémolaire	,canine	;incisive	;molaire	;prémolaire	
sexualité	,sexualité de groupe	
signe	,poissons	,taureau	
jeu	,larigot	
cinéma	;parlant	,sonore	,muet	;en 2 dimensions	,en 2D	,en 3 dimensions	,en 3D	,relief	;noir et blanc	,couleur	
jour	,lundi	,mardi	,mercredi	,jeudi	,vendredi	,samedi	,dimanche	
maquillage	,rouge à lèvres	
sabre	,cuillère à pot	
champ scalaire	,fonction	
document	,enregistrement	
savon	,savon de Marseille	,savon d’Alep	,savon blanc	,savon noir	
douche	,cabine	
nœud	,nœud de vache	
saison	,printemps	,été	,automne	,hiver	
signe de ponctuation	,point	,point d’exclamation	,virgule	
téléphone	,téléphone portable	,fixe	,mobile	,portable	
pain	,pain polaire	
moyen de transport	,véhicule flottant	;véhicule roulant	;véhicule volant	
braguette	,fermeture éclair	
cycle	,vélo	,bicyclette	,tricycle	,tandem	
sacrement	,baptême	
cartilage	,cricoïde	,aryténoïde	
sens	,ouïe	,vue	,odorat	,goût	,toucher	
articulateur	,langue	,lèvres	,mâchoires	,mandibule	
handicap	,patte folle	
sandwich	,cheeseburger	,croque-monsieur	;hamburger	,hot-dog	,kebab	,pan bagnat	,panini	
régime réel	,régime réel normal	,régime réel simplifié	
instrument de mesure	,mètre	
geste	,doigt d’honneur	
provision	,provision pour risques et charges	
vitesse	,première	,deuxième	,troisième	
vents	,bois	,cuivres	
homme de loi	,avocat	,magistrat	
date	,treize	;trente	
violon	,alto	,violon alto	
siège	;banc	;canapé	;chaise	;fauteuil	;tabouret	
félins	,chat	
film	,documentaire	;court métrage	,moyen métrage	,long métrage	
sport	,sport aérien	;sport d’hiver	;sport de combat	;sport de glisse	;sport mécanique	;sport nautique	
musique	,musique classique	,musique classique	
bilan	;bilan instrumental	,bilan standardisé	;bilan écologique	;bilan de renouvellement	;bilan d’investigation	,bilan de contrôle	;bilan pré-opératoire	,bilan post-opératoire	;bilan pré-implantation	
orchestre	,fanfare	,harmonie	
tâche ménagère	,ménage	,repassage	
véhicule roulant	;autobus	,motocyclette	,deux-roues	,moto	,bicyclette	,voiture	,automobile	;auto	,véhicule	,vélo	,bus	,autocar	;car	,train	,tramway	;voiture	,wagon	
dimension	,longueur	,largeur	,hauteur	,profondeur	
instrument à percussion	,tambour	
son	,coup	
pierre précieuse	,diamant	,émeraude	,rubis	,saphir	,diamant	
flûte	,flûte de Pan	,flûte traversière	,flûte à bec	
mot	,gros mot	,mot magique	
exclamation	,misère	
obstacle	,haie	,rivière	
pierre fine	,grenat	
phénomène atmosphérique	,nuage	,orage	,pluie	,tempête	,tempête	,tornade	,vent	
contraceptif	,pilule	
équidés	,âne	;cheval	;zèbre	
respiration	,petit chien	
matière	,matière ordinaire	,matière noire	,antimatière	
particule subatomique	,proton	,électron	,neutron	
champignon	,cèpe	
porte	,porte à tambour	
particule	,particule subatomique	
coiffure	,chignon	
pâtisserie	,éclair	,fondant	,opéra	,pièce montée	
articulation	,articulation temporo-mandibulaire	;articulation crico-aryténoïdienne	,première articulation	,deuxième articulation	,troisième articulation	
transports	,transport ferroviaire	
fourrure	,vair	
message	,courriel	,sms	
engin de navigation	,bateau	
mésange	,mésange bleue	,mésange boréale	,mésange charbonnière	,mésange huppée	,mésange nonnette	
voilier	,jonque	
nage	,brasse	,brasse-papillon	,crawl	,dos	,dos brassé	,dos crawlé	,nage indienne	
pantalon	,jean	;patte d’éléphant	
outil	,aiguisoir	,cisaille	,clé	,enclume	,fraise	,marteau	,pelle	,pic	,pince	,pioche	,poinçon	,rabot	,râteau	,scie	,tenailles	,tournevis	,truelle	,vilebrequin	
argot	,loucherbem	
marsupial	,kangourou	
cuir	,agneau	,veau	
>>>	Fact_2
camion	,acheminer	,transporter	
mécanicien	,créer	,inventer	
tempête	,s’abattre	;balayer	;frapper	
accusateur	,accuser	
bocal	,contenir	
combattante	,combattre	,se battre	
vétérinaire	,examiner	;s’occuper	;soigner	,traiter	,examiner	;s’occuper	;soigner	,traiter	
garante	,garantir	
commentatrice	,commenter	
soleil	,illuminer	
acheteur	,acheter	
avocate	,conseiller	;représenter	;défendre	,défendre	;lutter	,militer	
semeur	,semer	
bateau	,transporter	
mère	,élever	,s’occuper	,prendre soin	;allaiter	,donner le sein	,nourrir	,s’occuper	,prendre soin	
coiffeur	,coiffer	;couper les cheveux	
dents	,couper	,scier	;broyer	
collectionneur	,collectionner	
aspirateur	,aspirer	;avaler	,absorber	,aspirer	,absorber	,avaler	
boulangère	,faire	;préparer	
ennemi	,détester	;nuire	,combattre	,lutter	;s’opposer	;nuire	
chasseresse	,chasser	
criminel	,commettre	,se livrer	
véhicule	,véhiculer	,transmettre	
arracheur	,arracher	
aide	,aider	,aider	
garant	,garantir	
agresseur	,agresser	
lessive	,laver	,nettoyer	
avocat	;conseiller	;représenter	;défendre	,défendre	;lutter	,militer	
casserole	,contenir	
hélicoptère	,transporter	
autocar	,transporter	
accusatrice	,accuser	
trieuse	,trier	
chasseuse	,chasser	
combattant	,combattre	,se battre	
ami	,aider	;protéger	,aider	;encourager	;protéger	
avion	,transporter	
opéra	,donner	
trieur	,trier	
accompagnatrice	,accompagner	,accompagner	
arbitre	,arbitrer	
bandit	,commettre	,se livrer	
mécanicienne	,conduire	
agresseuse	,agresser	
triangle	,signaler	
muscle	,mouvoir	
dent	,mordre	;croquer	;broyer	,s’emboîter	,broyer	,déchirer	
orchestre	,jouer	,interpréter	;repéter	
voyou	,agresser	,tabasser	;racketter	,voler	
bouchon	,boucher	,obstruer	
tornade	,bousculer	,secouer	<dévaster	,secouer	
dentifrice	,laver	,nettoyer	
représentation	,représenter	
chat	,attraper	;toucher	
chanteuse	,chanter	
pluie	,mouiller	,arroser	<laver	<tremper	,détremper	,lessiver	,doucher	<noyer	;transpercer	,traverser	,pénétrer	;alimenter	
navire	,transporter	
journaliste	,couvrir	;enquêter	,couvrir	;enquêter	
père	,élever	,s’occuper	,prendre soin	,s’occuper	,prendre soin	
bus	,transporter	
boulanger	,faire	;préparer	
composant	,composer	
vague	,frapper	,heurter	;submerger	
administrateur	,administrer	
barbier	,raser	
accompagnateur	,accompagner	,accompagner	
chasseur	,chasser	
chercheur	,chercher	
médecin	,examiner	;s’occuper	;soigner	,traiter	,examiner	;s’occuper	;soigner	,traiter	
caractéristique	,caractériser	
commentateur	,commenter	
acheteuse	,acheter	
couleur	,colorer	
guirlande	,agrémenter	,embellir	
nappe	,recouvrir	
porteur	,porter	
bouchère	,couper	,découper	;débiter	;dépecer	
chanteur	,chanter	
tyran	,tyranniser	
camionnette	,transporter	
boucher	,couper	,découper	;débiter	;dépecer	
four	,cuire	,brûler	
administratrice	,administrer	
bol	,contenir	
bastion	,protéger	
voiture	,transporter	
peloton de tête	,mener	
étagère	,supporter	
semeuse	,semer	
accompagnement	,accompagner	
présure	,cailler	
conceptrice	,concevoir	
coiffeuse	,coiffer	;couper les cheveux	
parasite	,profiter	,profiter	
tramway	,desservir	
car	,transporter	
factrice	,fabriquer	
facteur	,fabriquer	
>>>	SingS_1
Triangle	,étoile	
occupant	,occupant	
Irlande	,Irlandais	,Irlandaise	
pays	,habitant	,habitante	;citoyen	,citoyenne	,pays	
gallois	,Gallois	,Galloise	
marine	,marin	
poissons	,poisson	
collection	,vêtement	
Japon	,Japonais	,Japonaise	,Nippon	,Nippone	
noms	,noms	
germanique	,Germanique	,Germanique	
théâtre	,comédien	,comédienne	,acteur	,actrice	
chinois	,Chinois	,Chinoise	;sinophone	,sinophone	
anglais	,Anglais	,Anglaise	;anglophone	,anglophone	
émigration	,émigré	,émigrée	
japonais	,Japonais	,Japonaise	
angliche	,Angliche	
électorat	,électeur	,électrice	
putsch	,putschiste	
brosserie	,brosse	
forêt	,arbre	
coréen	,Coréen	,Coréenne	
pinède	,pin	
vers	,ver	
bordel	,prostituée	
fichier	,fiche	
chleuh	,Chleuh	,Chleuh	,Chleuh	
faune	,animal	
Moyen-Âge	,médiéval	
nippon	,Nippon	,Nippone	
Nouvelle-Zélande	,Kiwi	
réserve	,réserviste	,réserviste	
français	,Français	,Française	;francophone	,francophone	
breton	,Breton	,Bretonne	
mairie	,conseiller municipal	,conseillère municipale	
russe	,Russe	,Russe	;russophone	,russophone	
Turquie	,Turc	,Turque	
reptiles	,reptile	
personnel	,employé	,employée	,membre	,personnel	
Hollande	,Hollandais	,Hollandaise	
enfance	,enfant	,enfant	
flore	,végétal	
boche	,Boche	,Boche	
aire de jeux	,enfant	,enfant	
équipe	,membre	
cru	,vin	
paysannat	,paysan	,paysanne	
synagogue	,rabbin	
insectes	,insecte	
Espagne	,Espagnol	,Espagnole	
pinière	,pin	
suédois	,Suédois	,Suédoise	
oiseaux	,oiseaux	,oiseau	
trésor	,trésor	
lectorat	,lecteur	,lectrice	
œuvre	,œuvre	
États-Unis	,Américain	,Américaine	;États-unien	,États-unienne	
pineraie	,pin	
grec	,Grec	,Grecque	
salariat	,salarié	,salariée	
centre aéré	,enfant	
exemplier	,exemple	
carré	,fantassin	,soldat	,femme soldat	,militaire	,militaire	
turc	,Turc	,Turque	
gouvernement	,ministre	
orchestre	,musicien	,musicienne	
Allemagne	,Allemand	,Allemande	
active	,actif	
Australie	,Australien	,Australienne	
Corée	,Coréen	,Coréenne	
visite	,visiteur	,visiteuse	;participant	,participante	
gorge chaude	,rapace	
portée	,petit	
Belgique	,Belge	,Belge	
gens	,personne	,individu	
Grande-Bretagne	,Britannique	,Britannique	
conseil municipal	,conseiller municipal	,conseillère municipale	,conseiller municipal	,conseillère municipale	
Portugal	,Portugais	,Portugaise	
équipage	,membre	
table	,convive	,convive	,serveur	,serveuse	;cuisinier	,cuisinière	;chef	
espagnol	,Espagnol	,Espagnole	;hispanophone	,hispanophone	
paysannerie	,paysan	,paysanne	
Canada	,Canadien	,Canadienne	
allemand	,Allemand	,Allemande	;germanophone	,germanophone	
patronat	,patron	,patronne	
Corée du Nord	,Nord-Coréen	,Nord-Coréenne	
bureau	,secrétaire	,trésorier	,trésorière	,employé	,employée	,collègue	;collègue	
Chine	,Chinois	,Chinoise	
Corée du Sud	,Sud-Coréen	,Sud-Coréenne	
restaurant	,serveur	,serveuse	
clavier	,touche	
italien	,Italien	,Italienne	
Bretagne	,Breton	
maison close	,prostituée	
ballet	,danseur	,danseuse	
famille	,membre	;parent	,membre	,membre	,membre	,membre	,mafioso	
direction	,directeur	,directrice	
portugais	,Portugais	,Portugaise	;lusophone	,lusophone	
lexique	;mot	;lexème	
Italie	,Italien	,Italienne	
>>>	Syn_⊂^sex
cigarière	,cigarier	
brebis	,mouton	
concierge	,concierge	
agnelle	,agneau	
enjôleuse	,enjôleur	
rieuse	,rieur	
ambitieuse	,ambitieux	
ratée	,raté	
maquilleuse	,maquilleur	
Aborigène	,Aborigène	
reine	,roi	
muette	,muet	
parfumeuse	,parfumeur	
fournisseuse	,fournisseur	
inscrite	,inscrit	
détentrice	,détenteur	
maligne	,malin	
dîneuse	,dîneur	
donatrice	,donateur	
pique-niqueuse	,pique-niqueur	
catholique	,catholique	
expérimentatrice	,expérimentateur	
pessimiste	,pessimiste	
perdante	,perdant	
vivante	,vivant	
ravisseuse	,ravisseur	,ravisseur	
solitaire	,solitaire	
sans-abri	,sans-abri	
chercheuse	,chercheur	,chercheur	
vioque	,vioc	
scieuse	,scieur	
étrangère	,étranger	,étranger	
Française	,Français	
messagère	,messager	
pilote	,pilote	
siffleuse	,siffleur	
hôtelière	,hôtelier	
agricultrice	,agriculteur	
exploitante	,exploitant	
pique-assiette	,pique-assiette	
rivale	,rival	
coco	,coco	
coopérante	,coopérant	
camarade	,camarade	
ambulancière	,ambulancier	
rédactrice	,rédacteur	
linguiste	,linguiste	
indigène	,indigène	
dénonciatrice	,dénonciateur	
collègue	,collègue	
principale	,principal	
futée	,futé	
fonds commun de placement	,portefeuille	,fonds	
dévoreuse	,dévoreur	,dévoreur	
passionnée	,passionné	,passionné	
manieuse	,manieur	
domestique	,domestique	
malheureuse	,malheureux	
volleyeuse	,volleyeur	
amante	,amant	
Suissesse	,Suisse	
contribuable	,contribuable	
bergère	,berger	
tenniswoman	,tennisman	
gaspilleuse	,gaspilleur	
engagée	,engagé	,engagé	
artisane	,artisan	
trieuse	,trieur	
étourdie	,étourdi	
terrienne	,terrien	,terrien	
Angliche	,Angliche	
chef de bord	,chef de bord	
lâche	,lâche	
fan	,fan	
soldate du feu	,soldat du feu	
campagnarde	,campagnard	
laveuse	,laveur	,laveur	
Japonaise	,Japonais	
altiste	,altiste	
mécano	,mécano	,mécano	
politicarde	,politicard	
professeure	,professeur	,prof	
chocolatière	,chocolatier	
condamnée	,condamné	
promeneuse	,promeneur	
dictatrice	,dictateur	
votante	,votant	
parlementaire	,parlementaire	
informatrice	,informateur	
SDF	,SDF	
supérieure	,supérieur	
serveuse	,serveur	
paralysée	,paralysé	
gestionnaire	,gestionnaire	
dessinatrice	,dessinateur	
orthophoniste	,orthophoniste	
responsable	,responsable	
grosse	,gros	
éducatrice	,éducateur	,éduc	,éducateur	
nationaliste	,nationaliste	
