>>>	Syn_∩
planète	,monde	
sans objet	,nul et non avenu	,invalide	
au gré du vent	,n’importe où	
marchand de tapis	,escroc	
s’agiter	,bouger	;avoir les fesses qui démangent	,bouger	,bouger	
hydrocarbure	,pétrole	
pochard	,alcoolique	
cinéma	,grand écran	,septième art	
faucher	,carotter	,chaparder	,chiper	,chouraver	,chourer	,piquer	,taxer	,tirer	,ravir	,dérober	,faire main basse	,subtiliser	,voler	,couper	
renommé	,réputé	
traite	,chèque	
moule à gaufres	,cornichon	
consommé	,achevé	,accompli	
verdict	,jugement	
accuser	,reprocher	,imputer	;jeter la pierre	,accabler	,avoir	,subir	,montrer	
étagère	,rayon	,tablette	
box	,stalle	
repose-pieds	,tabouret	
en suspens	,en souffrance	
buller	,glander	
empotée	,maladroite	
peuple	,ethnie	,population	
douche écossaise	,douche froide	
tête dure	,entêté	,entêtée	
drap	,étoffe	
chef d’œuvre	,trésor	
canaille	,bandit	,chenapan	,crapule	,filou	;voyou	;garnement	,vaurien	,bandit	,brigand	,crapule	,escroc	,gangster	,filou	
annihiler	,anéantir	
sur ses deux oreilles	,profondément	
envahi	,colonisé	,plein	
éventail	,gamme	
gagnant	,vainqueur	,vainqueur	
volontairement	,intentionnellement	
atomique	,nucléaire	
diviser	,casser	
crise	,attaque	,difficulté	,démon de midi	,accès	
marine	,navigation	,plage	
avoir de la bouteille	,ne pas naître de la dernière pluie	
coalition	,front	
temporel	,matériel	
résidente	,habitante	
divorce	,séparation	,rupture	,rupture	,séparation	
cafétéria	,cantine	
supeuplé	,noir de monde	
accorder ses violons	,s’accorder	
éléments de langage	,discours	;argumentaire	
talon rouge	,noble	
rigolade	,rire	,pipi de chat	
évacuation	,fuir	,tuyau	,écoulement	
actionnaire	,associé	
voleur	,bandit	;brigand	,larron	
réflexion	,réverbération	
central	,principal	
fétide	,infect	
accompli	,achevé	,exemplaire	
ironie	,humour	
sommet	,cime	,montagne	,cime	
métro	,réseau	,système	;infrastructure	
réjouir	,affrioler	,exciter	,enthousiasmer	;intéresser	
moto	;engin	;monture	;pétoire	
bronzeur	,baigneur	
primaire	,élémentaire	
amener	,emmener	,conduire	
verrouiller	,cadenasser	
tranquilité	,calme	,quiétude	;sérénité	
autorité	,contrôle	,maîtrise	
condensé	,résumé	
explication	,explicitation	,justification	,raison	
appui	,encouragement	,encouragement	
méticuleux	,minutieux	
remplacer	,renouveler	,représenter	
horizon	,lointain	
exagération	,excès	
ramener sa fraise	,se mêler	
législation	,loi	
autrefois	,dans le temps	
revanche	,vengeance	
feu	,flamme	,incendie	,tir	
emprise	,pouvoir	
progresser	,se développer	,avancer	,s’avancer	;aller	,marcher	,marcher	,avancer	,avancer	,marcher	,augmenter	,avancer	
nant	,gave	;torrent	;ruisseau	
sanguinaire	,cruel	
ligoté	,attaché	;menotté	
poupe	,étambot	
gentil	,aimable	
pilleur	,bandit	;brigand	
flanquer	,administrer	,allonger	,balancer	,coller	,ficher	,filer	,foutre	,asséner	,donner	,envoyer	,lancer	
gants	,moufles	
certain	,évident	,plusieurs	
manières	,façon	
rond	,ivre	,saoul	<blindé	,cuité	<bourré	,pinté	<beurré	,plein	,pété	,torché	,déchiré	,raide	,arraché	,cercle	,bon	,bien	
fleuve des morts	,fleuve des Enfers	
pinailler	,chipoter	
clairsemé	,rare	
heure	,époque	,horaire	
créativité	,imagination	
parole d’honneur	,serment	,sur l’honneur	
se contredire	,s’emmêler les pinceaux	,s’emmêler les pédales	
perpétuel	,constant	
gratitude	,reconnaissance	
>>>	S_0
exagérer	,exagération	
arriver	,arrivée	,arrivée	,arrivée	,arrivage	
s’enrouler	,enroulement	
mentionner	,mention	
cultiver	,culture	
humainement	,homme	,humain	
vert	,vert	
gicler	,giclement	
comparatif	,comparaison	
jaune	,jaune	
expliciter	,explicitation	
se partager	,partage	
charbonnier	,charbon	
relire	,relecture	
obtenir	,obtention	
royal	,roi	
ignorer	,ignorance	
lire	,lecture	
est	,est	
se conduire	,conduite	
meurtrier	,meurtre	
électoral	,élection	
apprendre	,apprentissage	
coopérer	,coopération	
valoir	,valeur	
gustatif	,goût	,goût	
fiscal	,fisc	
désespéré	,désespoir	
dérouler	,déroulement	
résonner	,résonance	,résonance	
raccrocher	,raccrochage	
alphabétique	,alphabet	
extravagant	,extravagance	
balayer	,balayage	
juger	,jugement	,jugement	
hurler	,hurlement	,hurlement	,hurlement	,hurlements	
quotidien	,quotidien	
simplifier	,simplification	,simplification	
intestinal	,intestin	
coiffer	,coiffage	
torrentiellement	,torrent	
se méfier	,méfiance	
fermer	,fermeture	
vibrer	,vibration	
constater	,constatation	
citer	,citation	
désobéir	,désobéissance	
hypnotique	,hypnotisme	
naufrager	,naufrage	
débrancher	,débranchement	
démonter	,démontage	
souper	,souper	
rembourser	,remboursement	
boursier	,Bourse	
connaître	,connaissance	,connaissance	
se diviser	,division	
divin	,dieu	
consentir	,consentement	,consentement	
retourner	,retour	
se diffuser	,diffusion	
comparativement	,comparaison	
s’indigner	,indignation	
pipier	,pipe	
pendulaire	,pendule	
grec	,Grèce	,grec	
engager	,engagement	
concentrer	,concentration	
restructurer	,restructuration	
atmosphérique	,atmosphère	
cotonnier	,coton	
ajouter	,ajout	,ajout	,ajout	
sexuellement	,sexe	,sexe	
académique	,académie	
entretenir	,entretien	
cyno-	,chien	
monumental	,monument	
langagier	,langage	
détester	,détestation	
domanial	,domaine	
louvoyer	,louvoiement	
décorer	,décoration	,décoration	
effacer	,effaçage	,effacement	
se mélanger	,mélange	
jeûner	,jeûne	
cordialement	,cordialité	
mentir	,mensonge	
cosmétique	,cosmétique	,cosmétique	
germanique	,Allemagne	,germanique	
directeur	,direction	
exercer	,exercice	
circulaire	,cercle	
rigoler	,rigolade	
canarder	,canard	
entraîner	,entraînement	
artistiquement	,art	
circonstanciel	,circonstance	
anarchique	,anarchie	,anarchie	
déclarer	,déclaration	,déclaration	
guetter	,guet	
manifester	,manifestation	
>>>	A_2Perf
extraire	,extrait	
abandonner	,abandonné	
corruption	,corrompu	
décorer	,décoré	,décoré	
doubler	,doublé	
entourer	,entouré	
toaster	,toasté	;grillé	
dresser	,dressé	,vertical	,droit	
lever	,levé	,debout	,levé	,levé	,levé	,levé	
exercer	,exercé	
voiler	,voilé	
élargir	,élargi	
emprunter	,emprunté	
encercler	,encerclé	
éteindre	,éteint	
étrangler	,étranglé	
interdire	,interdit	
éplucher	,épluché	
boucher	,bouché	
insulter	,insulté	
dissimuler	,sous le tapis	
accepter	,accepté	
attacher	,attaché	
enregistrer	,enregistré	
promettre	,promis	
voir	,vu	
baser	,basé	
diminuer	,diminué	
se casser	,cassé	
ouvrir	,ouvert	
ajouter	,ajouté	,ajouté	
plier	,plié	
détacher	,détaché	
goudronner	,goudronné	
diplômer	,diplômé	
inscrire	,inscrit	
détourner	,détourné	,détourné	
explorer	,exploré	
allonger	,couché	,allongé	,étendu	,tendu	
pardonner	,pardonné	
enlever	,enlevé	,enlevé	
percer	,percé	
développer	,développé	
noyer	,noyé	
meubler	,meublé	
déconnecter	,déconnecté	
contraindre	,contraint	
domestiquer	,domestique	
fâcher	,fâché	
entasser	,entassé	,entassé	
restreindre	,restreint	
contrainte	,contraint	
vaincre	,vaincu	
installer	,installé	
endormir	,endormi	,endormi	
aider	,aidé	
surprendre	,surpris	
égarer	,égaré	
hospitaliser	,hospitalisé	
lacer	,lacé	
remplir	,rempli	,rempli	
étirer	,étiré	
punir	,puni	
illuminer	,lumineux	
enrouler	,enroulé	
enterrer	,enterré	,enterré	
garnir	,garni	
autoriser	,autorisé	
imaginer	,imaginé	
habiller	,habillé	,habillé	
coudre	,cousu	
envahir	,envahi	,envahi	
laver	,lavé	,lavé	
plisser	,plissé	
indiquer	,indiqué	
animer	,animé	,animé	
avertir	,averti	
gonfler	,gonflé	
ruiner	,ruiné	
brosser	,brossé	,brossé	
enchanter	,enchanté	
imprimer	,imprimé	
vider	,vidé	;vide	
diviser	,divisé	
engager	,engagé	
satisfaire	,satisfait	
encadrer	,encadré	,encadré	
défaire	,défait	,défait	
trancher	,tranché	
raidir	,raide	
décoration	,décoré	,décoré	
dégoûter	,dégoûté	
griller	,grillé	
décaler	,décalé	,décalé	
épouvanter	,épouvanté	
aérer	,aéré	
détruire	,détruit	,détruit	
prénommer	,prénommé	
enfermer	,enfermé	
recouvrir	,recouvert	
>>>	Anti
matériel	,spirituel	
intéressant	,inintéressant	
raccourcissement	,rallongement	
coincer	,décoincer	
continu	,discontinu	
actif	,inactif	,inactif	
vieillir	,rajeunir	,rajeunir	
désarmer	,armer	
périr	,naître	
invisible	,visible	
aube	,crépuscule	
tristement	,joyeusement	
inconnu	,connu	
assis	,debout	
désintéresser	,intéresser	
dégonfler	,gonfler	,gonfler	
indirect	,direct	
ouvrir	,fermer	,fermer	,fermer	,fermer	,fermer	,fermer	,fermer	
grand	,petit	,petit	,petit	,petit	,petit	,petit	,petit	,petit	,petit	
complet	,incomplet	
debout	,assis	,couché	
confirmé	,débutant	
maladresse	,adresse	
casser sa pipe	,naître	
humide	,sec	
se lever	,se coucher	
pousser	,tirer	
incompris	,compris	
avant	,arrière	,après	,après	,après	,après	,arrière	,arrière	
imprévisible	,prévisible	
composé	,corps simple	
précocement	,tardivement	
commençant	,finissant	
inabouti	,abouti	
obligatoire	,facultatif	
force	,faiblesse	
honnête	,malhonnête	
désavantage	,avantage	
à long terme	,à court terme	
échouer	,réussir	,arriver	
par-dessus	,par-dessous	
rien	,quelque chose	
rajeunissant	,vieillissant	
adroit	,maladroit	,maladroit	
intra-	,extra-	
ouvert	,fermé	,fermé	
sortir	,entrer	,entrer	,rentrer	
amateur	,professionnel	
chance	,malchance	
déterrer	,enterrer	
inacceptable	,acceptable	
insoluble	,soluble	,soluble	
acteur	,spectateur	
marcher	,péricliter	
rallongement	,raccourcissement	
exigible	,inexigible	
sec	,humide	
décéder	,naître	
impair	,pair	,pair	,pair	
conscience	,inconscience	,inconscience	
enlaidir	,embellir	,s’embellir	
modestie	,immodestie	
bas	,haut	,haut	,haut	,élevé	,haut	,haut	
probable	,improbable	
dénouer	,nouer	
proton	,électron	
se déshabiller	,s’habiller	
sain	,malsain	
retard	,avance	
favorable	,défavorable	,défavorable	,défavorable	
rempli	,vide	
de bon poil	,de mauvais poil	
non-coupable	,coupable	
détromper	,tromper	
délacer	,lacer	
extraordinaire	,ordinaire	
coupable	,non-coupable	;innocent	
échec	,réussite	,succès	
cradoque	,impeccable	
immodéré	,modéré	
coudre	,découdre	
ingouvernable	,gouvernable	
perdre	,gagner	
proue	,poupe	
à propos	,mal à propos	
méchanceté	,bonté	
serrer	,desserrer	
décidé	,indécis	
inimaginable	,imaginable	
discipliné	,indiscipliné	
honnêtement	,malhonnêtement	
s’allumer	,s’éteindre	
accord	,désaccord	
stable	,instable	
dételer	,atteler	
droite	,gauche	
atrophié	,hypertrophié	
patience	,impatience	
l’air de rien	,ostensiblement	
facile	,difficile	
>>>	S_res
glaçage	,glaçage	,glaçage	,glaçage	
jugement	,jugement	
analyse	,résultat	
se décaler	,décalage	
se couper	,coupure	
réaliser	,réalisation	
envelopper	,enveloppement	
test	,résultat	
incliner	,inclinaison	
effort	,résultat	
entassement	,entassement	,entassement	,entassement	,entassement	
collectionner	,collection	
expérimentation	,résultat	
affaiblir	,faiblesse	
étude	,résultat	
mesure	,mesure	;résultat	
course	,résultat	
se décourager	,découragement	
souffler	,souffle	
coup de foudre	,amour	
renverser	,renversement	
se fracturer	,fracture	
sondage	,résultat	
interdire	,interdiction	
réunion	,réunion	
décaler	,décalage	
confondre	,confusion	
blesser	,blessure	
constatation	,constat	
déchirer	,déchirure	
chanter	,chant	
arranger	,arrangement	,arrangement	
caresser	,caresse	
s’affaiblir	,faiblesse	
cracher	,crachat	,crachat	
suer	,sueur	
observation	,observation	;résultat	
caca	,caca	
humilier	,humiliation	
cadrer	,cadre	;photographie	,prise de vue	,cadre	
écrire	,écriture	
abonnement	,abonnement	
enfler	,enflure	
écarter	,écart	,écart	
enfermer	,enfermement	
trouer	,trou	
résumer	,résumé	
plisser	,pli	
klaxonner	,klaxon	
bilan	,bilan	;compte de bilan	,bilan	
constater	,constat	
tomate	,tomate	
vote	,résultat	
ioniser	,ion	,anion	,cation	
addition	,somme	;résultat	
gonfler	,gonflage	
maquette	,maquette	
encadrer	,encadrement	
s’ioniser	,ion	,anion	,cation	
lever de soleil	,jour	
éplucher	,épluchure	
examen	,résultat	,résultat	,résultat	
vieillir	,vieillesse	
critique	,critique	,critique	
se brûler	,brûlure	
dévaster	,dévastation	
s’éprendre	,amour	
juger	,jugement	
condamner	,condamnation	
chambouler	,désordre	
enquête	,résultat	,résultat	
scrutin	,résultat	
mesurer	,mesure	
polluer	,pollution	,pollution	
doubler	,double	
ranger	,rang	,rangée	
extinction des feux	,extinction des feux	
dessiner	,dessin	;figure	
opération	,résultat	,résultat	
négociation	,résultat	
enrouler	,enroulement	
soustraction	;différence	;résultat	
pluie	,eau	
zébrer	,zébrure	
élection	,résultat	
division	,quotient	;résultat	
aimanter	,aimant	
s’éloigner	,éloignement	
dégradation	,dégradation	
tournoi	,résultat	
infecter	,infection	
opération escargot	,ralentissement	;bouchon	,embouteillage	
coucher de soleil	,nuit	
entasser	,entassement	,entassement	
aimer	,sexe	
multiplication	,produit	;résultat	
concours	,résultat	
match	,résultat	
mélange	,mélange	,mélange	;mélange	
tempête	,houle	
>>>	Syn_⊃
buste	,thorax	
enlèvement	,kidnapping	
escargot	,escargots	
fumier	,crottin	
discours	,conférence	,toast	
oui	,oui oui	
veste	,veston	
aller	,fréquenter	;courir	
transférer	,télécharger	
partage	,manger dans la même écuelle	
jour	,jour	
regard	,coup d’œil	
se laver	,se baigner	,se doucher	
rémunération	,salaire	
gamin	,marmot	,marmot	
loueur	,loueuse	
mauve	,cyclamen	
bol fécal	,cigare	,colombin	
célébration	,cérémonie	,cérémonie	
ville	,agglomération	,métropole	;bourg	,bourgade	;village	;préfecture	,sous-préfecture	
résultat	,score	
écart	,excentricité	
pistolet	,revolver	
mouvement	,mouvement social	
tête	,crâne	
raisin	,raisin sec	
vent	,air	
carcinome	,carcinome mammaire	
s’isoler	,s’enterrer	
ancien	,vieillard	;croulant	
troubles	,tempête	
neiger	,neigeoter	
crier	,hurler	,hurler	,hurler	
s’enfiler	,boire	;manger	
craquelure	,cheveu	
tortue	,tortue de mer	,tortue marine	
mère	,maman	,mémère	,maman	
bistouquette	,cigare	,phallus	
profiter	,tirer la couverture à soi	;manger à tous les râteliers	
bon	,chèque cadeau	,chèque restaurant	,chèque transport	,chèque vacances	
couleur	,couleur	
éprouver	,ressentir	
dent	,chicot	,crocs	
cellule	,cachot	
roux	,rouge	
par terre	,au tapis	
grand	,surdimensionné	,vaste	
étagère	,bibliothèque	
rire	,se fendre la pipe	,fou rire	
côté	,droite	;gauche	,droite	;gauche	
se fourrer	,se blottir	
électeur	,votant	
crâne	,boîte crânienne	
manger	,déjeuner	,dîner	,goûter	,petit-déjeuner	,souper	;dévorer	
indication	,indice	,symptôme	
danser	,dansoter	
maison	,maisonnette	;baraque	,bicoque	;bungalow	,pavillon	
parc	,zoo	
museau	,groin	
élément	,élément	
terrain	,court	,lopin	
transport	,fret	
savon	,savonnette	;savon blanc	,savon d’Alep	,savon de Marseille	,savon noir	
glace	,glace	,glaçage	
rajeunir	,retrouver ses jambes de vingt ans	
bouche	,bec	,bec	
transporter	,acheminer	,véhiculer	
messe	,messe de minuit	
restaurant	,gargote	,cantine	
route	,nationale	,départementale	,autoroute	
coussin	,oreiller	
adresse	,coordonnées	,table	
changé	,déplacé	
parer	,chasser les mouches	
tourne-disque	,mange-disque	
trois-quarts	,manteau	
augmenter	,s’envoler	
caravanier	,caravanière	
voyou	,loubard	
dimension	;longueur	,corps	
entaille	,rainure	
améliorable	,perfectible	
enfant du pays	,enfant du pays	
crado	,dégueu	,dégueulasse	,dégueu	,dégueulasse	,dégueu	,dégueulasse	
pathologie	,maladie	
grenouille	,rainette	
siège bébé	,siège auto	
homosexuel	,tante	
maintenir	,assurer	
grand-mère	,mémère	
repéter	,ressasser	
aquatique	,marin	
prison	,centrale	
dentiste	;stomatologue	;orthodontiste	
rêver	,cauchemarder	
hamburger	,cheeseburger	
enfant	,bout de chou	,moustique	,petit	;marmot	,moutard	;chiard	,petit	;marmot	;fils	,fille	,petite	,petite	
utilitaire	,aspirateur	
cracher	,cracher	
munitions	,balle	,cartouche	
>>>	S_1
boucher	,boucheur	
border	,bordure	
molécularité	,réaction	
vêtement	,ouvrier	,ouvrière	
figuier	,figue	
tabaculture	,cultivateur	,cultivatrice	
agoraphobie	,agoraphobe	,agoraphobe	
accident	,accidentée	,accidenté	
saint	,saint	,sainte	
tendresse	,tendre	,tendre	
frimer	,frimeur	,frimeuse	
jupon	,femme	
librairie	,libraire	,libraire	
sortir	,chien	
vaincre	,vainqueur	
alvéole	,rayon	
rire	,rieur	;rieuse	
tousser	,tousseur	,tousseuse	
obstiné	,obstiné	,obstinée	
Suède	,Suède	
miel	,abeille	
solide	,matière	,substance	,substance	
mettre les petits plats dans les grands	,hôte	,hôte	,hôtesse	
tonneau	,bateau	,navire	,véhicule	,voiture	
causer	,cause	
archéologie	,archéologue	
printemps	,année	
camion	,chauffeur	,conducteur	,conductrice	
bagarreur	,bagarreur	,bagarreuse	
jeunesse	,jeune	,jeune	
vieillesse	,vieux	,vieille	
rue piétonnière	,piéton	,piétonne	
jogging	,joggeur	,joggeuse	,joggeur	,joggeuse	
percussion	,percussionniste	,percussionniste	
cousu main	,couturier	,couturière	,couturier	,couturière	,artisan	,artisane	
christianisme	,chrétien	,chrétienne	
France	,France	
triangle	,joueur	,joueuse	,femme	
ruelle	,lit	
soupe au lait	,soupe au lait	
particule	,matière	
ciel	,Dieu	
faire partie des meubles	,habitué	,habituée	
réverbération	,lumière	,son	
propriété physique	,substance	
mal-aimé	,mal-aimé	,mal-aimée	
empreintes	,pas	;pieds	
pêcher	,pêcheur	,pêcheuse	
hépatique	,hépatique	,hépatique	
écouter	,écouteur	
tombeau	,cadavre	,macchab	,macchabée	,corps	,mort	,morte	;squelette	
tunnel	,véhicule roulant	
timidité	,timide	,timide	
numéro atomique	,élément	,atome	
directeur	,roue	
Pays-Bas	,Pays-Bas	
assassiner	,assassin	,assassin	
études	,étudiant	,étudiante	
enlever	,ravisseur	
chèque	,auteur	,auteure	;émetteur	,émettrice	;signataire	,signataire	
témoigner	,témoin	,témoin	
dette	,débiteur	,débitrice	
domestique	,mouche	,moineau	,plante	
anarchisme	,anarchiste	,anarchiste	
régir	,règle	
civilité	,Madame	,Mademoiselle	,Monsieur	
enquête	,enquêteur	,enquêtrice	,enquêteuse	,enquêteur	,enquêtrice	
voiture	;conducteur	,conductrice	;automobiliste	,automobiliste	,train	
voyager	,voyageur	,voyageuse	
membre	,animal	
compétition	,compétiteur	,compétitrice	
phobie	,phobique	,phobique	
assurance	,assureur	
se passionner	,passionné	,passionnée	
sommeil	,dormeur	,dormeuse	
comprendre	,tout	
gros	,gros	,grosse	
tapis vert	,joueur	,joueuse	
foire	,vendeur	
sentimentalité	,sentimental	,sentimentale	
apprendre	,apprenant	,apprenante	,expérience	
chantage	,auteur	,auteure	,maître-chanteur	,maître-chanteuse	
protéger	,protecteur	,protectrice	,protection	
lit	,cours d’eau	
lune	,astre	,planète	
ioniser	,atome	,molécule	
bronzette	,bronzeur	,bronzeuse	
limitant	,réactif	,réactant	
nid	,oiseau	
clapier	,lapin	
boutique	,boutiquier	,boutiquière	
combat	,combattant	,combattante	
gare	,train	
récoltant	,récoltant	,récoltante	
loucherbem	,boucher	
prêter	,prêteur	,prêteuse	
noblesse	,noble	
mot	,locuteur	,locutrice	
course à pied	,coureur	,coureuse	
recherche	,chercheur	
>>>	Conv_21
résulter	,causer	
au-dessus	,au-dessous	
se désespérer	,désespérer	
se laisser bouffer	,manger la laine sur le dos	
passer	,renverser	
intégrer	,s’intégrer	,s’intégrer	
ouvrir	,commencer	
coucher	,se coucher	,se coucher	,se coucher	,se coucher	
passionner	,se passionner	
se souvenir	,revenir	
sensible	,sensible	,sensible	
en dessous	,en dessus	
s’ébahir	,ébahir	
s’alarmer	,alarmer	
tenir à cœur	,tenir à cœur	,tenir à cœur	
revenir	,se souvenir	,se rappeler	
expliquer	,s’expliquer	
manger la laine sur le dos	,se laisser bouffer	
tenir	,maintenir	,tenir	,tenir	
se déclencher	,déclencher	
occuper	,s’occuper	
aller	,avoir	
intéresser	,s’intéresser	
angoisser	,angoisser	,angoisser	
s’expliquer	,expliquer	
craindre	,effrayer	
créancier	,débiteur	
effet	,cause	
maintenir	,tenir	
s’intégrer	,intégrer	,intégrer	
à gauche	,à droite	
en conséquence	,car	
adoptif	,adoptif	,adoptif	
s’inquiéter	,inquiéter	
amuser	,s’amuser	
désoler	,se désoler	
déprimer	,déprimer	,déprimer	
conduire	,résulter	
cadet	,aîné	
posséder	,appartenir	
s’affoler	,affoler	
aîné	,cadet	
désespérer	,désespérer	,désespérer	,se désespérer	
divertir	,se divertir	
créancière	,débitrice	
commencer	,commencer	,ouvrir	,commencer	,s’ouvrir	
subir	,transformer	
mourir	,tuer	,emporter	
transformer	,subir	
partir	,avoir	
visiter	,recevoir	
colorer	,se colorer	
se coucher	,coucher	,coucher	,coucher	,coucher	
se désoler	,désoler	
se rappeler	,revenir	
donc	,car	
avoir	,aller	,partir	
ébahir	,s’ébahir	
se terminer	,terminer	,terminer	
se passionner	,passionner	
marcher	,faire	,alimenter	
agacer	,s’agacer	
s’intéresser	,intéresser	
recevoir	,visiter	
s’abriter	,abriter	
devant	,derrière	
s’appliquer	,appliquer	
se divertir	,divertir	
désintéresser	,se désintéresser	
par conséquent	,car	
s’occuper	,occuper	
se couvrir	,couvrir	
affoler	,s’affoler	
abriter	,s’abriter	
connaître	,toucher	
derrière	,devant	
entrer	,comprendre	
s’affaiblir	,affaiblir	
au-dessous	,au-dessus	
appartenir	,posséder	
se piquer	,piquer	
renverser	,passer	
toucher	,connaître	
causer	,résulter	,tenir	
se composer	,composer	
alors	,car	
couvrir	,se couvrir	
s’amuser	,amuser	
creusé	,creusé	,creusé	
conséquence	,cause	
inquiéter	,s’inquiéter	
alarmer	,s’alarmer	
résultat	,cause	
antérieur	,postérieur	
affaiblir	,s’affaiblir	
appauvrissement	,appauvrissement	,appauvrissement	
piquer	,se piquer	,piquer	,piquer	
retentir	,retentir	,retentir	
s’agacer	,agacer	
accueillir	,se trouver	
>>>	A_0
fixement	,fixe	
gymnastique	,gymnastique	,gymnique	
catastrophe	,catastrophique	,catastrophique	,catastrophique	
kaki	,kaki	
automatiquement	,automatique	
violet	,violet	
inversement	,inverse	
initialement	,initial	
blond	,blond	
torrent	,torrentiel	,torrentiel	
microbe	,microbien	
terre	,terreux	,terrestre	,terrestre	,terrestre	
nager	,natatoire	
modérément	,modéré	
égoïstement	,égoïste	
gencives	,gingival	
télévision	,télévisuel	
instrument	,instrumental	
orthographe	,orthographique	
épaules	,scapulaire	
sagement	,sage	
subtilement	,subtil	
fleur	,fleuri	,floral	
muscle	,musculaire	
marxisme	,marxiste	
paradis	,paradisiaque	
goudron	,goudronneux	
espace	,spatial	
orage	,orageux	
putsch	,putschiste	
caravane	,caravanier	
bronchite	,bronchiteux	
cauchemarder	,cauchemardesque	
particulièrement	,particulier	
misogynie	,misogyne	
hôpital	,hospitalier	
volcan	,volcanique	
électronique	,électronique	
boucherie	,boucher	
solidement	,solide	
respectueusement	,respectueux	
mer	,marin	,maritime	
banalement	,banal	
porc	,porcin	
ville	,urbain	
anormalement	,anormal	
nez	,nasal	,nasal	
intensément	,intense	
banque	,bancaire	
pertinemment	,pertinent	
molécule	,moléculaire	
courir	,coureur	
préfet	,préfectoral	
Chine	,chinois	
imbécilement	,imbécile	
avocat	,avocassier	
extraordinairement	,extraordinaire	
anarchie	,anarchique	,anarchique	
majuscule	,majuscule	
largement	,large	
religieusement	,religieux	
bouddhisme	,bouddhiste	
infiniment	,infini	
mobiler	,mobilier	
naissance	,natal	;de naissance	
avocate	,avocassier	
Terre	,terrestre	
trompeusement	,trompeur	
Noël	,de Noël	
poste	,postal	
rhumatisme	,rhumatismal	
béer	,bée	
Arabie	,arabe	
autoritairement	,autoritaire	
vaincue	,vaincu	
atomiquement	,atomique	
beige	,beige	
honnêtement	,honnête	
félins	,félin	
contrôle	,contrôlant	
cuisine	,culinaire	
franchement	,franc	,franc	
maison	,domestique	
voix	,vocal	
climat	,climatique	
thorax	,thoracique	
Chleuh	,chleuh	
cation	,cationique	
buriner	,buriné	
vilainement	,vilain	,vil	
coude	,cubital	
fidèlement	,fidèle	
grève	,gréviste	
formidablement	,formidable	,formidable	
sainement	,sain	
précisément	,précis	
jaune	,jaune	
institution	,institutionnel	
astuce	,astucieux	
couramment	,courant	
>>>	Able_1
craindre	,craintif	
rouler	,roulant	
compenser	,compensatoire	
inventer	,inventif	
causer	,causant	,causeur	
tracasser	,tracassier	
s’épuiser	,épuisable	
envahir	,envahissant	
pécher	,peccable	
autorité	,autoritaire	
étouffer	,étouffant	
chipoter	,chipoteur	,chipoteur	,chipoteur	
flamber	,inflammable	
rudoyer	,rude	
se suicider	,suicidaire	
exiger	,exigeant	
bagarre	,bagarreur	
sport	,sportif	
trouille	,trouillard	
aventure	,aventureux	,aventurier	
coopérer	,coopératif	
alarmer	,alarmant	
déplacement	,mobile	
observer	,observateur	
éruption	,éruptif	
russe	,russophone	
dommages	,dommageable	
réaction	,réactif	
s’évaporer	,évaporable	
inspirer	,inspirant	
malade	,maladif	
pleurer	,pleureur	
soupçonner	,soupçonneux	
frousse	,froussard	
rire	,rieur	
espagnol	,hispanophone	
flatter	,flatteur	
risque	,risqué	
attirer	,attractif	
expliquer	,explicatif	
coopération	,coopératif	
blague	,blagueur	
distraire	,distrayant	
bavarder	,bavard	
tempête	,exposé	
réagir	,réactif	
épouvanter	,épouvantable	
perturber	,perturbant	,perturbant	
angoisse	,angoissé	
s’entêter	,têtu	<entêté	
ruse	,rusé	
voler	,volant	
astuce	,astucieux	
travailler	,bosseur	,travailleur	
distinguer	,distinctif	
changer	,changeant	
suspecter	,suspicieux	
ramper	,rampant	,rampant	
allemand	,germanophone	
voleur	,voleur	
cogner	,cogneur	
convaincre	,convaincant	
rigoler	,rigoleur	
caprice	,capricieux	
obéir	,obéissant	
colère	,coléreux	,colérique	
amuser	,amusant	
fable	,fabulateur	
tolérer	,tolérant	
conserver	,conservateur	
désobéir	,désobéissant	
résister	,résistant	
s’emporter	,coléreux	,colérique	,soupe au lait	
avoir ses limites	,limité	
dormir	,somnolent	
se débrouiller	,débrouillard	
se casser	,cassant	
charité	,charitable	
chinois	,sinophone	
crier	,criard	
exploser	,explosible	
jouer	,joueur	
calcul	,calculateur	
portugais	,lusophone	
compensation	,compensatoire	
éducation	,éducable	
casser	,cassant	
questionner	,questionneur	
voyage	,voyageur	
absorber	,absorbant	
entreprendre	,entreprenant	
mordre	,mordeur	
se soumettre	,soumis	
écœurer	,écœurant	
incendie	,incendiaire	
désespérer	,désespérant	
oublier	,oublieux	
sale	,salissant	
accélérer	,accélérateur	
créer	,créatif	
>>>	Able_2
achetable	,acheter	
exiger	,exigible	
prévoir	,prévisible	
observer	,observable	
sympathie	,sympathique	,sympa	
maîtriser	,maîtrisable	
louer	,locatif	;louable	
douleur	,sensible	
gouverner	,gouvernable	
extraire	,extractible	
scier	,sciable	
incliner	,inclinable	
épuiser	,épuisable	
facture	,facturable	
nausée	,nauséeux	
rabattre	,rabattable	
communiquer	,communicable	
cafardeux	,cafardeux	
exploiter	,exploitable	
éviter	,évitable	
éduquer	,éducable	
comparer	,comparable	
composition	,composable	
ajuster	,ajustable	
traduire	,traduisible	
exécuter	,exécutable	
oublier	,oubliable	
recommander	,recommandable	
bouffer	,comestible	,mangeable	
se marier	,mariable	
imagination	,imaginable	
honteux	,honteux	
vacciner	,vaccinable	
adapter	,adaptable	
anxiété	,anxiogène	
se passionner	,passionnant	
adaptable	,adapter	
épouvante	,épouvantable	
mépriser	,méprisable	
déplacer	,déplaçable	
somme	,sommable	
digérer	,digérable	
citer	,citable	
attirer	,attirable	
ordonner	,ordonnable	
mépris	,méprisable	
toucher	,touchable	
vendre	,vendable	
voler	,volable	
trier	,triable	
diffuser	,diffusible	,diffusable	
raconter	,racontable	
inonder	,inondable	
tempête	,exposé	
accepter	,acceptable	
expérimenter	,expérimentable	
vérifier	,vérifiable	
juger	,jugeable	
adopter	,adoptable	
décoller	,décollable	
admettre	,admissible	
constater	,constatable	
transporter	,transportable	,transportable	
absorber	,absorbable	
prolonger	,prolongeable	
attaquer	,attaquable	
exprimer	,exprimable	
labourer	,labourable	,arable	
contester	,contestable	
compensation	,compensable	,compensable	
modifier	,modifiable	
libérer	,libérable	
compréhension	,compréhensible	
deviner	,devinable	
déterminer	,déterminable	
calcul	,calculable	
glisser	,glissant	
distribuer	,distribuable	
appliquer	,applicable	,applicable	
compenser	,compensable	,compensable	
manger	,mangeable	,comestible	
démonter	,démontable	
multiplier	,multipliable	
décrire	,descriptible	
naviguer	,navigable	
laver	,lavable	,lavable	
critiquer	,critiquable	
orienter	,orientable	
supposer	,supposable	
recycler	,recyclable	
administrer	,administrable	,administrable	
tuer	,tuable	
détruire	,destructible	,destructible	
trouver	,trouvable	
douter	,douteux	
réparer	,réparable	
allergie	,allergène	,allergisant	
constatation	,constatable	
réalisation	,réalisable	,réalisable	
comprendre	,compréhensible	
>>>	Anti_∩
flâneur	,rapide	
domesticité	,sauvagerie	
clairsemé	,abondant	
non	,oui	,oui	
baisser	,lever	,lever	
célibat	,couple	
exigu	,spacieux	
ignorer	,connaître	,savoir	,reconnaître	
finir	,abandonner	,interrompre	
méfiance	,confiance	
phobie	,obsession	
soleil	,ombre	
opaque	,transparent	
divorce	,mariage	
chambouler	,ranger	
tabac	,bide	
accalmie	,tempête	;tempête	
manger	,jeûner	,ne pas manger	,articuler	,restituer	
paraître	,disparaître	
tranquilité	,agitation	
libre	,réglementé	
cul-de-sac	,passage	,voie	
menteur	,franc	,sincère	
valide	,périmé	
rarement	,souvent	,jamais	,toujours	
victoire	,veste	,veste	
bienheureux	,malheureux	
sur pied	,invalide	,couché	
couvert	,sans filet	
noir et blanc	,couleur	
à la diable	,soigneusement	
coup d’épée dans l’eau	,coup d’éclat	;coup de théâtre	
unification	,diversification	
ambiguïté	,clarté	
crime	,merveille	
s’ouvrir	,se fermer	
écouter	,faire la sourde oreille	,fermer l’oreille	
partisan	,ennemi	
net	,sale	
intelligent	,bête	,idiot	
mince	,gros	,obèse	
confiance	,méfiance	
franchement	,hypocritement	
au petit bonheur	,méthodiquement	,systématiquement	
naissance	,bout	,extrémité	
accommodant	,têtu	
écourter	,allonger	,prolonger	
flou	,netteté	
averti	,ignorant	
escarpé	,doux	
en toutes lettres	,entre les lignes	
sac	,valise	
tenir la route	,clocher	
entre deux eaux	,franc	
régional	,national	
livide	,rouge	
avoir ses limites	,suffire	
honnêtement	,mal	
écarter	,accepter	,serrer	,choisir	
inclinable	,fixe	
retrouver ses jambes de vingt ans	,ne plus avoir de jambes	
boulimique	,anorexique	,anorexique	,anorexique	,anorexique	
rapide	,long	,récent	,omnibus	
s’engager	,s’arrêter	
secondaire	,principal	
écrasé	,crémeux	
lever	,baisser	,abaisser	,baisser	,instaurer	,dépérir	,s’étioler	,abaisser	,baisser	,rabattre	,dissoudre	
déraison	,bon sens	
en peloton	,debout	
ne pas faire long feu	,durer	
ressemblance	,différence	,dissimilitude	,dissemblance	,dissimilarité	,dissemblance	
nouveauté	,ancienneté	
remonter	,descendre	
faux	,authentique	
diminuer	,s’allonger	,s’allonger	,s’allonger	,rétrécir	,grandir	,s’allonger	,s’allonger	,rallonger	,agrandir	,rallonger	,étirer	;élargir	,allonger	,rallonger	,allonger	
faible	,fort	
complexe	,simple	
géante	,naine	
brièveté	,longueur	
partir	,aller	
brûlant	,glacé	
concentrer	,déconcentrer	,allonger	,diluer	
déprimer	,réjouir	
norme	,bizarrerie	
authentique	,faux	
tout	,rien	,personne	
rapetisser	,grandir	,allonger	
crémeux	,écrasé	
distinct	,similaire	,analogue	
obscurité	,clarté	
hors	,dans	
totalité	,partie	
laisser aller	,interrompre	
seins	,faux seins	
différence	,ressemblance	,analogie	,similarité	,similitude	,analogie	;point commun	
charitable	,égoïste	
imaginaire	,réel	
couché	,debout	,debout	,levé	,sur pied	,debout	,verticalement	,debout	
inerte	,réactif	
religieux	,civil	
>>>	Real_1
petit-gris	,élever	;ramasser	
gibier	,chasser	
jogging	,avoir	,porter	
cadavre	,enterrer	,inhumer	
gifle	,donner	,mettre	,donner	
passerelle	,traverser	
conflit	,avoir maille à partir	
rêve	,réaliser	;vivre	
jour des Morts	,célébrer	,commémorer	
mayonnaise	,consommer	,manger	
serre-tête	,porter	
jeu	,tirer	
vêtement	,porter	;avoir	
chewing-gum	,mâcher	
destin	,accomplir	
claque	,donner	,mettre	
cerf-volant	,faire voler	
jour	,éclairer	
tartine	,manger	;grignoter	
disque	,lancer	
mobylette	,rouler	
banalité	,dire	,énoncer	;asséner	,proférer	
tramway	,emprunter	,prendre	,utiliser	
biberon	,donner	
voie	,passer	,emprunter	,prendre	,faire	;grimper	,gravir	
chasse-mouche	,utiliser	
pays	,habiter	,vivre	,habiter	,vivre	
sondage	,sonder	
carton rouge	,sortir	;dégainer	;brandir	
savon	,savonner	;se laver	,se savonner	
cercueil	,avaler	,boire	,consommer	,picoler	
conte de fées	,raconter	
toasteur	,toaster	
chiffre	,écrire	,tracer	,chiffrer	
bateau	,faire	
vin chaud	,boire	,avaler	
pansement	,porter	
coude	,plier	,replier	;déplier	
quarantaine	,respecter	
escalier	,gravir	,grimper	,monter	;descendre	
toilette	,avoir	,porter	
dessert	,manger	,avaler	
instrument	,jouer	
plateau	,porter	;apporter	,transporter	,manger	
bœuf	,manger	
rame	,ramer	
affiche	,afficher	
histoire	,raconter	
car	,conduire	
couvercle	,mettre	
gants	,enfiler	
toboggan	,faire	
voiture	,conduire	
rive	,longer	
obstacle	,franchir	;escalader	
lieu commun	,dire	,énoncer	;asséner	,proférer	
assiette	,manger	
gymnastique	,faire	,se livrer	,faire	;se livrer	,faire	;se livrer	
dizaine	,dire	,réciter	
chatte	,avoir	,posséder	
râpe	,râper	
continent	;demeurer	,habiter	,séjourner	,vivre	
poncif	,dire	,énoncer	;asséner	,proférer	
trottinette	,faire	,jouer	,se déplacer	,rouler	
haro	,crier	
la pluie et le beau temps	,parler	
taraud	,tarauder	
guitare	,jouer	
chant	,chanter	,interpréter	
drap	,dormir	
triangle	,faire	,jouer	
marches	,gravir	,monter	;escalader	;descendre	
imprimé	,compléter	,remplir	
têtu	,s’entêter	
carte de visite	,donner	,laisser	
pull	,avoir	,porter	
costume	,porter	<arborer	,avoir	,porter	,porter	<arborer	,arborer	
parfum	,porter	
accent	,mettre	,accentuer	,mettre	,accentuer	
nuisette	,avoir	,porter	;dormir	
placard	,remplir	,afficher	,apposer	,coller	,placarder	,afficher	,apposer	,distribuer	
laitue	,manger	
escargot de Bourgogne	,élever	;ramasser	
bouchon d’oreille	,mettre	
maison	,habiter	
nappe	,mettre	
manteau	,avoir	,porter	
autocar	,conduire	
piano	,jouer	
bougeotte	,avoir les fesses qui démangent	
tarot	,jouer	
oreilles	,entendre	,distinguer	,saisir	
soutien-gorge	,porter	
balai	,passer	;manier	;jouer	,passer	
vache	,manger	
cravate	,avoir	,porter	;porter	;arborer	
cadenas	,cadenasser	
seins	,donner	,allaiter	,donner le sein	;montrer	,dévoiler	
musée	,visiter	
protection hygiénique	,avoir	,porter	
>>>	V_0
désir	,désirer	,désirer	
enseignement	,enseigner	
réussite	,réussir	
triomphe	,triompher	
transpiration	,transpirer	
énumératif	,énumérer	
traitement	,traiter	
démontage	,démonter	
vaccination	,vacciner	
embrassement	,embrasser	
vidage	,vider	
inondation	,inonder	
explosion	,exploser	
avancement	,avancer	
rejet	,rejeter	
brossage	,brosser	,brosser	,brosser	
liage	,lier	
emprisonnement	,emprisonner	
appréciation	,apprécier	
planement	,planer	
paiement	,payer	,payer	
affection	,affectionner	
arrestation	,arrêter	
têtu	,tête dure	
enrichissement	,enrichir	
ponte	,pondre	
trafic	,trafiquer	
semailles	,semer	
allumage	,allumer	
sifflet	,siffler	
raccourcissement	,raccourcir	
réaction	,réagir	,réagir	,réagir	,réagir	,réagir	,réagir	,réagir	,réagir	,réagir	
partage	,partager	,partager	
description	,décrire	
exécution	,exécuter	
trottinement	,trottiner	
craquement	,craquer	
portée	,porter	
brûlage	,brûler	
atterrissage	,atterrir	
annulation	,annuler	
génération	,générer	
doute	,douter	
plantage	,planter	
tabac	,fumer	
encombrement	,encombrer	
synthèse	,synthétiser	
oubli	,oublier	,oublier	
sommeil	,sommeiller	
séparation	,séparer	
gaspillage	,gaspiller	
alimenté	,alimenter	
fuyant	,fuir	
aboiements	,aboyer	
apitoiement	,s’apitoyer	
abandon	,abandonner	,abandonner	,s’abandonner	
calcul	,calculer	
dérangement	,déranger	
télécommande	,télécommander	
souvenir	,se souvenir	
exceptionnellement	,excepter	
dévoration	,dévorer	,dévorer	
ronchonnement	,ronchonner	
ouverture	,ouvrir	
réduit à zéro	,réduire à zéro	
se déplacer	,se déplacer	
teinture	,teindre	
classement	,classer	
extinction	,éteindre	
matraquage	,matraquer	
marquage	,marquer	
numérotation	,numéroter	
toux	,tousser	
ouvert	,ouvrir	
sculptural	,sculpter	
pris	,prendre	
chevauchée	,chevaucher	
entraînement	,entraîner	
déformation	,déformer	
hausse	,monter	
immobilisation	,immobiliser	
aération	,aérer	
complot	,comploter	
crainte	,craindre	
éclairage	,éclairer	
simplification	,simplifier	,simplifier	
compliment	,complimenter	
massacre	,massacrer	
débat	,débattre	,débattre	
mise	,mettre	,mettre	
recul	,reculer	
accouchement	,accoucher	
contestataire	,contester	
incorporation	,incorporer	,incorporer	
rebond	,rebondir	,rebondir	
chute	;chuter	,tomber	,chuter	,tomber	,tomber	
apport	,apporter	
rétablissement	,rétablir	
exercice	,exercer	,s’exercer	
destination	,destiner	
>>>	S_3
accentuation	,accent	,accent	
débitrice	,dette	
bilan	,patient	
supérette	,client	,cliente	,clientèle	
détacher	,détachant	
piocher	,pioche	
parier	,mise	
diriger	,direction	
nommer	,nom	;prénom	,nom	
prénommer	,prénom	
ordonnance	,médicament	
addition	,client	,cliente	
hypermarché	,client	,cliente	,clientèle	
louange	,louange	
empoisonner	,poison	
admiration	,objet	,source	
cuir	,article	
lectorat	,éditeur	
enveloppe	,destinataire	,destinataire	,bénéficiaire	,bénéficiaire	
débiteur	,dette	
boulanger	,client	,cliente	
louer	,locataire	,locataire	,locataire	,locataire	
timbre	,colis	;enveloppe	,lettre	
charcuterie	,client	,cliente	
téléphone	,opérateur	
nettoyage	,nettoyeur	
expédier	,destinataire	,destinataire	
juge	,tribunal	
remédier	,remède	,remède	
course	,taxi	;fiacre	
conversation	,sujet	,thème	
taille	,vêtement	
touche	,tournoi	
pansement	,pansement	
poissonnerie	,client	,cliente	
service	,restaurant	
juger	,délit	;crime	,jugement	,jugement	;avis	,opinion	
menuisier	,bois	
boucher	,client	,cliente	
consolation	,consolation	
rapporter	,rapport	
habiller	,habits	,vêtements	
piéger	,piège	
apprendre	,élève	,élève	,étudiante	,étudiant	,expérience	
chèque	,bénéficiaire	,bénéficiaire	;porteur	
trahir	,trahison	
déshabiller	,habits	,vêtements	
accentuer	,accent	,accent	
téléspectateur	,télévision	
ministre	,gouvernement	,état	
discuter	,sujet	,thème	
colis	,destinataire	,destinataire	
envoi	,destinataire	,destinataire	
améliorer	,amélioration	
autopsie	,résultat	
racket	,victime	
plateau	,tir	;ball-trap	
comprimé	,substance active	
multiplier	,multiplicateur	
courriel	,contenu	
coiffage	,peigne	,brosse	
financement	,financement	
coup de grâce	,coup de grâce	
tirage	,tirage	
botter les fesses	,faute	
péage	,péagiste	,péagiste	
pâtisserie	,cliente	,client	
arracher	,arracheuse	
observer	,observation	
bijouterie	,client	,cliente	
télévision	,téléspectateur	,téléspectatrice	
encadrer	,cadre	
bandit	,victime	
théâtre	,public	
inspecteur	,inspection	
panser	,pansement	
vocabulaire	,langue	
qualifier	,qualificatif	
différer	,différence	
visser	,vis	
bombarder	,bombe	,bombardier	
député	,circonscription	
téléspectatrice	,télévision	
bouchère	,client	,cliente	
alimenter	,aliment	
malade	,partie du corps	,maladie	,maladie	
boîte aux lettres	;courrier	
exonérer	,taxe	
fonder	,fondement	
teindre	,teinture	,coloration	
bagage	,domaine	,discipline	
baromètre	,temps	
compenser	,compensation	
voler	,volé	
classe	,classe	
administrable	,administrateur	
mairie	,administré	,administrée	
honneur	,honneur	
tirer	,arme à feu	,loterie	
dater	,date	,datage	
>>>	A_1
exister	,existant	
tambour	,à	
pâleur	,pâle	
dormir	,endormi	,dormant	,endormi	,dormant	
envelopper	,enveloppant	
commodité	,commode	
tuberculose	,tuberculeux	
empathie	,en	
vie	,vivant	,en	
grève	,gréviste	
sapidité	,sapide	
anxiété	,anxieux	
adolescente	,adolescent	
coopération	,coopérant	
se bousculer	,nombreux	,nombreux	
États-unien	,états-unien	
cornes	,cornu	
fonctionner	,en service	
air	,dans	
dent dure	,à	
difficulté	,difficile	
bras long	,à	
tyran	,tyrannique	
incontournable	,incontournable	,incontournable	
rareté	,rare	,rare	
frissonner	,frissonnant	,frissonnant	,frissonnant	
Coréen	,coréen	
se passionner	,passionné	
incommodité	,incommode	
environner	,environnant	
agonie	,à	
saint	,saint	
rafraîchir	,rafraîchissant	
con	,con	
Nord-Coréenne	,nord-coréen	
dur	,dur	
débuter	,débutant	,débutant	
zèle	,plein	,rempli	
transport	,transporté	
épaisseur	,épais	
fortune	,fortuné	
superbe	,superbe	
présence	,présent	
gémir	,gémissant	
paralysé	,paralytique	
fécondité	,fécond	
misogyne	,misogyne	,misogyne	
ivrognesse	,ivrogne	
désinteressement	,désinteressé	
attention	,attentif	
exactitude	,exact	
prison	,prisonnier	
contestataire	,contestataire	,contestataire	
hispanophone	,hispanophone	,hispanophone	
gêner	,gênant	
couleurs	,coloré	
pouvoir	,capable	,à	,susceptible	,capable	
symptôme	,symptomatique	,symptomatique	
marcher	,en marche	,allumé	,en service	
Boche	,boche	,boche	
hétérosexuel	,hétérosexuel	
rampant	,rampant	
insister	,insistant	
rabat-joie	,rabat-joie	
réalité	,réel	
décourager	,décourageant	
probabilité	,probable	
Irlandaise	,irlandais	
modifier	,modificateur	,modificatif	,modifiant	
riche	,riche	,riche	
déplacement	,en	,en	
participer	,participant	
mammifères	,mammifère	
mollesse	,mou	,mou	,mou	,mou	
aimer	,amoureux	
orpheline	,orphelin	,orphelin	
maladie	,atteint	,affecté	,touché	,malade	,atteint	,touché	,malade	,touché	,affecté	,atteint	,malade	,atteint	,touché	,malade	
chanter	,chantant	
en avoir sous la casquette	,intelligent	
protection	,protecteur	
malhonnêteté	,malhonnête	
mineur	,mineur	
séduire	,séduisant	,séduisant	
suspense	,à suspense	
communisme	,communiste	
moderne	,moderne	,moderne	
bâtarde	,bâtard	
majeure	,majeur	
mal-aimé	,mal-aimé	
acquérir	,acquéreur	
boule	,en	
grippe	,malade	,grippé	
grelotter	,grelottant	
ignorer	,ignorant	
marche	,en	,en marche	,en marche	,allumé	,en marche	,composé	
Bretonne	,breton	
griffer	,griffeur	
lenteur	,lent	
inspirer	,inspirateur	
distinction	,distingué	
>>>	S_2^prototyp
mise en scène	,photographe	,photographe	
personne	,âgé	,seul	
dépression	;fluide	;gaz	,liquide	
célébrante	,mariage	;messe	
patiente	,médecin	,médecin	,docteur	,docteure	
battre	,adversaire	,adversaire	,compétitrice	,compétiteur	;record	,carte	,campagne	,sentier	,chemin	,crème	,pâte	,fer	,blé	,ennemi	
design	,meuble	;site	
tramway	,terminus	
tabac	,tabac	
cadre	,entreprise	,parti	,armée	
siège éjectable	,avion	
transmettre	,maladie	,maladie	;microbe	
porteur	,chèque	
conduire	,auto	,moto	,automobile	,train	,voiture	,véhicule	
border	,lit	;drap	,couverture	,enfant	,enfant	
passement	,bras	;jambes	
fondre	,sentiment	,sensation	
gratter	,guitare	,gratte	
chaussée	,véhicule roulant	,véhicule	
siège	,ville	
se coucher	,lit	
petit chien	,accouchement	
confisquer	,antenne	
chausson	,pomme	
bétonné	,béton	
panier	,basket	
réduire	,image	,photographie	
symptomatique	,maladie	
nostalgie	,enfance	,jeunesse	,passé	;pays	,pays	
conter	,histoire	;conte	
voie	,véhicule roulant	,véhicule	,sommet	,voyageur	,voyageuse	
balayer	,nuage	
robinet	,eau	;gaz	;fluide	
analogie	,organe	
hisser	,voile	;drapeau	
cinéma	,cinéaste	,cinéaste	;metteur en scène	,metteur en scène	;réalisateur	,réalisatrice	
pâte	,pain	,pizza	,gâteau	,tarte	,biscuit	,beignet	,chou	,crêpe	,gaufre	
compatir	,douleur	;malheur	;tristesse	
débit	,bois	
vase	,fleur	,fleur coupée	
signature	,courriel	
huile	,mécanisme	,moteur	
avoir des nouvelles	,avocat	
toaster	,pain	;tartine	
table	,restaurant	,auberge	
transporté	,admiration	
gauche	,cœur	
posture	,yoga	
tempête	,protestation	
théâtre	,accident	;drame	
résultat	,compétition	
tête	,liste	,sondage	
aéroporté	,avion	,hélicoptère	
patient	,médecin	,médecin	,docteur	,docteure	
plaque	,épitaphe	
conducteur	,voiture	,véhicule	,automobile	,moto	,auto	,autobus	,autocar	,bus	,camion	,car	,métro	,train	,tramway	
amarre	,bateau	
éclairé	,lampe	
régime	,sujet	,objet	
menottes	,main	,poignet	,bras	;prisonnier	,prisonnière	
aspirateur	,poussière	
chiffon	,poussière	
geler	,salaire	
consultation	,médecin	,médecin	
cultiver	,plante	
bouchon	,bouteille	,bouteille	
paille	,boisson	
réserviste	,armée	,police	
tablette	,chocolat	
écran	,film	
visé	,accusation	
plan	,film	
chauffeur	,autobus	,autocar	,bus	,camion	,car	
détourner	,regard	
collaborer	,Allemand	
flamber	,banane	
cailler	,lait	,fesses	,miches	
apprendre	,savoir	;discipline	
escalade	,montagne	;rocher	,col	,côte	
toilette	,porc	,veau	
passage	,passage	,passage	
s’asseoir	,chaise	,fauteuil	,siège	
chaussette	,café	;thé	,hydrocarbure	
lait	,nourrisson	;bébé	,enfant	,enfant	,nouveau-né	,nouvelle-née	;petit	,petite	
colis abandonné	,train	
stade	,sport	
champ	,blé	,formulaire	,arme à feu	
factrice	,courrier	,lettre	;colis	,paquet	,clavecin	;flûte	;orgue	;piano	
fonder	,famille	
patins	,luge	
prier	,Dieu	
habit	,catholicisme	,bouddhisme	
boulangère	,pain	;viennoiserie	
pièce d’ameublement	,pièce	;appartement	,maison	
pâté	,lapin	,volaille	
condamner	,accusé	,accusée	
éclair	,café	;chocolat	;vanille	
quai	,gare	;métro	,métro	,train	
collaboration	,Allemand	
passer	,passage	,passage	
>>>	Syn_⊃^sex
blagueur	,blagueuse	
infirmier	,infirmière	
délinquant	,délinquante	
avocat	,avocate	,avocate	
petit	,petite	
correspondant	,correspondante	,correspondante	
végétarien	,végétarienne	
fondeur	,fondeuse	
juriste	,juriste	
coupeur de cheveux en quatre	,coupeuse de cheveux en quatre	
combattant	,combattante	,combattante	
écologue	,écologue	
magicienne	,magicien	
maçon	,maçonne	
béni-oui-oui	,béni-oui-oui	
gendarme	,gendarme	,gendarmette	
déclarant	,déclarante	
familier	,familière	
romancier	,romancière	
président	,présidente	,présidente	
timide	,timide	
grippé	,grippée	
comploteur	,comploteuse	
Chinois	,Chinoise	
pisseur	,pisseuse	
aviculteur	,avicultrice	
anonyme	,anonyme	
aventurier	,aventurière	
margrave	,margrave	
lion	,lionne	
boulanger	,boulangère	,boulangère	
trouillarde	,trouillard	
puni	,punie	
monarchiste	,monarchiste	
concepteur	,conceptrice	
inconscient	,inconsciente	
blond	,blonde	
égoïste	,égoïste	
doc	,doc	
emprunteur	,emprunteuse	
tuberculeux	,tuberculeuse	
coopérant	,coopérante	
voyageur	,voyageuse	
pécheur	,pécheresse	
parieur	,parieuse	
aborigène	,aborigène	
angoissé	,angoissée	
clochard	,clocharde	
gueulard	,gueularde	
facteur	,factrice	,factrice	
cancéreux	,cancéreuse	
Breton	,Bretonne	
auditeur	,auditrice	
poissonnier	,poissonnière	
impertinent	,impertinente	
muet	,muette	
joaillier	,joaillière	
candidat	,candidate	
insulaire	,insulaire	
ami	,amie	,amie	,amie	
bodybuilder	,bodybuildeuse	
dévoreur	,dévoreuse	,dévoreuse	
compétiteur	,compétitrice	
développeur	,développeuse	
utilisateur	,utilisatrice	
inspecteur	,inspectrice	
joggeur	,joggeuse	
âne	,ânesse	
gymnaste	,gymnaste	
cultivateur	,cultivatrice	
alcoolo	,alcoolo	,alcoolique	
ignorant	,ignorante	
descripteur	,descriptrice	
débrouillard	,débrouillarde	
pensionné	,pensionnée	
sourd	,sourde	
milliardaire	,milliardaire	
musulman	,musulmane	
instituteur	,institutrice	,instit	
producteur	,productrice	
batelier	,batelière	
skieur	,skieuse	
contestataire	,contestataire	
abandonné	,abandonnée	
vétérinaire	,vétérinaire	
amateur	,amatrice	
fan	,fan	
accro	,accro	,accro	
chimiste	,chimiste	
jumeaux	,jumelles	
kidnappeur	,kidnappeuse	
fuyard	,fuyarde	
restaurateur	,restauratrice	
messager	,messagère	
pote	,pote	
émetteur	,émettrice	,émettrice	
ogre	,ogresse	
réalisateur	,réalisatrice	
tendre	,tendre	
roux	,rousse	
>>>	Adv_0
manuel	,manuellement	
exceptionnel	,exceptionnellement	,exceptionnellement	
électrique	,électriquement	
respectueux	,respectueusement	
exact	,exactement	
supplément	,supplémentairement	
absolu	,absolument	
religion	,religieusement	
brusque	,brusquement	
impeccable	,impeccablement	,impec	
individuel	,individuellement	
intérieur	,intérieurement	,intérieurement	
assurer	,assurément	
uniforme	,uniformément	
dru	,dru	
grammaire	,grammaticalement	
excepter	,exceptionnellement	
adroit	,adroitement	,adroitement	
hebdomadaire	,hebdomadairement	
précoce	,précocement	
sérieux	,sérieusement	
cher	,chèrement	
temporel	,temporellement	
calme	,calmement	
franc	,franchement	
formidable	,formidablement	,formidablement	
géographie	,géographiquement	
histoire	,historiquement	
curieux	,curieusement	,curieusement	
prompt	,promptement	
illusion	,illusoirement	
danger	,dangereusement	
scandale	,scandaleusement	
furieux	,furieusement	
constant	,constamment	
habituel	,habituellement	
indépendant	,indépendamment	
profond	,profond	,profondément	
incroyable	,incroyablement	
fidèle	,fidèlement	
illisible	,illisiblement	
national	,nationalement	
insuffisance	,insuffisamment	
chimique	,chimiquement	,chimiquement	
objectif	,objectivement	
pâle	,pâlement	
bizarre	,bizarrement	
cérébral	,cérébralement	
pertinent	,pertinemment	
égal	,également	
urgent	,urgemment	
maladroit	,maladroitement	,maladroitement	
force	,fort	,fortement	
partiel	,partiellement	
parallèle	,parallèlement	
profitable	,profitablement	
bénévole	,bénévolement	
musique	,musicalement	
conceptuel	,conceptuellement	
impec	,impeccablement	,impec	
geste	,gestuellement	
délicat	,délicatement	
gracieux	,gracieusement	
torrentiel	,torrentiellement	
stratégie	,stratégiquement	
après-coup	,après coup	
souple	,souplement	
adorable	,adorablement	
effectif	,effectivement	
modéré	,modérément	
entier	,entièrement	
toucher	,tactilement	
commercial	,commercialement	
diable	,diaboliquement	
profession	,professionnellement	
exagéré	,trop	
drame	,dramatiquement	
cinéma	,cinématographiquement	
atroce	,atrocement	
suffire	,suffisamment	
agile	,agilement	
obligatoire	,obligatoirement	
incomplet	,incomplètement	
lamentable	,lamentablement	
savant	,savamment	,savamment	
innocence	,innocemment	
alphabet	,alphabétiquement	
confidentiel	,confidentiellement	
inverse	,inversement	
naturel	,naturellement	
temps	,temporellement	
divers	,diversement	
actif	,activement	
commencer	,depuis	
facile	,facilement	
fonctionnel	,fonctionnellement	
timidité	,timidement	
logique	,logiquement	
définitif	,définitivement	
atomique	,atomiquement	
>>>	S_instr
odorat	,nez	,nez	
goût	,langue	;papilles	;palais	
ping-pong	,balle	;raquette	;ping-pong	,table de ping-pong	
toilette	,gant de toilette	,linge	,objet	,parure	;gel douche	,produit	,savon	;affaires	,nécessaire	
ramer	,rame	,rame	
boxe	,gants	
radio	,radio	
basket	,ballon	;panier	
tennis	,balle	;raquette	;filet	
allaiter	,seins	
courriel	;boîte mail	;serveur	
voiture	,voiture	
klaxonner	,klaxon	
condamner	,jugement	,verdict	
tout oreilles	,oreilles	
aller	,moyen de transport	
plage	;parasol	,paillasse	,tapis de plage	;maillot	,serviette	;bouée	,palmes	,masque	,tuba	
coiffeuse	,ciseaux	;brosse	,peigne	;sèche-cheveux	
menotter	,menottes	
faire de l’essence	,pompe	
nourrir	,seins	
moudre	,moulin	;moulin à café	
coup de poing	,coup de poing	
dentiste	,davier	;fraise	;roulette	,davier	;fraise	;roulette	
seller	,selle	
donner le sein	,seins	
piquer	,seringue	
sucer	,bouche	,lèvres	,bouche	
rugby	,ballon	;buts	,poteaux	
laver	,douche	,baignoire	,lavabo	
s’éventer	,éventail	
imprimer	,presse	;imprimante	
volley-ball	,ballon	;filet	
bain	,baignoire	
observer	,microscope	,loupe	,lunette	
sentir	,nez	;nez	
uriner	,urinoir	;toilettes	
déboucher	,tire-bouchon	
chanter	,corde vocale	,larynx	,larynx	,corde vocale	
tourner	,caméra	
prêcher	,sermon	
bouchère	,couteau	;crochet	
boxeur	,gants	
zapper	,télécommande	
crime	,arme	
mesurer	,règle	,mètre	;instrument de mesure	
escalader	,bicyclette	,vélo	
droite	,main droite	
se moucher	,mouchoir	;doigt	
communication	,téléphone	
douche	,douche	;fleur de douche	
téléphoner	,téléphone	
skier	,skis	
mesure	,mètre	,règle	;instrument de mesure	
violon	,archet	
pompier	,camion	;lance	;bouche d’incendie	,camion	;lance	;bouche d’incendie	
vol	,avion	
médecin	,stéthoscope	,stéthoscope	
flatter	,compliment	
voler	,aile	,avion	,avion	
harnacher	,harnais	
matraquer	,matraque	
éventer	,éventail	
poignarder	,poignard	
distinguer	,oreilles	
se doucher	,douche	
jogging	,baskets	
judo	,kimono	,judogi	
battre	,fouet	,batteuse	
voyager	,avion	,autocar	,train	,voiture	
ski	;bâton	;chaussures	;skis	
flûte	,flûte	
mécanicienne	,outil	
cirer	,cire	,cirage	
triangle	,baguettes	
respirer	,nez	,narines	,narine	
karaté	,kimono	,karatégi	
droit	,main droite	
se réveiller	,réveil	
crayonner	,crayon	
pieuter	,lit	,pieu	,paddock	,pageot	
coiffeur	,ciseaux	;brosse	,peigne	;sèche-cheveux	
imaginer	,imagination	
orchestre	,instrument de musique	
punaiser	,punaise	
articuler	,articulateur	
football	,ballon	;buts	,cage	
boulangère	,pétrin	;four	
boulanger	;pétrin	;four	
musique	,instrument de musique	,instrument de musique	,instrument de musique	
hold-up	,arme	
lavis	,pinceau	
bêcher	,bêche	
adapter	,adaptateur	
mécanicien	,outil	
doucher	,douche	
klaxon	,klaxon	
entendre	,oreilles	
badminton	,volant	;raquette	
boucher	,couteau	;crochet	,esse	
>>>	Syn_⊂
état mental	,état psychique	
instructeur	,militaire	
tignasse	,chevelure	
meuble	,bien	,ameublement	
cacher son jeu	,dissimuler	
assiette	,base	,état d’esprit	
jouir	,utiliser	
parfum	,odeur	
avancé	,situé	
forme	,état	,état	,matrice	
se désertifier	,se transformer	
métal	,métal	
coup de torchon	,suppression	,nettoyage	
marquer le coup	,manifester	
passer à la casserole	,faire l’amour	
remuscler	,muscler	
cagibi	,placard	
souper	,manger	,bouffer	,repas	,repas	
frayeur	,peur	
chien de mer	,requin	
siester	,dormir	
revolver	,pistolet	
diligence	,voiture	
caresser la bouteille	,boire	
âge d’or	,période	
flottille	,flotte	
pratiquer	,faire	
crachin	,pluie	
véreux	,malhonnête	
s’avancer	,se déplacer	
maison	,institution	,entreprise	
dégueu	,sale	<cracra	,crade	,cradingue	,crado	,cradoque	,craspec	,crasseux	,sale	<cracra	,crade	,cradingue	,crado	,cradoque	,sale	<cracra	,crasseux	,crade	,cradingue	,crado	,cradoque	
avalanche	,chute	
sac	,sac	
récupérer	,prendre	
pays	,lieu	
maman	,mère	,mère	
bungalow	,maison	
faire long feu	,s’allumer	
aller à la selle	,aller aux toilettes	
balais	,an	
accoupler	,réunir	
étiologique	,diagnostique	
nager	,se déplacer	,nager	,se trouver	,se trouver	,nager	
débouchement	,débouchage	
crise de nerfs	,émotion	
se taper la cloche	,manger	
papeterie	,magasin	
averse	,précipitation	;pluie	,pluie	,flot	,pluie	,flot	
craspec	,sale	,sale	,sale	,sale	
amuser	,occuper	
long	,grand	
fanfare	,orchestre	,musique	,bruit	
classe	,pièce	
gué	,passage	
essence de térébenthine	,essence	
écrevisse	,rouge	
routier	,chauffeur	
solder	,clôturer	,acquitter	
intervalle	,écart	
calcul	,obstruction	
voleter	,voler	,voler	
actionnaire	,propriétaire	,propriétaire	
attraper	,prendre	
lisse	,barre	
défunt	,mort	,mort	
manger dans la même écuelle	,partager	
canard boiteux	,individu	
vagir	,crier	
s’élever	,être	
journal	,feuille de chou	
mess	,cantine	
empreintes	,empreinte	
narine	;orifice	;conduit	
ultime	,final	
eau de mer	,eau	
titre	,droit	
microscopique	,petit	
délit de sale gueule	,attitude	
japper	,aboyer	
repousser	,pousser	
surnom	,nom	
élimé	,usé	
crico-aryténoïdien	,cricoïdien	;aryténoïdien	
association d’idées	,analogie	
impliquer	,causer	
intervention	,discours	
droits de mutation	,frais	
boiter	,marcher	,fonctionner	
étranger	,extérieur	
baigner	,laver	
coup de filet	,opération	
cigarillo	,cigare	
mouche	,appât	
guêpier	,nid	
préfecture	,ville	
cation	,ion	
concurrence	,rivalité	
branlée	,défaite	
glu	,colle	
>>>	Syn
pince	,main	,pieds	
orteil	,pouce	
fonds commun de placement à risque	,FCPR	
quasiment	,quasi	
palmier dattier	,dattier	
vêto	,vétérinaire	
gifle	,baffe	
avoir un trou dans le cigare	,avoir un trou dans la tête	
sommaire	,succinct	
souci	,problème	
capuchon	,capuche	
10 000 mètres	,10 kilomètres	
gaspi	,gaspillage	
amphibiens	,batraciens	
coloration	,couleur	,teinture	,couleur	,teinture	,couleur	,teinture	
minou	,foufoune	,zézette	,chatte	,moule	,vulve	
3D	,3 dimensions	
préservatif	,capote	,condom	
valises	,valoches	
soldate	,soldat	,femme soldat	
mère nourricière	,nourrice	
se finir	,finir	
accident vasculaire cérébral	,AVC	
phishing	,hameçonnage	
à califourchon	,à cheval	
aspirateur	,aspi	
pendant	,durant	,durant	
adéquat	,adapté	,approprié	,conforme	,congruent	,idoine	
musulman	,islamique	
bouffer dans la main	,manger dans la main	
T9	,F9	,neuf-pièces	
quasi	,quasiment	
caoutchouc	,élastique	
colvert	,malard	
T4	,F4	,quatre-pièces	
jouet	,joujou	
planche à pain	,limande	
tige	,clope	,garo	,schmer	,cigarette	,sèche	,cancéreuse	,cibiche	
chasseresse	,chasseuse	
cabinets	,toilettes	,W.-C.	,waters	,water-closet	,petit endroit	,tinette	,vécés	,wawas	,cagoinces	,chiottes	,goguenots	,gogues	,tartisses	,cabinet d’aisances	,commodités	,lieux d’aisances	,sanitaires	
boîte à lettres	,boîte aux lettres	,boîte aux lettres	
oncle	,tonton	
pédaler dans le vide	,pédaler dans la choucroute	,dans la semoule	,pédaler dans le yaourt	
Bon appétit	,Bon app’!	
rando	,randonnée	,randonnée	
schmer	,clope	,garo	,tige	,cigarette	,sèche	,cancéreuse	,cibiche	
frousse	,trouille	,peur	
pieuter	,dormir	
Les mains en l’air!	,Haut les mains !	
bifteck	,steak	
en écraser	,ronfler	
polar	,roman policier	
petit-déjeuner	,petit-déj	,petit-déj	
fromage	,frometon	
flotteur	,bouchon	
lac	,citerne	,sinus	
miel	,Merde !	,cérumen	
volcan	,montagne de feu	
rendez-vous	,RDV	
bouffée	,taffe	
plastoc	,plastique	
pillard	,pilleur	
popotin	,paire de fesses	,cul	,derrière	,panier	,arrière-train	,postérieur	,séant	,miches	,pétard	,croupe	,croupion	,fessier	,derche	,lune	
jambes	,gambettes	,guibolles	,cannes	,pattes	
peine	,difficulté	
F9	,neuf-pièces	,T9	
table de chevet	,table de nuit	
poire	,boule	,caboche	,carafe	,cigare	,crâne	,pomme	,chef	,tête	
se geler les fesses	,cailler	,geler	
causeur	,causant	
trois	,3	,3	,3	,3	
belle-d’un-jour	,hémérocalle	
mai 68	,68	
recevoir	,prendre	
SF	,science-fiction	
médecin légiste	,légiste	,légiste	
éducatif	,éducateur	
merde	,caca	,crotte	,étron	,caca	,pétrin	
Méfiance est mère de sûreté.	,Prudence est mère de sûreté.	
muscu	,musculation	
rebond	,rebondissement	
chiottes	,cagoinces	,goguenots	,gogues	,tartisses	,cabinets	,toilettes	,W.-C.	,waters	,water-closet	,petit endroit	,tinette	,vécés	,wawas	,cabinet d’aisances	,commodités	,lieux d’aisances	,sanitaires	,cagoinces	,goguenots	,gogues	,tartisses	,cabinets	,petit coin	,toilettes	,W.-C.	,waters	,water-closet	,pipi-room	,tinettes	,vécés	,wawas	,cabinet d’aisances	,commodités	,lieux d’aisances	,sanitaires	
dégueu	,dégueulasse	,dégueulasse	,dégueulasse	,dégueulasse	,dégueulasse	,dégueulasse	,dégueulasse	,dégueulasse	,dégueulasse	,dégueulasse	,dégueulasse	,dégueulasse	,dégueulasse	,dégueulasse	
frangine	,sœurette	,sœur	
bureau de tabac	,débit de tabac	,tabac	
corbeille	,poubelle	
eau	,flotte	,flotte	
pineraie	,pinière	,pinède	
perso	,personnel	
montre	,tocante	
viande	,barbaque	
tifs	,cheveux	,chevelure	
prêcher dans le désert	,crier dans le désert	,parler dans le désert	
collabo	,collaborateur	,collaboratrice	
futal	,fute	,ben	,bénard	,falzar	,fendard	,froc	,culotte	,pantalon	
table de ping-pong	,ping-pong	
cancéreuse	,sèche	,cibiche	,cigarette	,clope	,garo	,tige	,schmer	
lancer	,jeter	
dans la semoule	,pédaler dans la choucroute	,pédaler dans le vide	,pédaler dans le yaourt	
menotte	;mimine	
>>>	S_1Pred
hospitalisé	,hospitalisé	,hospitalisée	
myope	,myope	,myope	
germanique	,Germanique	,Germanique	
gentil	,gentil	,gentille	
hétérosexuel	,hétérosexuel	,hétérosexuelle	
titulaire	,titulaire	
cul-de-jatte	,cul-de-jatte	,cul-de-jatte	
têtu	,têtu	,têtue	<entêté	,entêtée	;cabochard	,cabocharde	,tête de mule	,tête de cochon	
lâche	,lâche	,lâche	
portugais	,Portugais	,Portugaise	
canadien	,Canadien	,Canadienne	
francophone	,francophone	,francophone	
bon	,bon	
jeune	,jeune	,jeune	
mineur	,mineur	,mineure	
japonais	,Japonais	,Japonaise	
laid	,laid	,laide	
incontournable	,incontournable	,incontournable	
féminin	,femme	
belge	,Belge	,Belge	
russophone	,russophone	,russophone	
chleuh	,Chleuh	,Chleuh	,Chleuh	,Chleuh	
bienheureux	,bienheureux	
fort	,fort	
pair	,nombre	;chiffre	
franc	,Franc	
millionnaire	,millionnaire	,millionnaire	
couard	,couard	,couarde	
criminel	,crime	,crime	,crime	
imbécile	,imbécile	,imbécile	
vieux	,vieux	,vieille	
breton	,Breton	,Bretonne	
héroïque	,héros	,héroïne	
chrétien	,chrétienne	,chrétien	
insulaire	,insulaire	,insulaire	
sourd	,sourd	,sourde	,bruit	
adulte	,adulte	,adulte	
juif	,juif	,juive	
célibataire	,célibataire	,célibataire	
turc	,Turc	,Turque	
québécois	,Québécois	,Québécoise	
pauvre	,pauvre	,pauvre	
inconscient	,inconscient	,inconsciente	
suédois	,Suédois	,Suédoise	
excentrique	,excentrique	,excentrique	,excentricité	
célèbre	,célébrité	
anonyme	,anonyme	,anonyme	
boulimique	,boulimique	,boulimique	
ingrat	,ingrat	,ingrate	
anglophone	,anglophone	,anglophone	
européen	,Européen	,Européenne	
communiste	,communiste	,communiste	
suisse	,Suisse	,Suisse	,Suissesse	
mélomane	,mélomane	,mélomane	
solide	,solide	
idiot	,idiot	,idiote	
voyou	,voyou	
obèse	,obèse	,obèse	
catholique	,catholique	,catholique	
aveugle	,aveugle	,aveugle	
acquéreur	,acquéreur	
merveilleux	,merveille	
innocent	,innocent	,innocente	
original	,original	,original	
indiscret	,indiscret	,indiscrète	
fabulateur	,fabulateur	,fabulatrice	
rouge	,rouge	,rouge	
carié	,dent	
indien	,Indien	,Indienne	,Indien	,Indienne	
alcoolique	,alcoolique	,alcoolique	
boche	,Boche	,Boche	
américain	,Américain	,Américaine	,Américain	,Américaine	
immigré	,immigré	,immigrée	
bavard	,bavarde	,bavard	
blessé	,blessé	,blessée	
agressé	,agressé	,agressée	
sud-américain	,Sud-Américain	,Sud-Américaine	
bouddhiste	,bouddhiste	,bouddhiste	
lusophone	,lusophone	,lusophone	
infirme	,infirme	,infirme	
hispanophone	,hispanophone	,hispanophone	
mâle	,mâle	
coco	,coco	,coco	
timide	,timide	,timide	
rusé	,rusé	,rusée	
chauve	,chauve	,chauve	
anglais	,Anglais	,Anglaise	
accidenté	,accidenté	,accidentée	
extraterrestre	,extraterrestre	,extraterrestre	
gazeux	,gaz	
gallois	,Gallois	,Galloise	
allemand	,Allemand	,Allemande	
long	,vin	
ordinaire	,ordinaire	
musulman	,musulman	,musulmane	
irlandais	,Irlandais	,Irlandaise	
beau	,beauté	
espagnol	,Espagnol	,Espagnole	
victorieux	,vainqueur	
rival	,rival	;rivale	
>>>	S_2
abandonner	,compétition	
assureur	,assuré	
sous-tasse	,tasse	
valise	,contenu	;valise	
valeur	,valeur	
animer	,antenne	
jouer	,sport	,instrument	,musique	,rôle	
prédateur	,proie	
coûter	;prix	,coût	
éprouvé	,épreuve	
finir	,fin	
complot	,victime	
afficher	,affiche	
charcuterie	,charcuterie	
canner	,chaise	,fauteuil	,siège	
ressentir	,émotion	,sentiment	;sensation	
comprimé	,maladie	,trouble	
champ d’investigation	,chercheur	,chercheuse	
contenant	,contenu	
chipoter	,nourriture	
produit	,facteur	
lisse	,métier à tisser	
table	,client	,cliente	
longueur	,longueur	
plateau	,fusil	;carabine	
chiqueur	,tabac	
odorat	,odeur	
chasser	,proie	
choix	,choix	
bagages	,bagage	
ramer	,plante	
habillé	,vêtements	;vêtement	
mardi	,semaine	
médecine	,patient	,patiente	,malade	,malade	
recherche	,objet	
coiffeuse	,client	,cliente	
lune	,mois	
escalade	,obstacle	
collaborer	,occupant	
culotter	,pipe	
renifler	,odeur	
regret	,regret	
maman	;enfant	
tramway	,arrêt	,station	
toaster	,toast	
baragouinage	,baragouinage	
automobile	,véhicule	
compte de bilan	,actif	,passif	
manger	,manger	;nourriture	
molécule	,substance	
débuter	,début	
transférer	,sentiment	
dentiste	,patient	,patiente	,patient	,patiente	
affirmateur	,affirmation	
exploré	,explorateur	,exploratrice	
conte de fées	,histoire	
chèque	,montant	
soulevé	,sentiment	
placard	,peau	
conte	,histoire	
week-end	,semaine	
soutif	,poitrine	,seins	
baguettes	,instrument à percussion	
cigarettier	,cigarette	
jeudi	,semaine	
protecteur	,protégé	
fondé	,fondement	
se confier	,confident	,confidente	
semeur	,semence	;graine	
aiguille	,seringue	
cinéaste	,film	
marin	,bateau	
sinistre	,sinistré	,sinistrée	
vicié	,vice	
casser la croûte	,casse-croûte	
promenade	,lieu	;promenade	,cour	
emboucher	,instrument à vent	
enveloppe	,contenu	
protéger	,protégé	,protégée	
pharmacie	,pharmacie	
transparent	,rétroprojecteur	
tragédie	,tragédien	,tragédienne	,acteur	,actrice	
contenir	,contenu	,contenu	
nation	,pays	
rockeuse	,rock	
exécuté	,exécuteur	,exécutrice	
se focaliser	,foyer	
couver	,œuf	
mobiler	,mobiler	
s’expliquer	,explication	
avocat	,client	,cliente	,cause	
se fonder	,fondement	
urne	,bulletin de vote	
élever	,petit	
presse	,presse	
honte	,honte	
rempailler	,chaise	,fauteuil	,siège	
avoir pied	,eau	
masse	,masse	
belle-sœur	,belle-sœur	,beau-frère	
>>>	S_1^usual
gérer	,gestionnaire	,gestionnaire	
Internet	,internaute	,internaute	
jouer	,musicien	,musicienne	,musicien	,musicienne	
s’engager	,engagé	,engagée	
photographier	,photographe	,photographe	
médecine	,médecin	,médecin	,femme médecin	,docteur	,docteure	
licencié	,salarié	,salariée	
publicité	,publicitaire	,publicitaire	
roue	,véhicule	
volley-ball	;joueur	,joueuse	,volleyeur	,volleyeuse	
plein	,pompiste	,pompiste	,mer	
tamponneur	,auto	
apiculture	,apiculteur	,apicultrice	
collection	,livre	
batterie	,batteur	,batteuse	
vilain	,vilain	,vilaine	
grammaire	,grammairien	,grammairienne	
vache	,éleveur	,éleveuse	;vacher	,vachère	
bus	,chauffeur	,conducteur	,conductrice	
maïs	,maïsiculteur	,maïsicultrice	
concombre	,cultivateur	,cultivatrice	
couper les cheveux en quatre	,coupeur de cheveux en quatre	,coupeuse de cheveux en quatre	
marionnette	,marionnettiste	,marionnettiste	
sondage	,sondeur	
cheval	,éleveur	,éleveuse	,palefrenier	,palefrenière	,cavalier	,cavalière	;écuyer	,écuyère	
critique	,critique	,critique	,critique	,critique	
fabriquer	,fabricant	,fabricante	
plumes	,oiseau	
casser les couilles	,casse-couilles	,casse-couilles	
défendre	,avocat	,avocate	,avocate	,avocat	
production	,producteur	,productrice	
secourir	,secouriste	
pensionné	,pensionné	,pensionnée	
nettoyeur	,nettoyeur	,nettoyeuse	
volaille	,aviculteur	,avicultrice	;éleveur	,éleveuse	
musique	,musicien	,musicienne	,interprète	,interprète	
camping	,campeur	,campeuse	
masser	,masseur	,masseuse	
dessin	,dessinatrice	,dessinateur	
devoirs	,élève	,élève	
jugeable	,juge	
ping-pong	,pongiste	,pongiste	
laisse	,chien	
manger la feuille de match	,footballeur	,footballeuse	
poser	,installateur	,installatrice	
péter	,péteur	,péteuse	
oignon	,cultivateur	,cultivatrice	
génial	,génie	
roman	,romancier	;romancière	
guichet	,guichetier	,guichetière	
ivre	,ivrogne	,ivrogne	,ivrognesse	
pompe	,pompiste	,pompiste	;garagiste	,garagiste	
gueuler	,gueulard	,gueularde	
souder	,soudeur	,soudeuse	
toilette	,toiletteur	,toiletteuse	
pizza	,pizzaiolo	,pizzaiola	
guignol	,marionnettiste	,marionnettiste	
pansement	,panseur	,panseuse	
mélancolie	,mélancolique	,mélancolique	
préparation	,cuisinier	,cuisinière	,cuisinier	,cuisinière	
raser	,barbier	
distraction	,distrait	,distraite	
foie	,bœuf	,veau	
enjôler	,enjôleur	,enjôleuse	
voiture	,cocher	
opéra	,cantatrice	,chanteur	,chanteuse	
savonneux	,savon	
champ	,paysan	,agriculteur	,agricultrice	,paysanne	
surveiller	,surveillant	,surveillante	
escalade	,alpiniste	,alpiniste	
couper les cheveux	,coiffeur	,coiffeuse	
balayer	,balayeuse	,balayeur	
grue	,grutier	,grutière	
cale	,navire	,bateau	
enseigner	,enseignant	,enseignante	
dormir	,dormeuse	,dormeur	
cuisine	,cuisinier	,cuisinière	,cuisinier	,cuisinière	,cuisinier	,cuisinière	
imagination	,imaginatif	,imaginative	
moulin	,meunier	,meunière	
architecture	,architecte	,architecte	
rugby	;joueur	,joueuse	,rugbyman	,rugbyman	,rugbywoman	
poème	,poète	,poétesse	
fable	,fabuliste	,fabuliste	,fabulateur	,fabulatrice	
assister	,assistante	,assistant	
moutarde	,cultivateur	,cultivatrice	
préparer	,cuisinier	,cuisinière	
conseil	,conseiller	,conseillère	
piste	,disque	
résorber	,médecin	,médecin	;chirurgien	,chirurgienne	
porc	,éleveur	,éleveuse	;porcher	,porchère	
peur	,peureux	,peureuse	
pois	,cultivateur	,cultivatrice	
entêtement	,têtu	,têtue	
anxiété	,anxieux	,anxieuse	
prévision	,prévisionniste	,prévisionniste	
gribouiller	,gribouilleur	,gribouilleur	
haricot	,cultivateur	,cultivatrice	
culture	,cultivateur	,cultivatrice	
électronique	,électronicien	,électronicienne	
commenter	,commentateur	,commentatrice	
>>>	Magn
à ravir	,bien	
spécialiste	,grand	;expert	
certifer	,sur l’honneur	
alcool	,fort	,à ressusciter les morts	,casse-poitrine	
mentir	,comme on respire	,comme un arracheur de dents	
libre	,comme l’air	,comme le vent	
pâle	,blême	,livide	,blême	,livide	
rouge	,ardent	,brillant	,vif	;foncé	,sombre	,ardent	,brillant	,vif	;foncé	,sombre	,tout	;cramoisi	;écarlate	;pourpre	,tout	;comme un coq	,comme un coquelicot	,comme un homard	,comme une écrevisse	,comme une pivoine	,comme une tomate	;cramoisi	;écrevisse	;pourpre	;rougeaud	;rubicond	;écarlate	;sanguin	
collaboration	,étroit	
moyen	,très	,médiocre	
pagaille	,gros	,joyeux	,sacré	
skis	,grand	,long	
fatigué	,épuisé	
bien	,grand	<immense	<fou	,très	,rudement	<terriblement	<mieux	;très	<parfaitement	,admirablement	,à merveille	,formidablement	,merveilleusement	,formidablement	,remarquablement	,mieux	,meilleur	,très	
éclair	,vif	<aveuglant	,éblouissant	,foudroyant	,fulgurant	,violent	,terrible	;grand	,large	,vif	,brillant	<éblouissant	,aveuglant	,lumineux	
collaborer	,étroitement	
fâché	,hors de ses gonds	
coma	,profond	
enveloppe	,gros	,important	
longueur	,grand	,grand	,grand	
chanter	,fort	<à tue-tête	,à pleins poumons	,à pleine voix	
pas	,du tout	,le moins du monde	;en aucune façon	,nullement	
réagir	,fortement	,violemment	,vivement	
avoir	,bien	,complètement	
lien	,intime	,étroit	
bâiller	,aux corneilles	
surveillé	,étroitement	
droit	,comme un i	
bandit	,de grand chemin	
franchement	,très	;en tout [Y]	
fesses	,rebondi	,dodu	<gros	,gras	,d’éléphant	
fond	,fin	,fin	,fin	
sale	,bien	;très	,cracra	,crade	,cradingue	,crado	,cradoque	,crasseux	<dégueu	,dégueulasse	;comme un cochon	,comme un peigne	,comme un porc	,comme un pou	,comme une truie	,de la tête aux pieds	,crade	,crado	,cradoque	,crasseux	<dégueulasse	,dégueu	,crasseux	,crado	,cracra	,cradingue	,craspec	,crade	,cradoque	<dégueulasse	,dégueu	,cracra	,crade	,cradingue	,crado	,cradoque	<dégueulasse	,dégueu	,crade	,cradingue	,crado	,cradoque	,craspec	<dégueulasse	,dégueu	,cracra	,crade	,cradingue	,crado	,cradoque	,craspec	<dégueulasse	,dégueu	,dégueulasse	,dégueu	
rire	,à belles dents	;à gorge déployée	
addition	,coup de fusil	
tornade	,violent	,terrible	,violent	,violent	
bouffer	,beaucoup	;avidement	;goulûment	;copieusement	;à belles dents	,de bon appétit	,de bon cœur	<à se faire péter la panse	,à se faire péter la sous-ventrière	,se faire péter la panse	,comme quatre	,comme un ogre	,énormément	,tout cru	
vite	,plus _Adv que la musique	,ventre à terre	,plus _Adv que la musique	
lumineux	,éclatant	,resplendissant	;éblouissant	
horreur	,saint	
ami	,bon	,grand	,vrai	<meilleur	;intime	,proche	,grand	<fervent	
savon	,mémorable	;sacré	
sourire	,à belles dents	
bière	,fort	
assis	,bien	<solidement	,bien	,solidement	
ennemi	<juré	<pire	<juré	,farouche	,pire	
se lier	,fortement	
boire	,beaucoup	,sec	<trop	,à tire-larigot	,comme un trou	,jusqu’à plus soif	,beaucoup	,sec	<trop	
nez	,gros	
analogie	,singulier	,saisissant	,évident	,remarquable	,singulier	<frappant	,saisissant	,évident	,fort	,remarquable	,profond	,grand	<étroit	<absolu	,complet	,parfait	
lettre	,long	
barbiche	,barbe	
serment	,sur l’honneur	
évènement historique	,grand	
s’allonger	,démesurément	,considérablement	,indéfiniment	,indéfiniment	
maigre	,comme un clou	,squelettique	
affirmer	,sur l’honneur	
route	,long	
ronflements	,bruyant	,sonore	
penser	,mûrement	
fou	,à lier	
fossette	,profond	
demain	,après-demain	
rebond	,fort	,net	
réfléchir	,mûrement	
orage	,important	,beau	<gros	,violent	,furieux	<terrible	,épouvantable	,affreux	,effroyable	
se barber	,comme un rat mort	
galérer	,à mort	
obéir	,au doigt et à l’œil	
coup de fouet	,sacré	
cuisine	,sacré	
millier	,bon	
pédé	,comme un phoque	
beau	,à croquer	,à croquer	,superbe	,resplendissant	
suspense	,haletant	,gros	
joli	,à croquer	,beau	
se faire chier	,à crever	,comme un rat mort	
nase	,gros	
triste	,comme une porte de prison	,à pleurer	
insolation	,vif	
chiffre	,élevé	
incident	,accident	
bordel	,gros	,joyeux	,sacré	
mère	,notre _N à tous	,vrai	
félicitations	,chaleureux	
mal	;bien	,très	,de chien	,de chien	,de chien	
blesser	,grièvement	,gravement	,profondément	,profondément	
mélancolie	,sombre	
loup de mer	,vieux	
analogue	,exactement	,parfaitement	<équivalent	,identique	,exact	
s’ennuyer	,beaucoup	,ferme	
pluie	,abondant	,dru	,fort	,gros	,intense	<battant	,brutal	,violent	,grain	,rincée	,saucée	,sauce	<torrentiel	,diluvien	,trombe	,cataracte	,tempête	,déluge	,cordes	,abondant	
averse	,bon	,beau	<abondant	,gros	,copieux	,fort	,intense	,important	,puissant	,soutenu	<brutal	,violent	,méchant	,sacré	<énorme	,torrentiel	,déluge	
goût	,aiguisé	,développé	,boulimie	
laver	,de la tête aux pieds	
proche	,très	,très	
vaguelette	,vague	
attester	,sur l’honneur	
piano	,pianissimo	
jurer	,sur l’honneur	
>>>	A_2
Enfer	,damné	
encombrer	,encombré	
faute	,fautif	
miel	,mellifère	,mellifique	
consentement	,consenti	
amour	,amoureux	
savoir	,su	,su	
pouvoir	,sous	
déprimer	,déprimé	
agacer	,agacé	
fossette	,creusé	
haleter	,haletant	
épreuve	,éprouvé	
fracture	,fracturé	
raisonner	,raisonné	
manger	,mangé	
surveiller	,surveillé	
étouffer	,étouffé	,étouffé	,étouffé	,étouffé	
exécuter	,exécuté	
plaisir	,plaisant	
habitude	,habituel	
antenne	,à	,sur	,en ondes	
débat	,en	
finir	,final	
proche	,prochain	
entretenir	,entretenu	
poison	,empoisonné	
sinistre	,sinistré	
erreur	,erroné	
éclairer	,éclairé	
écouter	,écouté	
génération	,générateur	
miracle	,miraculé	
surmonter	,au-dessous	
chiffre	,chiffré	
atteindre	,atteint	,atteint	
parfumer	,parfumé	
dominer	,dominé	
illustrer	,illustré	
lac	,noyé	
réfléchir	,réfléchi	
pension	,pensionné	
recouvrir	,recouvert	,recouvert	
inquiéter	,inquiet	
vents	,à	
angoisse	,angoissant	
exagérer	,exagéré	,exagéré	
réduire à zéro	,réduit à zéro	
bague	,bagué	
battre	,battu	
connaissance	,connu	
profit	,profitable	
exposer	,exposé	,exposé	
composer	,composé	
serrer	,serré	
consentir	,consenti	
affect	,chargé	,rempli	
aliter	,alité	
abattre	,abattu	,abattu	,abattu	
occuper	,occupé	,occupé	,occupé	,occupé	
passionner	,passionné	
s’appauvrir	,appauvrissant	
devoir	,dû	
accusation	,visé	,en butte	
exploiter	,exploité	
barrer	,barré	
essouflant	,essouflé	
considération	,considéré	
décevoir	,déçu	
éblouir	,ébloui	
menacer	,menacé	
rassurer	,rassuré	
comprendre	,compris	,compris	,inclus	,compris	
garnir	,garni	
imputer	,imputable	
pollution	,polluant	
éducation	,éducateur	
désespérer	,désespéré	
électronique	,électronique	
exporter	,exporté	
air	,sur	
habiter	,habité	
supplément	,supplémentaire	
franc	,franc	
concerner	,concerné	
se distraire	,distrayant	
intention	,intentionnel	
prendre à la gorge	,pris à la gorge	
gauche	,gauche	
gonfler	,gonflé	
inspirer	,inspiré	,inspiré	
conservation	,conservé	
attrait	,attrayant	
creuser	,creusé	
droite	,droit	
éprouvé	,éprouvant	
brûlure	,brûlé	
couleurs	,à	,sous	
essouflé	,essouflant	
origine	,originaire	
>>>	Contr
violon	,alto	,violon alto	
voussoyer	,tutoyer	
jurisprudence	,législation	
muscles	,graisse	
musique	,bruit	,texte	,paroles	;livret	;chorégraphie	
démon	,ange	
ci	,là	
torchon	,serviette	
douceur	,acidité	
flore	,faune	
cuillère	,couteau	,fourchette	
croûte	,mie	
émigrer	,immigrer	
air	,récitatif	
minuscule	,majuscule	
démocratique	,monarchique	
quelque chose	,quelqu’un	
algèbre	,géométrie	
ancien	,actuel	
plage avant	,plage arrière	,plage arrière	
national	,international	
sud	,nord	
sujet	,objet	,objet	
analogique	,numérique	
animal	,Homme	
orient	,occident	
prochain	,actuel	
spirituel	,temporel	
vertical	,horizontal	,horizontal	
eau	,glace	;feu	
violon alto	,violon	
plafond	,sol	
ici	,là-bas	;ailleurs	,ailleurs	,loin	,là	;ailleurs	
grenier	,cave	
finale	,éliminatoire	
de large	,de long	
zapper	,s’obstiner	
pin	,sapin	
question	,réponse	
intellectuel	,manuel	
nez	,oreilles	,yeux	
coût de sortie	,coût d’entrée	
glace	,eau	;feu	
eau douce	,eau de mer	
sexe féminin	,sexe masculin	,sexe masculin	
monarchie	,démocratie	,république	,démocratie	,république	
numérique	,analogique	
s’éteindre	,brûler	
sémantique	,forme	
demoiselle	,dame	
moteur	,directeur	
tutoyer	,vouvoyer	,voussoyer	
là	;ailleurs	,ci	,ici	
salière	,poivrière	
femelle	,mâle	,mâle	
largeur	,longueur	
paternel	,maternel	
Enfer	,paradis	;purgatoire	
horizontale	,verticale	
nerf	,muscle	
Homme	,animal	
Corée du Nord	,Corée du Sud	
hiver	,été	
vidéo	,audio	
sport	,mode	
version	,thème	
queue	,tête	,tête	,tête	
titre de participation	,titre de placement	
droite	,gauche	,gauche	
chier	,pisser	
blanc	,rouge	
caca	,pipi	
minuit	,midi	
stratégique	,tactique	
longueur	,largeur	,hauteur	,profondeur	
torse	,tête	;membre	
passif	,actif	
géométrie	,algèbre	
au revoir	,bonjour	
à droite	,à gauche	
observation	,expérimentation	
hier	,aujourd’hui	,demain	,aujourd’hui	,demain	
vide	,plein	
haut sur pattes	,court sur pattes	,court sur pattes	,court sur pattes	
fesses	,seins	
lécher	,sucer	
masculin	,féminin	
esprit	,matière	,corps	
étoile	,soleil	
ville	,campagne	
voussoiement	,tutoiement	
physique	,chimie	
jambes	,bras	;tête	;corps	;tronc	,corps	;tronc	;tête	
porte	,fenêtre	
s’allonger	,se lever	,se lever	
fond	,haut	,sommet	,dessus	,forme	,surface	;plafond	,combles	,devant	,au premier plan	,surface	,apparence	,vitesse	,jour	
prédécesseur	,successeur	
métro	,R.E.R	,R.E.R	
Madame	,Monsieur	;Mademoiselle	
gaz de ville	,gaz naturel	
>>>	S_0Pred
horizontal	,horizontalité	
équivalent	,équivalence	
pertinent	,pertinence	
bizarre	,bizarrerie	
heureux	,bonheur	
malchanceux	,malchance	
tendu	,tension	
grave	,gravité	
saint	,sainteté	,sainteté	,sainteté	
féroce	,férocité	
chagrin	,chagrin	
victorieux	,victoire	
homosexuelle	,homosexualité	
bénévole	,bénévolat	
puissant	,puissance	
vif	,vivacité	,vivacité	,vivacité	
rude	,rudesse	
permanent	,permanence	
accessible	,accessibilité	
mobile	,mobilité	
incomplet	,incomplétude	
délicat	,délicatesse	
acide	,acidité	
mou	,mollesse	,mollesse	,mollesse	
charmant	,charme	
déprimé	,déprime	
distingué	,distinction	
misogyne	,misogynie	
rouge	,rougeur	,rougeur	
important	,importance	,importance	
majeure	,majorité	
traître	,trahison	
sale	,saleté	,saleté	
discret	,discrétion	
mélancolique	,mélancolie	,mélancolie	
amer	,amertume	,amertume	
dynamique	,dynamisme	
triangulaire	,triangle	
fidèle	,fidélité	
mécontent	,mécontentement	
raide	,raideur	
allotropique	,allotropes	
majeur	,majorité	,majorité	
élégant	,élégance	,élégance	
imbécile	,imbécillité	
esclave	,esclavage	
lâche	,lâcheté	
nostalgique	,nostalgie	,nostalgie	
constant	,constance	
moderne	,modernité	
égal	,égalité	
roux	,rousseur	,rousseur	
extravagante	,extravagance	
con	,connerie	
subjectif	,subjectivité	
têtu	,entêtement	
idiot	,idiotie	
grammatical	,grammaticalité	
normal	,normalité	
incompréhensible	,incompréhensibilité	
pur	,pureté	
possible	,possibilité	
bordélique	,bordel	
humble	,humilité	
subtil	,subtilité	
hétérosexuel	,hétérosexualité	,hétérosexualité	
craintif	,crainte	
maigre	,maigreur	
blanc	,blancheur	
disponible	,disponibilité	
rare	,rareté	
fluvial	,fluvialité	
indiscipliné	,indiscipline	
lent	,lenteur	
joyeux	,joie	
autonome	,autonomie	
voluptueux	,volupté	
rabat-joie	,rabat-joie	
glorieux	,gloire	
anonyme	,anonymat	
vorace	,voracité	
ridicule	,ridicule	
saleté	,sale	
juste	,justice	
clandestin	,clandestinité	
protecteur	,protection	
originel	,origine	
bienheureux	,bonheur	
fertile	,fertilité	
possessif	,possessivité	
vigoureux	,vigueur	
fantastique	,fantastique	
ancien	,ancienneté	
habile	,habileté	
énorme	,énormité	
similaire	,similarité	
ensoleillé	,ensoleillement	
débutant	,débuts	,début	
absent	,absence	
impertinent	,impertinence	
>>>	S_1^prototyp
couvent	,moine	,moniale	,religieux	,religieuse	
manger	,prédateur	;ogre	
zinzinuler	,fauvette	,mésange	
oreilles	,bonnet	;casquette	
foudroyer	,éclair	
cornes	,cervidés	,escargot	
croasser	,corbeau	,corbeau	
petit chien	,maman	
règles	,femme	
station	,lavage	
paragraphe	,texte	
mie	,pain	
roue à aubes	,bateau	;moulin	
réfléchi	,lumière	
champ magnétique	,aimant	,aimant	
émigration	,aristocratie	
poissonneux	,étang	
poulailler	,poule	,coq	
résiduel	,matière	;valeur	
lacet	,chaussures	,souliers	
sucre	,canne	,betterave	
coquille	,mollusques	,coquillage	,noix	,épée	,boxeur	
galbe	,partie du corps	;mollets	,seins	
fruitier	,arbre	
cabine	,bateau	
dévorer	,moustique	
quai	,voyageur	,voyageuse	
flocons	,céréales	
coussin	,canapé	;fauteuil	
en beauté	,femme	
pompe à fric	,escroc	
tonnerre	,applaudissements	
page	,livre	,carnet	,cahier	
voie	,voie de circulation	;route	,rue	,train	,train	
jupe	,voiture	,automobile	,voiture	,wagon	,locomotive	
abdiquer	,empereur	,souverain	,roi	,monarque	
propre	,voiture	,transports	,énergie	
angle	,appareil photo	;caméra	
bouclier	,soldat	
interpréter	,comédien	,comédienne	,acteur	,actrice	
piste	,cycliste	,cycliste	
consultation	,patient	,patiente	
baguette magique	,mage	,magicien	,magicienne	;sorcier	,sorcière	;fée	
soutif	,femme	
braguette	,pantalon	
durer	,couple	
cloche	,chapeau	
hi-han	,âne	
tomber	,neige	,pluie	
vent	,éventail	;soufflet	
pigeonnant	,poitrine	,seins	,gorge	,soutien-gorge	
cinéma	,acteur	,actrice	;comédien	,comédienne	,interprète	;interprète	,artiste	,artiste	;vedette	
carapace	,tortue	
muet	,cinéma	,film	
volée	,oiseau	
touffe	,herbe	;cheveu	
rouge	,cheveu	;pelage	
seins	,femme	
s’étirer	,chat	,chatte	
bave	,mollusques	
baguettes	,Chinois	,Chinoise	;Japonais	,Japonaise	
cadre	,lit	;tambour	;vélo	;métier à tisser	,fenêtre	,porte	,cheminée	;miroir	;toile	,tableau	,photographie	,photo	
galop	,cheval	
plage	,touriste	,touriste	;vacancier	,vacancière	;estivant	,estivante	<baigneur	,baigneuse	;bronzeur	,bronzeuse	,vacancier	,vacancière	
pare-brise	,véhicule	
kaki	,uniforme	,soldat	,soldat	
bicyclette	,cyclotouriste	,cyclotouriste	
quartier	,ville	
taper sur la tête	,soleil	;alcool	
honneur	,dieu	,Dieu	
gros dos	,chat	,chatte	
corps	,professeur	,professeure	;enseignant	,enseignante	;fonctionnaire	,fonctionnaire	;médecin	,médecin	,état	,doctrine	;théorie	,vin	;liqueur	
ciel	,ange	,saint	,sainte	;mort	,morte	
champ	,caméra	,appareil photo	,image	,tableau	,force	
fleurissant	,fleur	
addition	,barman	,barmaid	,serveur	,serveuse	
replier	,membre	,membre	
main gauche	,singe	,musicien	,musicienne	
fesses	,pantalon	
vacant	,emploi	;poste	
main	,droitier	,droitière	;gaucher	,gauchère	,singe	,carte	
bouse	,vache	
infirmerie	,infirmier	,infirmière	
baril	,pétrole	
essaimer	,abeille	
foyer	,cheminée	,cuisinière	,fourneau	,lentilles	,théâtre	,opéra	,association	,ellipse	,incendie	,orage	,chaudière	,cuisinière	,cheminée	
coffre	,voiture	
studio	,cinéma	
déplier	,membre	,membre	
discothèque	,client	,cliente	
ride	,visage	
moléculaire	,corps simple	,corps pur simple	
dossier	,banc	,canapé	,chaise	,fauteuil	,siège	
spirale	,cahier	
stéthoscope	,médecin	,médecin	
nez	,avion	;bateau	;voiture	
suspense	,histoire	;film	,roman	,enquête	,procès	,compétition	
course	,coureur	,coureuse	;coureur	,coureuse	,pilote	
clouer au lit	,maladie	
engagé	,colonne	
>>>	Redun
théorie	,scientifique	
serveur	,informatique	
duel	,grammatical	
câble	,électrique	
anniversaire	,de naissance	
alcool	,éthylique	
rencontre	,sportif	
fil	,linge	
huile	,alimentaire	
molécule	,chimique	
comme il faut	,bien	
ampoule	,électrique	
sapin	,de Noël	
somme	,argent	
pur	,chimiquement	
partenaire	,sexuel	,sexuel	
chaussette	,évacuation	
matière	,physique	
animal	,familier	
dégoût	,physique	
produit	,chimique	
pile	,électrique	
équation	,chimique	,chimique	
épreuve	,sportif	
lait	,maternel	
tomber	,par hasard	
dessous	,féminin	
Noël	,chrétien	
gare	,ferroviaire	
jumeaux	,deux	
environnement	,informatique	,logiciel	
élément	,chimique	,chimique	
retenue	,eau	
toison	,pubien	
effets	,personnel	
manteau	,terrestre	
infarctus	,myocarde	
flûte	,pain	
ticket	,entrée	
procédure	,judiciaire	
pièce	,monnaie	
serviette	,table	,hygiénique	;périodique	;sanitaire	
bouteille	,alcool	
train	,bois	
Pâque	,juif	
liaison	,chimique	,amoureux	,intime	
dépression	,nerveux	,de terrain	,atmosphérique	,barométrique	,économique	
urne	,funéraire	
États-Unis	,Amérique	
gymnastique	,intellectuel	
déchirement	,musculaire	
sujet	,syntaxique	;grammatical	
loin	,dans le temps	
genre	,grammatical	
prévision	,météorologique	
dizaine	,chapelet	,chapelet	
amour	,sexuel	;physique	,physique	
vaisseau	,sanguin	
pays d’accueil	,touristique	
fête	,religieux	
linge	,corps	
prise	,électrique	
conjoncture	,économique	
fond	,sonore	
dés	,à jouer	
régime	,politique	,mécanique	,alimentaire	,syntaxique	;grammatical	,alimentaire	
thèse	,doctorat	,doctoral	
circulation	,sanguin	
désirer	,physiquement	,sexuellement	
balayeuse	,aspirateur	
course	,hippique	,cheval	
marche	,athlétique	,au pas	,à pied	,électoral	
réactivité	,chimique	
fibre	,alimentaire	
escompte	,règlement	
tapette	,mouche	
tableau	,blanc	;noir	
traduire	,justice	
préparation	,alimentaire	,culinaire	
poitrine	,féminin	
terrorisme	,intellectuel	
marcher	,au pas	
triangle	,pubien	,signalisation	
voie	,ferré	
blague	,tabac	
chevaux	,fiscal	
précipitation	,atmosphérique	
boxe	,anglais	
droite	,politique	
réunion	,sportif	
toilette	,funèbre	,funéraire	,mortuaire	;dernier	,ultime	
diversité	,ethnique	
étreinte	,sexuel	
champ	,visuel	,vision	,tir	
forme	,linguistique	
chèque	,bancaire	
position	,sexuel	
congrégation	,religieux	
manifestation	,sportif	
plage	,horaire	
>>>	AntiBon
boisson alcoolisée	,bibine	;pipi de chat	
repas	,immangeable	,indigeste	;gras	
banlieue	,zone	
couteau	,mauvais	
film	,navet	
pluie	,dévastateur	,dévastateur	
vêtement	,usé	;fripé	,râpé	
rêve	,mauvais	<horrible	;cauchemar	
serviette	,humide	<mouillé	;sale	
manteau	,élimé	,râpé	,usé	
restaurant	,gargote	
effet	,méfait	
aller	,mal	
jambes	,faible	,mauvais	,faible	,mauvais	
divorce	,pour faute	;aux torts exclusifs	;par assignation	;aux torts partagés	
bateau	,mauvais	,rafiot	
pull	,troué	,usé	
dormir	,à la dure	,mal	,insuffisamment	
vin	,âpre	,gâté	,mauvais	,piqué	,piquette	,vinasse	
toilette	,négligé	
bicyclette	,clou	
jour	,sans	
gueule	,de _N de long	
rouge	,gros	;qui tache	
air	;lourd	;pollué	,vicié	
politicienne	,politicarde	
politicien	,politicard	
corps	,difforme	
écriture	,pattes de mouche	
théatre	,de boulevard	
alcool	,bibine	
vent	,âpre	;mauvais	
sens	,contresens	,mauvais	
nappe	,sale	,taché	,contaminé	;pollué	
recevoir	,comme un chien dans un jeu de quilles	
théâtre	,de boulevard	
nager	,mal	
couple	,malheureux	
mouchoir	,sale	
homme politique	,politicard	
environnement	,hostile	
chien	,indiscipliné	;agressif	,hargneux	,teigneux	<enragé	
assiette	,cassé	,ébréché	,fêlé	
chanter	,comme une casserole	
élève	,mauvais	,cancre	,mauvais	,cancre	
finir	,bâcler	
négocier	,chipoter	
réponse	,Normand	
écrire	,gribouiller	
parler	,baragouiner	,comme une vache espagnole	,baragouiner	
tête	,de _N de long	
formes	,disgracieux	
avocat	,mauvais	<piètre	;avocaillon	
thèse	,mauvais	<médiocre	
dessin	,gribouillage	
chiffre	,mauvais	
lac	,sombre	,impur	,boueux	,fangeux	;noir	,opaque	;houleux	
personnel	,incompétent	,incompétent	
s’entendre	,comme chien et chat	
se lever	,se lever du pied gauche	
écrit	,gribouillage	
colline	,abrupt	
nuage	,lourd	,menaçant	,lourd	,menaçant	
assis	,mal	
mélange	,mariage de la carpe et du lapin	
médecin	,mauvais	;médicastre	,mauvais	;médicastre	
lit	,grabat	
sujet	,chiffon rouge	
avocate	,mauvais	<piètre	;avocaillonne	
politique	,mauvais	<catastrophique	,désastreux	,politicard	
femme politique	,politicarde	
triangle	,infernal	
écrivain	,gribouilleur	;pisseur de copie	
journaliste	,mauvais	,folliculaire	,journaleux	,plumitif	;pisse-copie	,pisseur de copie	,mauvais	,folliculaire	,journaleuse	;pisse-copie	,pisseuse de copie	
courriel	,frauduleux	,hameçonnage	,spam	,pourriel	
linge	,froissé	,souillé	
passager	,clandestin	
violon	,crin-crin	
langue	,jargon	
prendre	,mal	
relation	,toxique	
sommeil	,agité	,détraqué	,mauvais	,perturbé	,troublé	
vêtements	,usé	;fripé	,râpé	;fripes	,guenilles	,loques	
rapport	,toxique	
gosse	,sale	;chiard	,sale	
installé	,mal	
bouche	,pâteux	
manger	,mal	,gras	
fond	,bas-fond	,vieux	,mauvais	,méchant	
crier	,braire	,braire	
chaussettes	,troué	;usé	
forme	,petit	<mauvais	,petit	,mauvais	
temps	,mauvais	<de chien	
prêcher	,prêcher un converti	
vélo	,clou	
odeur	,irrespirable	
tapis	,élimé	,râpé	,pelé	
atmosphère	,vicié	
marcher	,mal	;au ralenti	
chaussures	,usé	;éculé	
>>>	Mero
aspirateur	,brosse	,suceur	;tuyau	;sac	;fil	
métro	,rame	,métro	;métro	,station	,quai	;voie	
sms	,sms	
cours d’eau	,eau	
rayon	,alvéole	
flocons	,cristal	
chicorée	,chicorée	
poitrine	,seins	;sternum	,lard	
omelette	,œuf	
lavande	,lavande	
glaçon	,glace	,glace	
pomme de terre	,pomme de terre	
banc	,dossier	,siège	
cheval	,crinière	
W.-C.	,siège	,trône	,cuvette	,lunette	,abattant	,couvercle	
corps	;atome	,élément	,molécule	
verglas	,glace	;eau	
zigzag	,tournant	,virage	
escargot	,coquille	;antennes	,cornes	
pieds	,plante	
chemin de fer	,rails	,train	,chemin de fer	
tortue	,bec	;carapace	
voie ferrée	,rails	
museau	,truffe	,museau	
toilette	,miroir	,table	
gamme	,do	,sol	
haricot	,haricot	,haricot	
viorne	,cheveu-de-la-Vierge	
ongles	,kératine	
mamelles	,tétons	
volcan	,cheminée	;caldera	;flanc	,versant	;cratère	
iceberg	,glace	
navire	,coque	,pont	,cale	,hublot	,soute	;proue	,étrave	;poupe	,étambot	
gueule	,museau	
R.E.R	,R.E.R	
bride	,sous-gorge	
courriel	,en-tête	,signature	,pièce jointe	,adresse électronique	
noyau	,nucléon	,proton	,neutron	
rue	,chaussée	,voie	;trottoir	
églantier	,églantine	
éléphant	,trompe	
brosse	,dos	;poil	,fibre	;manche	,poil	,fibre	;manche	,poil	,fibre	
cheminée	,foyer	
fauteuil	,accoudoir	,bras	,coussin	,dossier	,oreilles	,patte	,pied	,siège	
graine de lin	,lin	
soutien-gorge	,bonnet	
glace	,eau	,sucre	,sucre glace	
guacamole	,avocat	
mère	,bactérie	
nuage	,vapeur	
tétons	,tétons	
fleuve	,méandres	;amont	,aval	;embouchure	;estuaire	,delta	;bouche	;berge	,bord	,rive	
air	,oxygène	
glaviot	,salive	
voiture	,moteur	,réservoir	;coffre	;volant	,tableau de bord	,pédale	;siège	,ceinture	;roue	,train	;habitacle	,compartiment	;siège	,couchette	,brancard	,essieu	,roue	,marchepied	
vinaigrette	,vinaigre	,huile	
moto	,guidon	;moteur	;réservoir	;roue	;side-car	
cube de glace	,glace	
école	,école	,école	
graine de lupin	,lupin	
course	,galop	,trot	
boule de neige	,neige	
gorge	,gosier	,gorge	,pipe	
ciel	,septième ciel	
mot	,lettre	
forêt	,sous-bois	
route	,chaussée	,voie	;bord	;revêtement	
lentilles	,foyer	
désert	,sable	,dune	,pierre	,roche	
lupins	,lupin	
nez	,bout	;dos	;lobe	;narines	,trou de nez	;racine	;os	;aile	
tortue de mer	,bec	;carapace	;nageoire	
muscle	,fibre	;tissu	
substance	,particule	
cou	,gorge	,gorge	
terrier	,entrée	,gueule	,ouverture	,trou	;couloir	;cavité	
lac	,bord	,rive	
trottoir	,bateau	
table	,plateau	,pied	;bord	,bout	,centre	,milieu	,coin	
patate	,patate	
tomate	,tomate cerise	,cœur de bœuf	
gentiane	,gentiane	
soupe au lait	,lait	
thorax	,sternum	;côte	
boulevard	,voie	,chaussée	;trottoir	
colline	,bas	,pied	;flanc	,versant	;haut	<sommet	
chemise	,col	;manche	
Corée	,Corée du Nord	,Corée du Sud	
avenue	,chaussée	,voie	;trottoir	
couronne	,branche	,feuille	
canapé	,accoudoir	,coussin	,dossier	
balai	,manche	,pommeau	
piano	,clavier	
bonhomme de neige	,neige	
rame	,voiture	
gymnastique	,pompe	
mélodie	,mélodie	
fleur	,pétales	,fleur	
chaise	,dossier	,patte	,siège	
trottinette	,roue	;guidon	,roue	;guidon	
>>>	Fact_0
lunette	,grossir	
montgolfière	,s’élever	;voler	
hélicoptère	,voler	
corbeau	,voler	,voler	
travailleur	,travailler	
dormeur	,dormir	,dormir	
coureuse	,courir	
chien	,percuter	
avocat	,exercer	
bateau	,naviguer	
soleil	,briller	,luire	
cigare	,se consumer	
marche	,retentir	,sonner	
dormeuse	,dormir	,dormir	
transporteur	,transporter	
rêveuse	,rêver	
médecin	,exercer	;consulter	,exercer	;consulter	
numéro	,sortir	,sortir	,paraître	
rêveur	,rêver	
tricycle	,rouler	,circuler	
collaborateur	,collaborer	
bouilloire	,chauffer	
aspirateur	,aspirer	
muscle	,agir	;se contracter	
tramway	,circuler	,se déplacer	,rouler	;fonctionner	,marcher	
couple	,embrasser	;enlacer	
prévision	,se réaliser	
antenne	,capter	,recevoir	;émettre	
mouche	,voler	,voleter	,voltiger	
travailleuse	,travailler	
avion	,voler	
draisienne	,rouler	,circuler	,rouler	
cycliste	,pédaler	,pédaler	
père	,officier	
coureur	,courir	
crocodile	,marcher	;nager	;ramper	
écureuil	,grimper	,sauter	,conserver	,garder	;économiser	
lac	,se déverser	,stagner	;se répandre	,se déverser	,s’étaler	,s’écouler	,se décharger	
collabo	,collaborer	,collaborer	
boulangère	,boulanger	
lessive	,sécher	
balai	;balayer	
guêpe	,voler	
rideau	,cacher	,masquer	,occulter	,séparer	,diviser	;cacher	,masquer	
bus	,rouler	;circuler	
chimie	,opérer	,opérer	
véhicule volant	,voler	
volcan	,exploser	,exploser	
roue	,tourner	,tourner	
bicyclette	,rouler	,circuler	
balayeuse	,balayer	
voiture	,rouler	;avancer	,circuler	;se déplacer	,rouler	
oreilles	,entendre	
alcoolique	,boire	,boire	
coup	,retentir	
tombeau	,contenir	,renfermer	,receler	
sorcier	,envoûter	
bronzeur	,bronzer	
casserole	,chauffer	
métro	,circuler	,rouler	,fonctionner	,marcher	
car	,rouler	
placard	,annoncer	<clamer	
chant	,retentir	,retentir	,retentir	
tombe	,contenir	,renfermer	;receler	
réactif	,réagir	
collaboratrice	,collaborer	
véhicule	,rouler	,se déplacer	;avancer	,circuler	,se déplacer	
vélo	,rouler	;circuler	
pâte	,cuire	
musicien	,jouer	
fleuve	<couler	
autocar	,rouler	
aéronef	,voler	
campeur	,camper	
campeuse	,camper	
prédiction	,se réaliser	
parturiente	,accoucher	
cercueil	,contenir	,renfermer	,receler	
skis	,glisser	
cigarette	,se consumer	
pompier	,intervenir	,intervenir	
train	,rouler	,circuler	,avancer	,se déplacer	
oiseau	,voler	
plage	,se dérouler	,jouer	
flocons	,tomber	;voler	;neiger	
cheveux	,pousser	
figure	,indiquer	,illustrer	,représenter	
musicienne	,jouer	
archéologue	,fouiller	
navire	,naviguer	
moustique	,voler	
nageur	,nager	
magie	,opérer	
avocate	,exercer	
camionnette	,circuler	,rouler	
courriel	,fonctionner	,marcher	
boulanger	,boulanger	
cheval	,marcher	;trotter	;galoper	
fond	,remonter	,remonter	
cœur	,battre	
>>>	Gener
enseignement	,secteur	
maladie de la vache folle	,maladie	
incisive	,dent	;dent	
liste rouge	,liste	
sous-préfecture	,administration	
chiffons	,vêtements	
arbre de Noël	,fête	;réception	
chauffeur	,professionnel	,profession	
rouge-queue	,oiseau	,oiseaux	;passereaux	
poignard	,arme blanche	
chou	,légume	,plante	,pâtisserie	
république	,régime	
mélancolique	,malade	,malade	
bouchon doseur	,bouchon	
charme	,arbre	
chouette	,oiseau	,oiseaux	
communisme	,régime	
figuier	,arbre	
tempête	,phénomène atmosphérique	,phénomène atmosphérique	
fer	,métal	
carapace	,partie du corps	
velours	,tissu	
coût moyen unitaire pondéré	,méthode de calcul	
clématite	,plante	;fleur	
coude	,partie du corps	
achat	,transaction	
chaussons	,pièce d’habillement	,pièce d’habillement	
football canadien	,sport	
edelweiss	,plante	;fleur	
élément	,corps pur	
doigt	,partie du corps	,partie du corps	,partie du corps	,partie du corps	
hi-han	,cri	
doctorat	,diplôme	
neutron	,particule subatomique	,nucléon	
volcan rouge	,volcan	
azalée	,plante	;fleur	
banc de jardin	,siège	,banc	
zéphyr	,vent	
dimanche	,jour	
Paris	,ville	
chat-huant	,oiseau	,oiseaux	
gaz	,substance	,combustible	
poupée	,jouet	
cigarettier	,professionnel	;profession	
Wimbledon	,quartier	,tournoi	
huppe	,oiseau	,oiseaux	
merlan	,animal	
joues	,partie du corps	,partie du corps	
paroles	,texte	
s’ioniser	,se transformer	
Hollande	,pays	
frousse	;sentiment	;émotion	;affect	
tornade	,phénomène atmosphérique	;sinistre	
grive	,oiseau	,oiseaux	;passereaux	
olivier	,arbre	
F10	,habitation	,logement	
métropole	,ville	
oiseau-mouche	,oiseau	,oiseaux	
multiplication	,opération	
pivoine	,fleur	;plante	
proverbe	,énoncé	
addition	,opération	
mayo	,sauce	
mille-feuille	,pâtisserie	,gâteau	
meringue	,biscuit	
hiver	,saison	
pain polaire	,pain	
course contre la montre	,compétition	;épreuve	;évènement sportif	
rhume	,maladie	
badinage	,échange verbal	
batracien	,animal	
bock	,boisson	;boisson alcoolisée	
valeur mobilière	,titre	
demi-pièce	,boisson	;boisson alcoolisée	
mail	,message	,coordonnées	,voie	
vache	,animal	,animal d’élevage	;bovin	;ongulés	,viande	
développé couché	,exercice	
causette	,échange verbal	
brioche	,viennoiserie	
cheval d’arçons	,agrès	
lunaire	,plante	;fleur	
avril	,mois	
bassin	,récipient	
bouche	,partie du corps	,partie du corps	,partie du corps	
bilan pré-implantation	,bilan	
huit-pièces	,habitation	,logement	
asphodèle	,fleur	;plante	
discussion	,échange verbal	
cyclistes	,chaussures	
jeu	,ensemble	
assassinat	,méfait	,crime	
clé	,outil	
sac	,contenant	
tigresse	,fauves	
carotte	,légume	,plante	
vendredi	,jour	
avant	,localisé	
boulangère	,métier	,profession	,marchande	
escargot de Bourgogne	,animal	;gastéropodes	,mollusques	
orgueil	,sentiment	
>>>	S_loc
ski	,piste	;station	
gendarme	,gendarmerie	
orpheline	,orphelinat	
tennis	,court	,terrain	,tennis	
cerise	,cerisier	
datte	,dattier	,palmier dattier	
réaction	,réacteur	,réacteur	,réacteur	
soucoupe	,soucoupe	
figure	,dans	,en plein	
parfum	,flacon	
tasse	,tasse	
gymnastique	,salle	;gymnase	,salle	;gymnase	
cernes	,yeux	;visage	
courriel	,adresse électronique	;boîte aux lettres	
main gauche	,gauche	,gauche	
chair de poule	,peau	
douche	;douche	,salle de douche	,salle de bain	,salle de douche	,salle de bain	,salle d’eau	,cabinet de toilette	
raisin	,vigne	
coiffeuse	,salon	
promenade	,prison	
boulangère	,fournil	
couché	,lit	
insecte	,insectarium	
eau de mer	,mer	,océan	
articuler	,articulation	
fleuve	<lit	
sport	,salle	;terrain	;palais des sports	
vélo	,vélodrome	
prune	,prunier	
figue de Barbarie	,figuier de Barbarie	
moustique	,marais	,mare	,marécage	
eau	,cours d’eau	;étendue d’eau	
clémentine	,clémentinier	
course	,champ de course	,hippodrome	
noix de coco	,cocotier	
curé	,cure	;paroisse	
banane	,bananier	
poire	,poirier	
main droite	,droite	,droite	
amande	,amandier	
thé	,théier	
encre	,encrier	
voie	,gare	
repas	,coin-repas	,salle à manger	;cantine	;restaurant	
noix	,noyer	
Lune	,Système solaire	
valises	,yeux	;visage	
corail	,mer	;récif corallien	
lait	,seins	
réunion	,salle de réunion	
Allemagne	,en	
fraise	,fraisier	
mère	,couvent	
voter	,bureau de vote	
vache	,étable	,vacherie	
noisette	,noisetier	
entrer	,entrée	,entrée	
presse	,presses	;imprimerie	
ver de terre	,terre	
assiette	,assiette	
cigarette	,bureau de tabac	,tabac	,débit de tabac	
maladie	,siège	
réagir	,réacteur	,réacteur	,réacteur	
faire de l’essence	,station-service	
eau douce	,cours d’eau	;étang	,lac	
pompier	,caserne	,caserne	
bœuf	,étable	,bouverie	
à l’eau	,eau	,eau	
lointain	,lointain	
environnement	,Terre	
vote	,urne	
traboule	,Lyon	
bandit	,repaire	
vaisselle	,vaisselier	
tortue marine	,mer	,océan	;eau de mer	
abricot	,abricotier	
cheval	,écurie	;box	,stalle	;haras	
garagiste	,garage	,garage	
tabac	,plantation	,champ	,bureau de tabac	,débit de tabac	,tabac	
Occidental	,ouest	
chaussures	,boîte	;meuble	
olive	,olivier	
coton	,cotonnier	
aboutir	,aboutissement	
volley-ball	,terrain	
tortue de mer	,mer	,océan	;eau de mer	
algue	,mer	,mer	;étendue d’eau	
figue	,figuier	
tombe	,cimetière	
sandwich	,sandwicherie	
corbeau	,nid	,nid	
étalage	,étal	
papilles	,langue	
lapin	,terrier	
valoches	,yeux	;visage	
villageois	,village	
framboise	,framboisier	
crime	,lieu	,scène	
dormir	,dortoir	
abeille	,nid	,ruche	
>>>	Oper_1
maladie	,avoir	,souffrir	,avoir	,avoir	,avoir	,avoir	
demande	,faire	
aversion	,avoir	,éprouver	,ressentir	
vent	,avoir	,faire	,lâcher	,mettre	
horreur	,éprouver	,ressentir	,avoir	,éprouver	,ressentir	
tennis	,faire	;jouer	,faire	,se faire	
cinéma	,faire	
couleur	,avoir	,faire	
ouf	,pousser	
spectacle	,donner	
atomes crochus	,avoir	
sport	,faire	
taureau	,être	
difficulté	,avoir	,éprouver	
froid dans le dos	,avoir	
judo	,faire	
tableau	,dresser	
coup de collier	,donner	
dentition	,faire	
prévision	,faire	
déception	,avoir	,éprouver	,ressentir	
don	,faire	
fellation	,faire	
tête près du bonnet	,avoir	
bilan	,effectuer	,pratiquer	,réaliser	,établir	<compléter	
voiture	,faire	
distinction	,avoir	
bagarreuse	,se bagarrer	
récital	,donner	
coup de pied dans la fourmilière	,donner	
petit vélo dans la tête	,avoir	
téléphone	,avoir	,avoir	
rhumatisme	,avoir	,souffrir	
promesse	,faire	,faire	
a priori	,avoir	;nourrir	
auto-stop	,faire	
veste	,prendre	,se prendre	,ramasser	,se ramasser	;essuyer	,subir	,prendre	,se prendre	,ramasser	;se ramasser	,se manger	
rêve	,faire	,avoir	,faire	
le pied au plancher	,avoir	
gymnastique	,faire	,faire	,faire	,se faire	
question	,poser	
tandem	,faire	
gratitude	,avoir	,éprouver	,ressentir	
chat dans la gorge	,avoir	
allégresse	,éprouver	,ressentir	
pouvoir	,avoir	,exercer	,posséder	,tenir	
coup	,donner	,faire	,jouer	,faire	
répulsion	,avoir	,éprouver	,ressentir	
satisfaction	,avoir	,éprouver	,ressentir	;goûter	
blague	,dire	,faire	,faire	
visite médicale	,avoir	,effectuer	,passer	,se soumettre	,subir	
quarantaine	,faire	,suivre	,être	
nuage	,flotter	,voler	
colle	,poser	
promenade	,faire	,faire	
tête	,occuper	,être	,figurer	
risque	,courir	
sieste	,faire	
train	,former	,mener	
foot	,foot	
analogie	,faire	,tracer	,établir	,présenter	,partager	,posséder	
pipe	,faire	,tailler	
père	,être	,être	
saut	,faire	
frayeur	,avoir	,éprouver	,ressentir	
attentat	,commettre	,perpétrer	
règles	,avoir	
doigt d’honneur	,faire	
émoi	,avoir	,éprouver	,ressentir	
compliment	,présenter	
les jambes mortes	,avoir	
coup de frein	,donner	
bon pied bon œil	,avoir	
orgueil	,avoir	,éprouver	,ressentir	
mère	,être	,être	,être	
cor	,jouer	
pâte	,faire	
badminton	,faire	;jouer	,faire	,se faire	
frustration	,avoir	,éprouver	,ressentir	
vélo d’appartement	,faire	
mal au cœur	,avoir	,avoir	
éclair	,cracher	,jeter	,lancer	,projeter	,lancer	,jeter	
coup dans le nez	,avoir	
insulte	,adresser	,proférer	
excuses	,présenter	
rapport	,établir	,faire	
angine de poitrine	,avoir	,souffrir	
cauchemar	,faire	
oreilles	,être	
bâtons dans les roues	,mettre	,jeter	,foutre	
fourmis dans les jambes	,avoir	
cause	,être	
longueur	,faire	
jugement	,porter	
VTT	,faire	
préjugé	,avoir	;nourrir	
ictère	,avoir	,souffrir	
service	,rendre	
numéro	,exécuter	,faire	
mécontentement	,avoir	,éprouver	,ressentir	
>>>	Cf
chiffre	,lettre	
imprimante	,presse	;scanneur	
mélange	,corps pur	
kilo	,gramme	,tonne	
bourgeon	,bouton	
sol	,do	,ré	,mi	,fa	,la	,si	
sien	,mien	
anniversaire	,fête	
recoucher	,coucher	
grammatical	,syntaxique	
perspective	,relief	
mollets	,chevilles	
si	,do	,ré	,mi	,fa	,sol	,la	
lavande	,thym	
testicule	,partie	
étrangeté	,anomalie	
planche à pain	,poitrine	
minute	,seconde	
frère	,sœur	
changement physique	,changement chimique	
septième	,sept	
longueur	,mesure	;point	
TER	,T.G.V.	
imam	,prêtre	,pasteur	,pope	
hélice	,aube	
plume	,stylo	
renardeau	,renard	,renarde	
thym	,lavande	
alligator	,crocodile	
amour	,Vénus	
carapace	,coquille	
nappe	,serviette	
barbouze	,barbe	
harnais	,selle	
coquillage	,crustacés	
tiédeur	,fraîcheur	;chaleur	
direction	,destination	
chaise	,fauteuil	
doigts	,aube	
capitalisme	,communisme	
soucoupe	,assiette	
futur	,passé	
presse	,imprimante	
billet	,argent	
pasteur	,prêtre	,imam	
Pâques	,Pâque	
flûte	,baguette	
nœud papillon	,cravate	
chevilles	,pieds	;mollets	
serpillière	,éponge	
couché	,assis	,endormi	,assis	,assis	
drap	,couverture	
poursuite	,procès	
rat	,souris	
déshydraté	,assoiffé	
sourire	,rire	,rire	
héréditaire	,génétique	
houle	,vague	
miel	,gelée royale	
corporel	,corps	
auriculaire	,cœur	
tonnerre	,foudre	;orage	
L’abus d’alcool est dangereux pour la santé.	,À consommer avec modération	
cheval	,poney	
boire	,manger	
gorge	,ventre	
pneumonie	,bronchite	
figue	,datte	
explosif	,bombe	
tigresse	,furie	
chipoteuse	,avare	
droite	,segment	
pompe	,distributeur	
sec	,déshydraté	
quotient	,division	
annuel	,mensuel	,trimestriel	
quater	,ter	
gavial	,crocodile	
majorité	,unanimité	
bronchite	,pneumonie	
paume	,tennis	,paume	
ingambe	,jambes	
lune	,mois	
étroitement	,inconfortablement	
salade	,crudités	
étroit	,inconfortable	
changement chimique	,changement physique	
peigne	,barrette	
quelque part	,quelque chose	,quelqu’un	
coin-repas	,salle à manger	
signature	,paraphe	,signature	
avocate	,juriste	
œuf	,poule	
obstacle	,barrière	
passé	,futur	
marguerite	,pâquerette	
mobylette	,moto	,vélo	
réactif	,réactif	,réactif	,réactant	
givre	,neige	
patins	,chaussons	
>>>	Sing
outillage	,outil	
Voie lactée	,étoile	;corps céleste	,astre	
vinaigre	,bouteille	
jambon	,tranche	
savon	;bloc	,bout	,copeau	,cube	,goutte	,morceau	,paillette	,pain	,savon	;bouteille	,flacon	
rock	,rock	
laser	,rayon	
tissu	,cellule	;fibre	
dentifrice	,flacon	,tube	,dentifrice	
armement	,arme	
ski	,championnat	,compétition	
bol	,coup	
vent	,brin	<souffle	,bouffée	;courant d’air	
humanité	,homme	
cheval	,compétition	
ennemi	,ennemi	
lentilles	,boîte	,paquet	
bière	,bouteille	,canette	,verre	,bière	,bock	,canette	,chope	,demi	<pinte	<pack	
cours	,séance	,cours	
cornichon	,rondelle	,tranche	
égouts	,égout	
guerre	,bataille	
boxe	<combat	,match	<compétition	,tournoi	<championnat	
judo	,combat	<compétition	,tournoi	<championnat	
sauciflard	,rondelle	
huile	,bouteille	
musique	,morceau	,pièce	
glace	,cristal	;glaçon	;bloc	,boule	,pain	;glaçon	;cube de glace	
industrie	,industrie	
couettes	,cheveu	
escalier	,marche	
ping-pong	,match	,partie	,ping-pong	;rencontre	<compétition	,tournoi	
tramway	,ligne	
beurre	,noisette	,noix	;motte	
opéra	,air	
jogging	,jogging	
denture	,dent	
rabbinat	,rabbin	
magistrature	,magistrat	,magistrate	
averse	,goutte	
alphabet	,lettre	
mois	,semaine	,semaine	<jour	
vin	,verre	<bouteille	
gendarmerie	,gendarme	,gendarme	,gendarmette	
correspondance	,lettre	
terminologie	,terme	
feu	,coup de feu	
titulature	,titre	
graine de lin	,graine	
champagne	,coupe	,flûte	,verre	,champagne	<bouteille	
sable	,grain	
années	,année	
riz	,grain	<paquet	
racaille	,racaille	
conflit	,bataille	
voirie	,voie	
cresson	,botte	
aviation	,avion	
air	,souffle	
chéquier	,chèque	
tabac	,pied	,paquet	,pot	
maïs	,grain	<boîte	
corolle	,pétales	
appareillage	,appareil	
or	,pépite	
muguet	,brin	
frites	,cornet	,barquette	
tarte	,part	
mobiler	,meuble	
neige	,flocons	;cristal	;boule	,boule de neige	
gâteau	,part	,tranche	
parc	,arbre	;pelouse	;allée	
dentition	,dent	
terre	,motte	
billard	,jeu	,partie	
lessive	,cuillère	,dose	,poignée	;dosette	,pastille	<baril	,bidon	,boîte	,bouteille	,carton	,flacon	,paquet	
pharmacopée	,médicament	
yaourt	,pot	,yaourt	<boîte	,pack	,paquet	
membrure	,membre	
branchage	,branche	
pain	,miette	<bout	,morceau	,tranche	
karaté	,combat	<compétition	,tournoi	<championnat	
ligne de titres	,titre	
colère	,bouffée	
chemin de fer	,ligne	
terrorisme	,acte	
soupe	,assiette	,assiettée	;bol	
bouteille	,verre	
législation	,loi	
pain d’épices	,tranche	,morceau	
nouilles	,paquet	
semaine	,jour	
basket	,match	,partie	,basket	;rencontre	<compétition	,tournoi	<championnat	
rugby	,match	,partie	,rugby	;rencontre	<compétition	,tournoi	<championnat	
marche	,marche	
courrier	,courrier	
escalade	,escalade	
matraquage	,coup de matraque	
miel	,pot	
concombre	,rondelle	,tranche	
>>>	Mult
raisin	,raisin	
vents	,orchestre	,ensemble	
saleté	,saleté	
mouton	,troupeau	,cheptel	
cheveu	,chevelure	,cheveux	,cheveu	
gendarme	,gendarmerie	
client	,clientèle	
symptôme	,syndrome	
faux ami	,lexique	,vocabulaire	
dizaine	,chapelet	,chapelet	
banane	,régime	
part	,capital	
bœuf	,cheptel	;troupeau	;bétail	
clé	,trousseau	,jeu	
entité chimique	,espèce chimique	
musicien	,ensemble	,groupe	,troupe	,orchestre	
abeille	,colonie	,essaim	;horde	,nuage	,nuée	
lettre	,alphabet	,correspondance	
poisson	,banc	
punaise	,colonie	
jour	,semaine	,semaine	<mois	,mois	
ciseaux	,paire	
terme	,terminologie	
paysanne	,paysannat	,paysannerie	
Chleuh	,peuple	
navire	,flotte	,flottille	
injure	,chapelet	
bête à bon Dieu	,nuage	
marche	,escalier	,marches	
lectrice	,lectorat	
touche	,clavier	
ennemi	,ennemi	
saucisse	,chapelet	
ami	,réseau	
coccinelle	,nuage	
corbeau	,bande	,colonie	;nuée	,bande	,colonie	;nuée	
loup	,bande	,horde	,meute	
employée	,personnel	
ministre	,gouvernement	,ministère	,cabinet	
chien	,horde	,meute	
cerise	,poignée	
coup de feu	,feu	
rabbin	,rabbinat	
pétales	,corolle	
fibre	,tissu	
batracien	,batraciens	
carte	,jeu	,paquet	
voyou	,bande	,gang	,horde	
bruyère	,tapis	
chaise	,rangée	
chaussures	,paire	
muscle	,musculature	
sous-vêtement	,sous-vêtement	
comprimé	,boîte	,flacon	;tube	;plaquette	
membre	,membrure	,groupe	
éléphant	,troupeau	
fiche	,fichier	
patron	,patronat	
oignon	,botte	;filet	
sardine	,banc	
pièce de vaisselle	,vaisselle	
skis	,paire	
seins	,poitrine	;paire	
industrie	,industrie	
datte	,grappe	,régime	
meuble	,mobiler	
homme	,humanité	
jumelle	,jumelles	
fauteuil	,rangée	
poireau	,botte	
grappe	,raisin	
diamant	,rivière	
crin	,crinière	
muguet	,tapis	
année	,années	
lecteur	,lectorat	
radis	,botte	
cigare	,boîte	
racaille	,racaille	
vache	,troupeau	;cheptel	
égout	,égouts	
os	,ossature	,squelette	
moustique	,essaim	;horde	,nuage	,nuée	
élément	,ensemble	
mouche	,nuage	,nuée	
cliente	,clientèle	
végétal	,flore	,végétation	
chiffon	,tas	
enveloppe	,paquet	
loi	,code	
avion	;flotte	
volcan	,chaîne	
dessous	,dessous	
dent	,dentition	,denture	,dentelure	
bouton	,plaque	
jumeau	,jumeaux	
oiseau	,volée	
appareil	,appareillage	
chaussons	,paire	,paire	
cours	,cours	
>>>	Hypo
signe	,poissons	,taureau	
flûte	,flûte de Pan	,flûte traversière	,flûte à bec	
instrument à percussion	,tambour	
mot	,gros mot	,mot magique	
félins	,chat	
mois	,janvier	,février	,mars	,avril	,mai	,juin	,juillet	,août	,septembre	,octobre	,novembre	,décembre	
film	,documentaire	;court métrage	,moyen métrage	,long métrage	
épreuve	,bac	
pierre précieuse	,diamant	,émeraude	,rubis	,saphir	,diamant	
véhicule	,automobile	,auto	,voiture	;autocar	,car	,autobus	,bus	;camion	,poids lourd	;camionnette	,fourgonnette	
sacrement	,baptême	
jour	,lundi	,mardi	,mercredi	,jeudi	,vendredi	,samedi	,dimanche	
musique	,musique classique	,musique classique	
désert	,erg	,reg	
savon	,savon de Marseille	,savon d’Alep	,savon blanc	,savon noir	
geste	,doigt d’honneur	
handicap	,patte folle	
localité	,ville	,village	
drogue	,herbe	
phénomène atmosphérique	,nuage	,orage	,pluie	,tempête	,tempête	,tornade	,vent	
coordonnées	,mail	
crotte	,fiente	,crottin	
moyen de transport	,véhicule flottant	;véhicule roulant	;véhicule volant	
vents	,bois	,cuivres	
crime	,crime	;cambriolage	,vol	;délit	,forfait	;kidnapping	,enlèvement	,rapt	;viol	;fraude	
marsupial	,kangourou	
voiture	,voiture-bar	,voiture-restaurant	,wagon-restaurant	;voiture-couchettes	,wagon-couchettes	;voiture-lits	,wagon-lits	
appendice	,antennes	
saison	,printemps	,été	,automne	,hiver	
cuir	,agneau	,veau	
date	,treize	;trente	
fonds commun de placement	,fonds commun de placement à risque	
émonctoire	,narines	
dent	,canine	;incisive	;molaire	;prémolaire	,canine	;incisive	;molaire	;prémolaire	
respiration	,petit chien	
cinéma	;parlant	,sonore	,muet	;en 2 dimensions	,en 2D	,en 3 dimensions	,en 3D	,relief	;noir et blanc	,couleur	
pierre fine	,grenat	
porte	,porte à tambour	
orchestre	,fanfare	,harmonie	
régime réel	,régime réel normal	,régime réel simplifié	
niveau d’articulation	,première articulation	,deuxième articulation	,troisième articulation	
bilan	;bilan instrumental	,bilan standardisé	;bilan écologique	;bilan de renouvellement	;bilan d’investigation	,bilan de contrôle	;bilan pré-opératoire	,bilan post-opératoire	;bilan pré-implantation	
obstacle	,haie	,rivière	
volcan	,volcan gris	,volcan rouge	;guyot	
pompe	,pompe	,pompe	
matière	,matière ordinaire	,matière noire	,antimatière	
articulation	,articulation temporo-mandibulaire	;articulation crico-aryténoïdienne	,première articulation	,deuxième articulation	,troisième articulation	
engin de navigation	,bateau	
exclamation	,misère	
fonction	,dérivée	
champignon	,cèpe	
canapé	,canapé-lit	,clic-clac	,convertible	
champ	,objet	
doigt	,auriculaire	,pouce	
douche	,cabine	
guitare	,guitare sèche	;guitare électrique	
maquillage	,rouge à lèvres	
siège	;banc	;canapé	;chaise	;fauteuil	;tabouret	
diplôme	,doctorat	
véhicule roulant	;autobus	,motocyclette	,deux-roues	,moto	,bicyclette	,voiture	,automobile	;auto	,véhicule	,vélo	,bus	,autocar	;car	,train	,tramway	;voiture	,wagon	
dimension	,longueur	,largeur	,hauteur	,profondeur	
dispositif	,additionneur	
message	,courriel	,sms	
téléphone	,téléphone portable	,fixe	,mobile	,portable	
gâteau	,palet	
compte	,compte	
examen	,bac	
nage	,brasse	,brasse-papillon	,crawl	,dos	,dos brassé	,dos crawlé	,nage indienne	
volume	,cube	,sphère	
fourrure	,vair	
outil	,aiguisoir	,cisaille	,clé	,enclume	,fraise	,marteau	,pelle	,pic	,pince	,pioche	,poinçon	,rabot	,râteau	,scie	,tenailles	,tournevis	,truelle	,vilebrequin	
volley	,volley de plage	,beach-volley	,volley de plage	,beach-volley	
lampe	,lampe-tempête	
violon	,alto	,violon alto	
sexualité	,sexualité de groupe	
biscuit	,pâtisserie	
briquet	,briquet-tempête	
sport	,sport aérien	;sport d’hiver	;sport de combat	;sport de glisse	;sport mécanique	;sport nautique	
pain	,pain polaire	
signe de ponctuation	,point	,point d’exclamation	,virgule	
nœud	,nœud de vache	
saint	,saint patron	
parties intimes	,partie	
cétacé	,baleine	
sens	,ouïe	,vue	,odorat	,goût	,toucher	
wagon	,wagon-lits	,wagon-restaurant	
connecteur	,implication	
boucle	,boucle articulatoire	
piano	,piano droit	,piano à queue	,piano crapaud	
transports	,transport ferroviaire	
sabre	,cuillère à pot	
course	;marathon	,semi-marathon	,50 mètres	,100 mètres	,200 mètres	,400 mètres	,800 mètres	,1500 mètres	,5000 mètres	,10 000 mètres	,10 kilomètres	;rallye	
escargot	,escargot de Bourgogne	,petit-gris	
discipline	,sport	,sprint	
document	,enregistrement	
logiciel	,utilitaire	;aspirateur	,gestionnaire	
orifice	,narines	
arme blanche	,épée	
provision	,provision pour risques et charges	
appartement	,meublé	;penthouse	;garçonnière	;studio	;loft	;duplex	;triplex	;quadruplex	,une-pièce	;F1	,T1	;deux-pièces	,F2	,T2	;trois-pièces	,F3	,T3	;quatre-pièces	,F4	,T4	;cinq-pièces	,F5	,T5	;six-pièces	,F6	,T6	;sept-pièces	,F7	,T7	;huit-pièces	,F8	,T8	;neuf-pièces	,F9	,T9	;dix-pièces	,F10	,T10	
>>>	Fact_2
dentifrice	,laver	,nettoyer	
dents	,couper	,scier	;broyer	
tornade	,bousculer	,secouer	<dévaster	,secouer	
guirlande	,agrémenter	,embellir	
vague	,frapper	,heurter	;submerger	
agresseuse	,agresser	
triangle	,signaler	
conceptrice	,concevoir	
agresseur	,agresser	
soleil	,illuminer	
composant	,composer	
boulangère	,faire	;préparer	
mère	,élever	,s’occuper	,prendre soin	;allaiter	,donner le sein	,nourrir	,s’occuper	,prendre soin	
pluie	,mouiller	,arroser	<laver	<tremper	,détremper	,lessiver	,doucher	<noyer	;transpercer	,traverser	,pénétrer	;alimenter	
bouchère	,couper	,découper	;débiter	;dépecer	
caractéristique	,caractériser	
bocal	,contenir	
accusateur	,accuser	
ami	,aider	;protéger	,aider	;encourager	;protéger	
voyou	,agresser	,tabasser	;racketter	,voler	
boulanger	,faire	;préparer	
journaliste	,couvrir	;enquêter	,couvrir	;enquêter	
commentatrice	,commenter	
four	,cuire	,brûler	
garant	,garantir	
chasseur	,chasser	
voiture	,transporter	
parasite	,profiter	,profiter	
présure	,cailler	
accompagnatrice	,accompagner	,accompagner	
semeur	,semer	
peloton de tête	,mener	
coiffeur	,coiffer	;couper les cheveux	
mécanicien	,créer	,inventer	
avion	,transporter	
porteur	,porter	
chat	,attraper	;toucher	
camion	,acheminer	,transporter	
nappe	,recouvrir	
aspirateur	,aspirer	;avaler	,absorber	,aspirer	,absorber	,avaler	
savon	,laver	,nettoyer	,laver	,nettoyer	
bus	,transporter	
ennemi	,détester	;nuire	,combattre	,lutter	;s’opposer	;nuire	
dent	,mordre	;croquer	;broyer	,s’emboîter	,broyer	,déchirer	
factrice	,fabriquer	
représentation	,représenter	
muscle	,mouvoir	
orchestre	,jouer	,interpréter	;repéter	
médecin	,examiner	;s’occuper	;soigner	,traiter	,examiner	;s’occuper	;soigner	,traiter	
arracheur	,arracher	
autocar	,transporter	
acheteur	,acheter	
trieur	,trier	
bateau	,transporter	
accompagnement	,accompagner	
avocate	,conseiller	;représenter	;défendre	,défendre	;lutter	,militer	
opéra	,donner	
couleur	,colorer	
tempête	,s’abattre	;balayer	;frapper	
chanteur	,chanter	
bol	,contenir	
concepteur	,concevoir	
boucher	,couper	,découper	;débiter	;dépecer	
arbitre	,arbitrer	
chercheur	,chercher	
mécanicienne	,conduire	
hélicoptère	,transporter	
administratrice	,administrer	
chanteuse	,chanter	
accompagnateur	,accompagner	,accompagner	
tramway	,desservir	
semeuse	,semer	
commentateur	,commenter	
collectionneur	,collectionner	
garante	,garantir	
véhicule	,véhiculer	,transmettre	
tyran	,tyranniser	
barbier	,raser	
casserole	,contenir	
combattante	,combattre	,se battre	
navire	,transporter	
camionnette	,transporter	
père	,élever	,s’occuper	,prendre soin	,s’occuper	,prendre soin	
aide	,aider	,aider	
facteur	,fabriquer	
coiffeuse	,coiffer	;couper les cheveux	
chasseuse	,chasser	
trieuse	,trier	
étagère	,supporter	
criminel	,commettre	,se livrer	
accusatrice	,accuser	
bastion	,protéger	
bouchon	,boucher	,obstruer	
administrateur	,administrer	
avocat	;conseiller	;représenter	;défendre	,défendre	;lutter	,militer	
lessive	,laver	,nettoyer	
acheteuse	,acheter	
vétérinaire	,examiner	;s’occuper	;soigner	,traiter	,examiner	;s’occuper	;soigner	,traiter	
bandit	,commettre	,se livrer	
car	,transporter	
>>>	SingS_1
brosserie	,brosse	
orchestre	,musicien	,musicienne	
direction	,directeur	,directrice	
Hollande	,Hollandais	,Hollandaise	
italien	,Italien	,Italienne	
gouvernement	,ministre	
paysannat	,paysan	,paysanne	
collection	,vêtement	
coréen	,Coréen	,Coréenne	
ballet	,danseur	,danseuse	
équipage	,membre	
chinois	,Chinois	,Chinoise	;sinophone	,sinophone	
carré	,fantassin	,soldat	,femme soldat	,militaire	,militaire	
portugais	,Portugais	,Portugaise	;lusophone	,lusophone	
noms	,noms	
visite	,visiteur	,visiteuse	;participant	,participante	
Australie	,Australien	,Australienne	
reptiles	,reptile	
suédois	,Suédois	,Suédoise	
vers	,ver	
boche	,Boche	,Boche	
Bretagne	,Breton	
germanique	,Germanique	,Germanique	
faune	,animal	
portée	,petit	
pineraie	,pin	
grec	,Grec	,Grecque	
pinède	,pin	
enfance	,enfant	,enfant	
Chine	,Chinois	,Chinoise	
gens	,personne	,individu	
nippon	,Nippon	,Nippone	
active	,actif	
personnel	,employé	,employée	,membre	,personnel	
centre aéré	,enfant	
angliche	,Angliche	
Nouvelle-Zélande	,Kiwi	
fichier	,fiche	
synagogue	,rabbin	
paysannerie	,paysan	,paysanne	
Corée	,Coréen	,Coréenne	
mairie	,conseiller municipal	,conseillère municipale	
Allemagne	,Allemand	,Allemande	
Triangle	,étoile	
clavier	,touche	
chleuh	,Chleuh	,Chleuh	,Chleuh	
lectorat	,lecteur	,lectrice	
poissons	,poisson	
Amérique	,Américain	,Américaine	,Américain	
turc	,Turc	,Turque	
Moyen-Âge	,médiéval	
marine	,marin	
trésor	,trésor	
japonais	,Japonais	,Japonaise	
réserve	,réserviste	,réserviste	
table	,convive	,convive	,serveur	,serveuse	;cuisinier	,cuisinière	;chef	
pays	,habitant	,habitante	;citoyen	,citoyenne	,pays	
gallois	,Gallois	,Galloise	
exemplier	,exemple	
équipe	,membre	
pinière	,pin	
russe	,Russe	,Russe	;russophone	,russophone	
Corée du Sud	,Sud-Coréen	,Sud-Coréenne	
occupant	,occupant	
patronat	,patron	,patronne	
cru	,vin	
français	,Français	,Française	;francophone	,francophone	
fratrie	,frère	,sœur	
famille	,membre	;parent	,membre	,membre	,membre	,membre	,mafioso	
électorat	,électeur	,électrice	
restaurant	,serveur	,serveuse	
Belgique	,Belge	,Belge	
Corée du Nord	,Nord-Coréen	,Nord-Coréenne	
théâtre	,comédien	,comédienne	,acteur	,actrice	
Japon	,Japonais	,Japonaise	,Nippon	,Nippone	
maison close	,prostituée	
oiseaux	,oiseaux	,oiseau	
Grande-Bretagne	,Britannique	,Britannique	
anglais	,Anglais	,Anglaise	;anglophone	,anglophone	
Portugal	,Portugais	,Portugaise	
lexique	;mot	;lexème	
Canada	,Canadien	,Canadienne	
salariat	,salarié	,salariée	
gorge chaude	,rapace	
bureau	,secrétaire	,trésorier	,trésorière	,employé	,employée	,collègue	;collègue	
putsch	,putschiste	
Irlande	,Irlandais	,Irlandaise	
Italie	,Italien	,Italienne	
œuvre	,œuvre	
aire de jeux	,enfant	,enfant	
allemand	,Allemand	,Allemande	;germanophone	,germanophone	
Espagne	,Espagnol	,Espagnole	
Turquie	,Turc	,Turque	
émigration	,émigré	,émigrée	
conseil municipal	,conseiller municipal	,conseillère municipale	,conseiller municipal	,conseillère municipale	
bordel	,prostituée	
flore	,végétal	
breton	,Breton	,Bretonne	
espagnol	,Espagnol	,Espagnole	;hispanophone	,hispanophone	
États-Unis	,Américain	,Américaine	;États-unien	,États-unienne	
>>>	Syn_⊂^sex
coléreuse	,coléreux	
chasseresse	,chasseur	
Québécoise	,Québécois	
continentale	,continental	
diplômée	,diplômé	
travailleuse	,travailleur	
politicarde	,politicard	
motocycliste	,motocycliste	
Européenne	,Européen	
francophone	,francophone	
publicitaire	,publicitaire	
doctoresse	,docteur	
pouilleuse	,pouilleux	
toilière	,toilier	
volleyeuse	,volleyeur	
margrave	,margrave	
pasteure	,pasteur	
rougeaude	,rougeaud	
Arabe	,Arabe	
vengeresse	,vengeur	
adolescente	,adolescent	,ado	
rivale	,rival	
remplaçante	,remplaçant	
parente	,parent	
admiratrice	,admirateur	
patineuse	,patineur	
capitaine	,capitaine	,capitaine	,capitaine	
vétérinaire	,vétérinaire	
muette	,muet	
hispanophone	,hispanophone	
productrice	,producteur	
enquêteuse	,enquêteur	
jeûneuse	,jeûneur	
petite vieille	,petit vieux	
linguiste	,linguiste	
soigneuse	,soigneur	,soigneur	
agressée	,agressé	
parieuse	,parieur	
débitante	,débitant	
grutière	,grutier	
hôte	,hôte	,hôte	,hôte	
ratée	,raté	
détentrice	,détenteur	
pleureuse	,pleureur	
internaute	,internaute	
anonyme	,anonyme	
coopérante	,coopérant	
bagarreuse	,bagarreur	
parfumeuse	,parfumeur	
pisseuse de copie	,pisseur de copie	
électronicienne	,électronicien	
passagère	,passager	
savante	,savant	
médecin légiste	,médecin légiste	
étudiante	,étudiant	
tireuse	,tireur	
confiseuse	,confiseur	
expéditrice	,expéditeur	
intervieweuse	,intervieweur	
diablesse	,diable	
adulte	,adulte	
extraterrestre	,extraterrestre	,extraterrestre	
puînée	,puîné	,cadet	
professeure	,professeur	,prof	
volée	,volé	
Suisse	,Suisse	
religieuse	,religieux	
arrivante	,arrivant	
esclave	,esclave	
kidnappée	,kidnappé	
éléphante	,éléphant	
futée	,futé	
Portugaise	,Portugais	
béni-oui-oui	,béni-oui-oui	
dormeuse	,dormeur	,dormeur	
ermite	,ermite	,ermite	
ébéniste	,ébéniste	
convive	,convive	
juive	,juif	
xénophobe	,xénophobe	
footballeuse	,footballeur	
hôtesse	,hôte	
emmerdeur	,emmerdeuse	
cane	,canard	
ivrognesse	,ivrogne	
coupable	,coupable	
accusée	,accusé	
croyante	,croyant	
menuisière	,menuisier	
banlieusarde	,banlieusard	
boiteuse	,boiteux	
originale	,original	
cadette	,cadet	
prévisionniste	,prévisionniste	
plongeuse	,plongeur	
monitrice	,moniteur	
nulle	,nul	
prof	,prof	,professeur	
chercheuse	,chercheur	,chercheur	
défunte	,défunt	
