>>>	S_0
se méfier	,méfiance	
râler	,râle	,râlement	
routier	,route	
mettre	,mise	
soulager	,soulagement	
auditif	,audition	;ouïe	
vérifier	,vérification	
abdiquer	,abdication	,abdication	
jardiner	,jardinage	
préhistorique	,préhistoire	
aboyer	,aboiement	,aboiements	
matinal	,matin	
délicieux	,délice	
pluvial	,pluie	
emprunter	,emprunt	
transpirer	,transpiration	
comparer	,comparaison	
humainement	,homme	,humain	
pénétrer	,pénétration	
formel	,forme	,forme	
bananier	,banane	
ranger	,rangement	,rangement	
magique	,magie	
guetter	,guet	
géométrique	,géométrie	,géométrie	,géométrie	
animer	,animation	
vrombir	,vrombissement	
administrer	,administration	,administration	
discuter	,discussion	
gémir	,gémissement	
communal	,commune	
penser	,pensée	
Merci	,remerciement	
mordre	,morsure	
jeûner	,jeûne	
accuser	,accusation	,accusation	
secourir	,secours	
manifester	,manifestation	
accoucher	,accouchement	
déménager	,déménagement	
proposer	,proposition	
négliger	,négligence	
tragique	,tragédie	
percer	,perçage	
développer	,développement	,développement	,développement	
expérimenter	,expérimentation	
costal	,côte	
douanier	,douane	
résider	,résidence	
verbal	,verbe	
destiner	,destination	
villageois	,village	
mobilier	,mobiler	
échapper	,échappée	
dresser	,dressage	
tactilement	,toucher	
geler	,gel	
fondre	,fonte	
mesurer	,mesure	
arrêter	,arrêt	,arrêt	,arrestation	
broyer	,broiement	,broyage	
recevoir	,réception	
frôler	,frôlement	
voyager	,voyage	
acheter	,achat	
afficher	,affichage	
souder	,soudage	;soudure	
tendre	,tendage	
nationaliser	,nationalisation	
loger	,logement	
>>>	A_2Perf
exposer	,exposé	
enchanter	,enchanté	
hospitaliser	,hospitalisé	
détruire	,détruit	,détruit	
éplucher	,épluché	
affoler	,affolé	
bourrer	,bourré	
dégoûter	,dégoûté	
détacher	,détaché	
lacer	,lacé	
décourager	,découragé	
hacher	,haché	
décider	,décidé	
enlever	,enlevé	,enlevé	
barrer	,barré	
exercer	,exercé	
nettoyer	,nettoyé	,nettoyé	,nettoyé	,nettoyé	,nettoyé	,nettoyé	,nettoyé	,nettoyé	,nettoyé	,nettoyé	
imprimer	,imprimé	
accuser	,accusé	
promettre	,promis	
animer	,animé	
défaire	,défait	,défait	
avertir	,averti	
développer	,développé	
épouvanter	,épouvanté	
orienter	,orienté	
élaborer	,élaboré	
remplir	,rempli	
goudron	,goudronné	
charger	,chargé	
vider	,vidé	;vide	
affaiblir	,affaibli	
disposer	,disposé	
rabattre	,rabattu	
explorer	,exploré	
enfermer	,enfermé	
ouvrir	,ouvert	
fâcher	,fâché	
éloigner	,éloigné	
râper	,râpé	
étirer	,étiré	
indiquer	,indiqué	
encercler	,encerclé	
fendre	,fendu	
insulter	,insulté	
inscrire	,inscrit	
griller	,grillé	
écrire	,écrit	
munir	,muni	
envahir	,envahi	,envahi	
recouvrir	,recouvert	
aider	,aidé	
ruiner	,ruiné	
enchaîner	,enchaîné	
déterminer	,déterminé	
diplômer	,diplômé	
endormir	,endormi	
décoration	,décoré	,décoré	
punir	,puni	
fonder	,fondé	
brosser	,brossé	
étrangler	,étranglé	
se détendre	,détendu	
appauvrir	,pauvre	
extraire	,extrait	
encadrer	,encadré	
allonger	,couché	
dresser	,dressé	
voir	,vu	
amuser	,amusé	
>>>	Syn_∩
ombre	,obscurité	
barrique	,éléphant	
faire chambre à part	,faire lit à part	
insigne	,cravate	
enfiévré	,fiévreux	
se restaurer	,manger	;s’alimenter	,se nourrir	;se sustenter	;tortorer	;becter	;bouffer	;casser la croûte	,casser la graine	;grailler	
respectable	,bien	
aïkido	,judo	,karaté	
exterminateur	,boucher	
vainqueur	,gagnant	,gagnant	
rythme	,train	,rapidité	,vitesse	,train	
scier	,blesser	
contestataire	,protestataire	
distant	,éloigné	,lointain	
observable	,visible	
important	,gros	
athlétique	,musclé	
se fixer	,s’installer	
phénomène	,évènement	
si bien	,alors	,donc	,du coup	;par conséquent	
dévoiler	,révéler	
coopérant	,coopératif	
décoration	,ornement	
bombardement	,orage d’acier	
chaîne	,antenne	
fautif	,incorrect	
s’éteindre	,s’arrêter	
se jeter _N derrière la cravate	,boire	,picoler	
enfermé	,prisonnier	
paire	,couple	
se heurter	,se cogner	
thermomètre	,température	,indication	
ne pas manger	,ne pas faire de mal à une mouche	
approximativement	,environ	
français	,hexagonal	
infraction	,faute	
hurlements	,grognement	
exagérer	,en faire des tartines	,en mettre des tartines	
trancher	,couper	,découper	
doigt	,fond	
provocant	,insultant	
curieuse	,questionneur	,questionneuse	
train de maison	,train de vie	
se confirmer	,se vérifier	
cuirassé	,bâtiment	;torpilleur	,blindé	
s’entretenir	,converser	,discuter	;causer	
automatisme	,réflexe	
meuf	,femme	,femelle	,gonzesse	
salle	,public	
royaume	,empire	;pays	,monarchie	,pays	
bon train	,rapidement	
piqûre	,blessure	
casse-croûte	,sandwich	,casse-dalle	
rond	,ivre	,saoul	<blindé	,cuité	<bourré	,pinté	<beurré	,plein	,pété	,torché	,déchiré	,raide	,arraché	,cercle	,bon	
poudrière	,champ de mines	,volcan	
manger son blé en herbe	,dilapider	,gaspiller	
canne	,bâton	
adosser	,appuyer	
étambot	,poupe	
se réduire	,se résumer	
marche à suivre	,démarche	,politique	
exiger	,demander	
footing	,jogging	,jogging	
tas	,entassement	,beaucoup	
génie	,talent	
calme	,sang-froid	;philosophie	,tranquilité	
face	,figure	,gueule	,tête	,visage	,côté	
intempéries	,pluie	
évêque	,religieux	
intéresser	,enthousiasmer	
>>>	Anti
minimiser	,exagérer	
net	,flou	
éligible	,inéligible	
s’endormir	,se réveiller	
sincérité	,insincérité	
ingouvernable	,gouvernable	
faux	,vrai	,vrai	,juste	
endormi	,réveillé	
impoli	,poli	
sauvage	,domestique	
proprement	,salement	,salement	,salement	,salement	
achetable	,vendable	
prudent	,imprudent	
serrer	,desserrer	
immobile	,mobile	
supérieur	,inférieur	
lentement	,rapidement	
mortel	,immortel	
déraison	,raison	
amont	,aval	
silence	,parole	
avantager	,désavantager	
matériel	,spirituel	
défaite	,victoire	
immergé	,émergé	
plier	,déplier	
moins	,plus	
xénophobie	,xénophilie	
aval	,amont	
croyable	,incroyable	
baisse	,hausse	
remplir	,vider	
discrétion	,indiscrétion	
accord	,désaccord	
passé	,futur	,futur	
cradingue	,impeccable	
enrouler	,dérouler	
impatience	,patience	
dépendre	,pendre	
rapide	,lent	
faiblesse	,force	
inauthentique	,authentique	
éteint	,allumé	
absence	,présence	
planter	,déplanter	
indigne	,digne	,digne	
coupable	;innocent	
lier	,délier	
public	,privé	
infertile	,fertile	
émergé	,immergé	
futur	,passé	,passé	
haut	,bas	,bas	,bas	
objectivité	,subjectivité	
déraisonner	,raisonner	
éveil	,sommeil	
unir	,désunir	
cracra	,impeccable	
correct	,incorrect	
chuter	,s’envoler	
forme	,informe	
déranger	,ranger	
apparaître	,disparaître	,disparaître	
démarrer	,arrêter	,s’arrêter	
meilleur	,pire	
échec	,réussite	,succès	
introuvable	,trouvable	
moderne	,ancien	
incompréhensible	,compréhensible	
souvent	,jamais	,rarement	,quelquefois	,parfois	,toujours	
>>>	Syn_⊃
promeneur	,flâneur	
cracra	,dégueu	,dégueulasse	
goût	,saveur	;bouche	
grand	,vaste	
cigare	,havane	,barreau de chaise	;cigarillo	
caca	,cigare	,colombin	
gagner	,écraser	,marcher sur la tête	
orthodontiste	,orthodontiste	
équin	,chevalin	
changer	,se changer	
vingtaine	,vingt	
avoir froid	,se geler les fesses	
voler	,voleter	;survoler	;planer	;survoler	,voleter	
crever	,passer l’arme à gauche	,succomber	,s’éteindre	
attendre	,patienter	
groupe	;équipe	;bande	
train	,T.G.V.	,TER	,corail	;express	,omnibus	
cravate	,lavallière	,régate	
mobiler	,meuble	
feuille de chou	,journal	
chose	,objet	
forme	,condition	,vitalité	,figure	,embauchoir	
se fourrer	,se blottir	
baguettes	,balai	
nuage	;couverture	,essaim	,ensemble	
tuyau	,pipe	
quantité	,nombre	;peu	
pot	,vin d’honneur	
rire	,se fendre la pipe	
commandant	,commandante	
maison	,pavillon	
fabricant	,facteur	
métro	,terminus	
foulard	,carré	
célébration	,cérémonie	
politicienne	,politicarde	
cheveux	,cheveu	
frapper	,cogner	,cogner	,taper	
poignée	,oreilles	
désert	,friche	,néant	,vide	,absence	
consommer	,finir	
utiliser	,faire usage	
table	,restaurant	
griller	,cloper	
enfantin	,infantile	
crime	,meurtre	,assassinat	
encadrement	,cadre	
pistolet	,revolver	
dent	,chicot	,crocs	
chanteuse	,cantatrice	
crier	,hurler	,hurler	
chaussures	,chaussons	
s’enfiler	,boire	;manger	
promeneuse	,flâneuse	
tâche	,sale boulot	
liquide	,boisson	
trépasser	,s’éteindre	,succomber	,passer l’arme à gauche	
lieu	,endroit	;lieu	
monnaie	,lire	
nez	,museau	;bec	
causer	,entraîner	,déclencher	,provoquer	,susciter	
Corée du Sud	,Pays du Matin calme	
Japon	,Pays du Soleil Levant	,Pays des Cerisiers en fleurs	
lavage	,lessive	
appliqué	,soigné	
violoniste	,violon	,violon	
jardin	,potager	
parlementaire	,député	,députée	
étonner	;stupéfier	
couche	,lit	,lit	
>>>	S_1
supprimer	,suppresseur	
mirage	,oasis	
camionnette	,chauffeur	,conducteur	,conductrice	
massif	,plante	
importer	,importateur	,importatrice	
débit	,cours d’eau	,fleuve	,rivière	
cogner	,cogneur	
éduquer	,éducateur	,éducatrice	
chat	,maître	,maîtresse	;propriétaire	,propriétaire	,chat	
lire	,lecteur	,lectrice	
critique	,critique	
fouiller	,fouilleur	
peau	,animal	
réalisé	,réalisation	
langue	,locuteur	,locutrice	
admirer	,admiratrice	,admirateur	
participant	,participant	,participante	
spectacle	,spectateur	,spectatrice	
accident	,accidentée	,accidenté	
lavage	,machine	,lave-linge	
vaccinable	,êtres animés	
hériter	,héritier	,héritière	
délinquance	,délinquant	,délinquante	
veuvage	,veuf	,veuve	
force	,fort	
bavarder	,bavard	,bavarde	
reine	,abeille	
animal	,maître	,maîtresse	,propriétaire	,propriétaire	,possesseur	
hypnotiser	,hypnotiseur	,hypnotiseuse	
train	,véhicule	
monture	,lunettes	
patiner	,patineur	,patineuse	
charcuterie	,charcutier	,charcutière	
guetter	,guetteur	,guetteuse	
bulletin de vote	,votant	,votante	;électeur	,électrice	
travailler	,travailleur	,travailleuse	;employé	,employée	
sourcils	,animal	
expérience	,expérimentateur	
cristal	,matière	
écrire	,écriveur	,écriveuse	
bonnet	,ruminants	
au bord des lèvres	,cigare	
rançon	,kidnappeur	,kidnappeuse	;ravisseur	,ravisseuse	
marcher	,marcheur	,marcheuse	;randonneur	,randonneuse	
démission	,démissionnaire	,démissionnaire	
Chine	,Chine	
poison	,empoisonneur	,empoisonneuse	
modestie	,modeste	,modeste	
jazz	,jazzman	,jazzwoman	
jouer	,joueur	,joueuse	
Grèce	,Grèce	
doigt	,gants	
secrétariat	,secrétaire	,secrétaire	
négocier	,négociateur	,négociatrice	
chasser	,chasseur	,chasseuse	,chasseresse	
s’enfuir	,fuyard	,fuyarde	
information	,informateur	,informatrice	
contenu	,contenant	
se venger	,vengeur	,vengeresse	
entreprise	,entrepreneur	,entrepreneuse	
affluent	,fleuve	
rédiger	,rédacteur	,rédactrice	
poissonnerie	,poissonnier	
inspirer	,inspirateur	,inspiratrice	
chien	,maître	,maîtresse	;propriétaire	,propriétaire	,tarot	
château	,châtelain	,châtelaine	
Allemagne	,Allemagne	
environnement	,humain	
sur ses deux oreilles	,dormir	
xénophobie	,xénophobe	,xénophobe	
>>>	A_0
internationalement	,international	
épouvantablement	,épouvantable	
géographie	,géographique	
gorge	,jugulaire	,guttural	
grandeur	,grand	
centre	,central	,central	
marbre	,marbrier	
sœur	,sororal	
femme	,féminin	
autrement	,autre	
information	,informationnel	
Chine	,chinois	
insecticide	,insecticide	
bouche	,buccal	
contredire	,contradictoire	
laine	,lainier	
Europe	,européen	
mouton	,ovin	
élire	,électoral	
sourcils	,sourcilier	
fraternellement	,fraternel	
pavillon	,pavillonnaire	
superbement	,superbe	
télévision	,télévisuel	
guerre	,guerrier	
immensité	,immense	
lâchement	,lâche	
roi	,royal	
Soleil	,solaire	
paralytique	,paralysie	
infiniment	,infini	
batellerie	,batelier	
apéritif	,apéritif	
agriculture	,agricole	
impeccablement	,impeccable	,impec	
plan	,plan	
aéroporter	,aéroporté	
printemps	,printanier	
avocate	,avocassier	
univers	,universel	
matériellement	,matériel	
corps à corps	,corps à corps	
ventre	,ventral	,ventral	
musculairement	,musculaire	
Belgique	,belge	
animalité	,animal	,animal	
goudron	,goudronneux	
imaginer	,imaginatif	
police	,policier	
aucunement	,aucun	
mois	,mensuel	
gendarmette	,gendarmesque	
spécialement	,spécial	
bénévolement	,bénévole	
courbe	,courbe	
louer	,locatif	
extraordinairement	,extraordinaire	
pape	,papal	
France	,français	
racisme	,raciste	
sardine	,sardinier	
ping-pong	,pongiste	
nuage	,nuageux	
langage	,langagier	
rouge	,rouge	,rouge	
séisme	,sismique	
médias	,médiatique	
commercialement	,commercial	
cause	,causal	
identité	,identitaire	
>>>	Able_2
danser	,dansable	
consommation	,consommable	
attraper	,attrapable	
importer	,importable	
détruire	,destructible	,destructible	
transporter	,transportable	,transportable	
plier	,pliable	,pliant	
adapter	,adaptable	
louer	;louable	
éviter	,évitable	
remuer	,remuable	
solution	,soluble	
ordonner	,ordonnable	
défendre	,défendable	
incliner	,inclinable	
exiger	,exigible	
sympathie	,sympathique	,sympa	
scier	,sciable	
imiter	,imitable	
mesurer	,mesurable	
pardonner	,pardonnable	
détester	,détestable	
éduquer	,éducable	
raccommoder	,raccommodable	
annuler	,annulable	
réparer	,réparable	
déplacer	,déplaçable	
tolérer	,tolérable	
atteindre	,atteignable	
distribuer	,distribuable	
administrer	,administrable	,administrable	
tourner	,tournant	
supposer	,supposable	
supprimer	,supprimable	
occuper	,occupable	
tuer	,tuable	
contestation	,contestable	
cultiver	,cultivable	
se désoler	,désolant	
achetable	,acheter	
modifier	,modifiable	
consommer	,consommable	
vélo	,cyclable	
soupçonner	,soupçonnable	;suspect	
exécuter	,exécutable	
recycler	,recyclable	
opposer	,opposable	
compensation	,compensable	,compensable	
agacement	,agaçant	
contrôler	,contrôlable	
accepter	,acceptable	
manger	,mangeable	,comestible	
appliquer	,applicable	,applicable	
avouer	,avouable	
démonter	,démontable	
ajuster	,ajustable	
digérer	,digérable	
exprimer	,exprimable	
décrire	,descriptible	
accès	,accessible	
bicyclette	,cyclable	
mourir	,mortel	
organiser	,organisable	
exploiter	,exploitable	
traverser	,traversable	
calcul	,calculable	
acheter	,achetable	
exporter	,exportable	
participer	,participatif	
prononcer	,prononçable	
>>>	Anti_∩
convenablement	,mal	,incorrectement	
empêcher	,permettre	
rareté	,profusion	
léger	,gros	
aujourd’hui	,autrefois	,hier	,demain	
flexible	,têtu	
encombré	,dégagé	
chambarder	,ranger	
déjà	,enfin	
malade	,debout	,valide	
pauvre	,riche	
connaître	,ignorer	
mal	,bien	,bien	,correctement	,convenablement	,honnêtement	
élever	,baisser	
comprendre	,nager	
gazeux	,liquide	,solide	
privatiser	,nationaliser	
tout	,rien	
long	,petit	,petit	,petit	,rapide	
exigu	,spacieux	
retrouver ses jambes de vingt ans	,ne plus avoir de jambes	
arriver	,quitter	
s’initer	,arrêter	
mauvais	,bon	,bon	,bon	
toujours	,parfois	,longtemps	
rapprocher	,éloigner	
baisser	,lever	
contraste	,analogie	,analogie	,similarité	
dansant	,indansable	
disgracieux	,gracieux	
en coup de vent	,longuement	
nationaliser	,privatiser	
économiser	,gaspiller	
savon	,compliment	
similitude	,dissimilarité	,différence	
éloge	,blâme	,reproche	,critique	
actualité	,passé	
oui	,non	
gaspiller	,économiser	
perdre	,trouver	,retrouver	
replier	,déplier	
tracassier	,arrangeant	
occupé	,libre	
fluide	,solide	
épouse	,célibataire	
idéalité	,réalité	
lâcheté	,courage	
ouvrable	,férié	
religieux	,civil	
technique	,courant	
brûlant	,glacé	
bande d’arrêt d’urgence	,bande de circulation	
chaud	,froid	
petit	,long	
clairsemé	,abondant	
dissemblable	,similaire	
fort	,faible	
reproche	,éloge	
humour	,balai dans le cul	
critique	,élogieux	
demeurer	,quitter	
minuscule	,immense	,énorme	,géant	,spacieux	
coup d’arrêt	,coup d’accélérateur	
crâne	,lâche	
jeune	,âgé	,vieux	,vieux	
propre	,malpropre	,malhonnête	
conserver	,quitter	
hypocritement	,franchement	
riche	,pauvre	
quitter l’habit	,prendre la robe	
>>>	V_0
sacrifice	,sacrifier	
toucher	,toucher	
direction	,diriger	
raisonnement	,raisonner	
maîtrise	,maîtriser	
différent	,différer	
gazouillement	,gazouiller	
intervention	,intervenir	
promesse	,promettre	
quatre-heures	,goûter	
broiement	,broyer	
qualification	,qualifier	
urgence	,urger	
aplatissement	,aplatir	
gâchage	,gâcher	
exceptionnel	,excepter	
rejet	,rejeter	
démolissage	,démolir	
tir	,lancer	
blocage	,bloquer	
galop	,galoper	
cueillette	,cueillir	
abus	,abuser	
refroidissement	,refroidir	
transformation	,transformer	
achat	,acheter	
transport	,transporter	,transporter	
capture	,capturer	
apaisement	,apaiser	,s’apaiser	
recherche	,rechercher	
occupation	,occuper	,occuper	,occuper	
léchage	,lécher	
arrivée	,arriver	
accomplissement	,accomplir	,s’accomplir	
haussement	,hausser	
culture	,cultiver	
désintérêt	,désintéresser	,se désintéresser	
accouchement	,accoucher	
liage	,lier	
règlement	,régler	
raccommodage	,raccommoder	
calcul	,calculer	
pesage	,peser	
cri	,crier	,crier	
provocation	,provoquer	
escalade	,escalader	
écoute	,écouter	
toilette	,toiletter	
dominateur	,dominer	
boutonnage	,se boutonner	,boutonner	
embrassement	,embrasser	
entretien	,s’entretenir	,entretenir	
soulagement	,soulager	
effondrement	,s’effondrer	
instruction	,instruire	,instruire	
confusion	,se confondre	
atteignable	,atteindre	
obtention	,obtenir	
liaison	,lier	
émigration	,émigrer	
imitation	,imiter	
dépôt	,déposer	
kidnapping	,kidnapper	
suite	,se suivre	
saignement	,saigner	
fonctionnement	,fonctionner	
exploitation	,exploiter	
pet	,péter	
ouverture	,ouvrir	
entente	,s’entendre	
>>>	S_3
bombarder	,bombe	,bombardier	
hôpital	,patient	,patiente	
coiffer	,coiffure	
admiration	,objet	,source	
accès	,accès	
ordonnance	,médicament	
trahir	,trahison	
arracher	,arracheuse	
imposer	,impôt	
maire	,administré	,administrée	
marche	,auditeur	,auditrice	
clinique	,soins	
restaurant	,clientèle	;client	,cliente	
timbre	,colis	;enveloppe	,lettre	
boucher	,client	,cliente	
bus	,arrêt	
film	,acteur	,actrice	,comédien	,comédienne	
plein	,véhicule	
diriger	,direction	
similitude	,similitude	,point commun	
multiplier	,multiplicateur	
collège	,collégien	,collégienne	
récompense	,récompense	
compenser	,compensation	
nettoyage	,nettoyeur	
courriel	,contenu	
accentuer	,accent	,accent	
député	,circonscription	
apprendre	,élève	,élève	,étudiante	,étudiant	
exposer	,public	
discuter	,sujet	,thème	
juger	,délit	;crime	
enveloppe	,destinataire	,destinataire	,bénéficiaire	
boulangère	,client	,cliente	
boîte aux lettres	;courrier	
différer	,différence	
améliorer	,amélioration	
débitrice	,dette	
criminel	,victime	
carré	,jardin	,potager	
voter	,élection	
habiller	,habits	,vêtements	
conversation	,sujet	,thème	
similarité	,similarité	,point commun	
drame	,comédien	,comédienne	
bouchère	,client	,cliente	
nourrir	,nourriture	
bagage	,domaine	,discipline	
bijouterie	,client	,cliente	
juge	,tribunal	
comprimé	,substance active	
autopsie	,résultat	
gommer	,gomme	
différence	,différence	
payer	,paiement	
tirage	,tirage	
plateau	,tir	;ball-trap	
course	,taxi	;fiacre	
parier	,mise	
remplaçant	,compétition	
fusil	,projectile	,balle	,plomb	
emprunté	,emprunteur	,emprunteuse	
décharger	,chargement	
expédier	,destinataire	,destinataire	
cuir	,article	
hypermarché	,client	,cliente	,clientèle	
colis	,destinataire	,destinataire	
conclure	,conclusion	
leçon	,élève	,élève	,collégien	,collégienne	,lycéen	,lycéenne	,étudiant	,étudiante	
opéra	,auditeur	,auditrice	,spectateur	,spectatrice	
>>>	A_1
tambour	,à	
se succéder	,successif	
barbe	,barbu	
survivre	,survivant	
moderne	,moderne	
gazouiller	,gazouillant	,gazouilleur	
éligibilité	,éligible	
gratuité	,gratuit	
affoler	,affolant	
fortune	,fortuné	
construction	,constructeur	
majorité	,majeur	
racisme	,raciste	
venger	,vengeur	,vengeur	
protestataire	,protestataire	,protestataire	
grâce	,gracieux	
douche	,sous	
déplacement	,en	,en	
aimer	,amoureux	
manquer	,manquant	
gonfler	,gonflant	
âge	,âgé	,âgé	,âgé	
maltraiter	,maltraitant	
énormité	,énorme	
décourager	,décourageant	
fluvialité	,fluvial	
douceur	,doux	,doux	
fixité	,fixe	,fixe	
trébuchement	,trébuchant	
dureté	,dur	
occuper	,occupant	
race	,racé	
ivrognesse	,ivrogne	
vivre	,vivant	
amateur	,amateur	
équilibre	,en	
préoccuper	,préoccupant	
couvercle	,à	,muni	
mains propres	,à	
nuage	,nuageux	
dent dure	,à	
verglas	,couvert	,recouvert	
sapidité	,sapide	
émigrer	,émigrant	
récolter	,récoltant	
barbu	,barbu	
modifier	,modificateur	,modificatif	,modifiant	
ennemi	,ennemi	
boule	,en	
adopter	,adoptant	
vitamine	,vitaminé	
bruit	,bruyant	
protection	,protecteur	
pêcher	,pêcheur	
diriger	,directeur	,dirigeant	
mystère	,mystérieux	
révolter	,révoltant	
mammifères	,mammifère	
couple	,en	,en	
paralysie	,paralysé	;paralytique	
accident	,accidenté	
possessivité	,possessif	
exister	,existant	
se venger	,vengeur	
extrême	,extrême	
apparaître	,apparent	;visible	
admirer	,admiratif	
tête de mule	,têtu	
possibilité	,possible	
appuyer	,appuyé	
>>>	S_2^prototyp
fibre	,muscle	,tissu	
toilette	,porc	,veau	
s’allonger	,lit	
théâtre	,accident	;drame	
rôti	,bœuf	,porc	
facteur	,courrier	,lettre	;colis	,paquet	,clavecin	;flûte	;orgue	;piano	
parrain	,mafia	
bitume	,ville	
pâté	,lapin	,volaille	
transporté	,admiration	
ceinture	,pantalon	,jupe	,robe	,manteau	,véhicule	,agglomération	
mobiler	,pièce	
apprendre	,savoir	;discipline	
robinet	,eau	;gaz	;fluide	
patiente	,médecin	,médecin	,docteur	,docteure	
battre	,adversaire	,adversaire	,compétitrice	,compétiteur	;record	
jambe	,porc	;bœuf	
détourner	,regard	
verrou	,porte	
joue	,bœuf	
bouchère	,viande	
couché	,lit	,lit	
station	,bus	,métro	
bracelet	,chevilles	;poignet	
sirop	,fraise	,menthe	
forme	,chaussures	,chapeau	,pain	,fromage	,sucre	
traite	,vache	
symptôme	,maladie	
bonbec	,sucre	
fromage	,brebis	,chèvre	,vache	
enveloppe	,lettre	,document	
machine à coudre	,tissu	
condamner	,accusé	,accusée	
peindre	,peinture	
contracter	,muscle	
analogie	,organe	
boulangère	,pain	;viennoiserie	
paille	,boisson	
passer	,passage	
pâte	,pain	,pizza	,gâteau	,tarte	,biscuit	,beignet	
chaussée	,véhicule roulant	,véhicule	
lire	,livre	;magazine	
nager	,eau	
porteur	,chèque	
patient	,médecin	,médecin	,docteur	,docteure	
bouchon	,bouteille	,bouteille	
miellerie	,miel	
boucher	,viande	
victime	,maladie	;accident	;catastrophe	
fumeur	,cigare	,cigarette	,pipe	;tabac	
recouvert	,tissu	
tarte	,citron	,fraise	,pomme	,prune	,fromage blanc	,crème	,sucre	,chocolat	
écran	,film	
bénéficiaire	,chèque	,enveloppe	
piloter	,avion	,avionnette	,hélicoptère	,auto	,automobile	,voiture	;bateau	
cadre	,entreprise	,parti	,armée	
factrice	,courrier	,lettre	;colis	,paquet	,clavecin	;flûte	;orgue	;piano	
moudre	,café	,blé	
amputation	,membre	
tube	,pâte	
rivière	,steeple	
paroles	,chanson	
poitrine	,bœuf	,porc	,veau	,mouton	;poulet	,canard	,volaille	
péage	,autoroute	
cible	,chantage	
avion	,passager	,passagère	,voyageur	,voyageuse	;cargaison	,fret	
plan	,film	
titulaire	,passeport	;permis	,passeport	,permis	
petit chien	,accouchement	
nez	,cerise	,framboise	;épice	
>>>	Syn_⊃^sex
continental	,continentale	
cousin	,cousine	
titulaire	,titulaire	
professeur	,professeure	,prof	
messager	,messagère	
écolier	,écolière	
suicidé	,suicidée	
questionneur	,questionneuse	
adepte	,adepte	,adepte	
créancier	,créancière	
saoulard	,saoularde	
confiseur	,confiseuse	
opposant	,opposante	
espion	,espionne	
vendeur	,vendeuse	
handicapé	,handicapée	
évadé	,évadée	
accusateur	,accusatrice	
ado	,adolescente	,ado	
grippé	,grippée	
savant	,savante	
mime	,mime	
combattant du feu	,combattante du feu	
modeste	,modeste	
brun	,brune	
romancier	,romancière	
provocateur	,provocatrice	
maniaque	,maniaque	
instructeur	,instructrice	
imitateur	,imitatrice	
capricieux	,capricieuse	
jeune	,jeune	
gorille	,gorille	
idiot	,idiote	
correspondant	,correspondante	,correspondante	
étudiant	,étudiante	
soiffard	,soiffarde	
villageois	,villageoise	
prophète	,prophétesse	
procréateur	,procréatrice	
locuteur	,locutrice	
usager	,usagère	
optimiste	,optimiste	
enseignante	,maîtresse	
Portugais	,Portugaise	
chiffreur	,chiffreuse	
général	,générale	
mort	,morte	
instit	,instit	,institutrice	
migraineux	,migraineuse	
gourmand	,gourmande	
contribuable	,contribuable	
interprète	,interprète	,interprète	
imbécile	,imbécile	
compatriote	,compatriote	
animateur	,animatrice	,animatrice	
retardataire	,retardataire	
Indien	,Indienne	
moche	,moche	
sans-abri	,sans-abri	
buraliste	,buraliste	
développeur	,développeuse	
vieillard	,vieillarde	
médicastre	,médicastre	
péteur	,péteuse	
machiniste	,machiniste	,machiniste	
sculpteur	,sculpteure	,sculptrice	
ravisseur	,ravisseuse	,ravisseuse	
mangeur	,mangeuse	,mangeuse	
dîneur	,dîneuse	
>>>	Adv_0
précoce	,précocement	
initial	,initialement	
second	,secondement	
orage	,orageusement	,orageusement	
passager	,passagèrement	
pratique	,pratiquement	
affectueux	,affectueusement	
exception	,exceptionnellement	,exceptionnellement	
synthèse	,synthétiquement	
solide	,solidement	
nuage	,en	,sous forme	
généreux	,généreusement	
histoire	,historiquement	
bien	,bien	
démocratique	,démocratiquement	
rigide	,rigidement	
commercial	,commercialement	
maladroit	,maladroitement	
drôlerie	,drôlement	
homme	,humainement	
corps	,corporellement	,physiquement	
brusque	,brusquement	
collectif	,collectivement	
suffire	,suffisamment	
lointain	,loin	
égal	,également	
poli	,poliment	
isolé	,isolément	
conceptuel	,conceptuellement	
exceptionnel	,exceptionnellement	,exceptionnellement	
identique	,identiquement	
comparer	,comparativement	
vertical	,verticalement	
élastique	,élastiquement	
incomplet	,incomplètement	
famille	,familialement	,familialement	
luxe	,luxueusement	
sourd	,sourdement	
apparence	,en	,en	,en	
extrême	,extrêmement	
possible	,possiblement	
facile	,facilement	
supplément	,supplémentairement	
général	,généralement	
cruel	,cruellement	
fier	,fièrement	
médecine	,médicalement	
vilain	,vilainement	,vilainement	
invincible	,invinciblement	
haut	,haut	
danger	,dangereusement	
impatient	,impatiemment	
divers	,diversement	
définitif	,définitivement	
père	,paternellement	
miel	,mielleusement	
agile	,agilement	
humble	,humblement	
maternel	,maternellement	
collectivement	,collectif	
principal	,principalement	
effectif	,effectivement	
automatique	,automatiquement	
curieux	,curieusement	
ridicule	,ridiculement	
sérieux	,sérieusement	
lâche	,lâchement	
férocité	,férocement	
indiscret	,indiscrètement	
spécial	,spécialement	
>>>	Syn_⊂
sieste	,sommeil	
rabibocher	,réparer	
plonger	,mettre	
chariot	,voiture	
erg	,désert	
millier	,mille	
lavis	,aquarelle	
tuyau	,information	
s’exécuter	,faire	
fureur	,colère	
coup de fusil	,addition	
étude	,enquête	
lavage	,nettoyage	
crachin	,pluie	
toundra	,plaine	
veston	,veste	
dans un mouchoir de poche	,proche	
vieillard	;vieux	,vioc	
cagibi	,placard	
scène	,lieu	
cigarillo	,cigare	
cauchemar	,rêve	
bons pères	,religieux	
marcher sur la tête	,gagner	
œufs au plat	,poitrine	
potager	,jardin	
second	,deuxième	
engueulade	,dispute	
héberger	,loger	
crado	,sale	
carnet	,cahier	
éternité	,durée	
allure	,apparence	
taché	,sale	
course	,course	,déplacement	
code de la route	,document	
trébucher	,peser	
nappe	,étendue	
bâtiment	,construction	
rouge	,vin	,roux	
s’envoler	,augmenter	,partir	
émetteur	,antenne	
délinquant	,malfaiteur	,malfrat	
tennis	,match	,partie	,court	;terrain	
grandir	,croître	
jus de chaussette	,café	
curé	,prêtre	
sprinter	,courir	,coureur	
gravissime	,grave	
cheptel	,troupeau	
pratiquer	,faire	
grain	,averse	
ressentir	,éprouver	
chantage	,pression	
mi-chaussettes	,chaussettes	
véhicule roulant	,véhicule	
velouté	,potage	
bruine	,pluie	
brosser	,peindre	
enseigne	,panneau	
repasser	,passer	
symptôme	;indication	
fréquenter	,aller	
microscopique	,petit	
tombereau	,voiture	
fiacre	,voiture	
longueur	,dimension	
nourrir	,alimenter	
pique-nique	,repas	
ballon	,montagne	
>>>	Syn
ripatons	,arpion	,panards	,pieds	
pet	,vent	,gaz	,flatuosité	
chemin de fer	,voie ferrée	
pesée	,pesage	
lieux d’aisances	,cabinet d’aisances	,commodités	,cabinets	,petit coin	,pipi-room	,tinettes	,tartisses	
nationale	,route nationale	
grand-mère	,aïeule	,mère-grand	,grand-maman	,mamie	,mémé	,mémère	,bonne-maman	,mamie	,mémé	,vieillarde	
tempête magnétique	,orage magnétique	
machine	,lave-linge	
appartement	,appart	
mémé	,mamie	,mémère	,bonne-maman	,grand-maman	,aïeule	,mère-grand	,grand-mère	,grand-mère	,mamie	,vieillarde	
sweat-shirt	,sweat	
émigrant	,émigré	
pipe	,turlute	,pompier	,fellation	
mastiquer	,mâcher	
Mars	,planète rouge	
teinture	,coloration	,couleur	,coloration	,couleur	,coloration	,couleur	
carré final	,dernier carré	
océanique	,océane	
stomacal	,gastrique	
dans le creux de l’oreille	,dans le tuyau de l’oreille	
coupe-tif	,merlan	,coiffeur	,coiffeuse	
soutien-gorge	,soutif	
prendre en photo	,photographier	
photographier	,prendre en photo	
lattes	,planches	,skis	
rando	,randonnée	,randonnée	
Bonne Mère	,Mère de Dieu	,Vierge Mère	
bientôt	,tantôt	
pomme	,boule	,caboche	,carafe	,cigare	,crâne	,poire	,chef	,tête	
ordi	,ordinateur	
roi des animaux	,lion	
derrière	,cul	,panier	,arrière-train	,postérieur	,séant	,miches	,pétard	,croupe	,croupion	,fessier	,popotin	,derche	,lune	
confiote	,confiture	
clébard	,clebs	,cabot	,cador	,chien	,toutou	
chambre	,piaule	,carrée	
Cour	,tribunal	
aéronef	,véhicule volant	
sans le sou	,pauvre	
grand-papa	,aïeul	,bon-papa	,papi	,pépé	,pépère	,grand-père	
godasses	,chaussures	,grolles	,pompes	,tatanes	
judoka	,judokate	
nombre	,chiffre	
toubib	,doc	,docteur	,médecin	,doc	,doctoresse	,docteure	,femme médecin	,médecin	
remplir	,emplir	
secouriste	,sauveteur	
costard	,costume	
se prendre	,prendre	,ramasser	,se manger	,se ramasser	
cabochard	,têtu	
copain	,pote	
bouche	,embouchure	
sculpture	,sculptage	
cibiche	,sèche	,cancéreuse	,cigarette	,clope	,garo	,tige	,schmer	
capuche	,capuchon	
crier dans le désert	,parler dans le désert	,prêcher dans le désert	
rouler	,enrouler	,marcher	,tourner	,rouler dans la farine	
sûr	,certain	
petit	,p’tit	
guillotine	,coupe-cigare	
léchage	,lèchement	
planche à repasser	,table à repasser	
décélérer	,ralentir	,ralentir	
fastoche	,facile	
pères	,aïeux	,ancêtres	
motocyclette	,moto	,bécane	,meule	
pompière	,sapeuse-pompière	,femme pompier	,pompier	,sapeur-pompier	
merlan	,coupe-tif	,coiffeur	
paysannat	,paysannerie	
falzar	,ben	,bénard	,fendard	,froc	,fute	,futal	,culotte	,pantalon	
ballon rond	,football	,soccer	
>>>	S_1Pred
titulaire	,titulaire	
moche	,moche	,moche	;mocheté	
vieux	,vieux	,vieille	
nul	,nul	,nulle	
tentateur	,tentateur	,tentatrice	
puni	,punie	
chrétien	,chrétienne	,chrétien	
féminin	,femme	
inconnu	,inconnu	,inconnue	
français	,Français	,Française	
cul-de-jatte	,cul-de-jatte	,cul-de-jatte	
chinois	,Chinoise	,Chinois	
adulte	,adulte	,adulte	
hospitalisé	,hospitalisé	,hospitalisée	
voyou	,voyou	
handicapé	,handicapé	,handicapée	
espagnol	,Espagnol	,Espagnole	
pauvre	,pauvre	,pauvre	
infirme	,infirme	,infirme	
américain	,Américain	,Américaine	
symptomatique	,symptôme	
idiot	,idiot	,idiote	
italien	,Italien	,Italienne	
rival	,rival	;rivale	
russe	,Russe	,Russe	
millionnaire	,millionnaire	,millionnaire	
anonyme	,anonyme	
célèbre	,célébrité	
femelle	,femelle	
catholique	,catholique	,catholique	
innocent	,innocent	,innocente	
immortel	,immortel	,immortelle	
bavard	,bavarde	,bavard	
mâle	,mâle	
affirmatif	,affirmative	
coupable	,coupable	,coupable	
muet	,muet	,muette	
alcoolique	,alcoolique	
fouetteur	,fouetteur	,fouetteuse	
myope	,myope	,myope	
lâche	,lâche	,lâche	
impair	,nombre	;chiffre	
fort	,fort	
riverain	,riverain	,riveraine	
indiscret	,indiscret	,indiscrète	
asiatique	,Asiatique	,Asiatique	
grec	,Grec	,Grecque	
mineur	,mineur	,mineure	
jeune	,jeune	,jeune	
imbécile	,imbécile	,imbécile	
bon	,bon	
favori	,favori	,favorite	
aîné	,aîné	,aînée	
bizarre	,bizarrerie	
arabe	,Arabe	,Arabe	
juif	,juif	,juive	
merveilleux	,merveille	
végétarien	,végétarien	,végétarienne	
gentil	,gentil	,gentille	
ordinaire	,ordinaire	
mort	,mort	,morte	
suisse	,Suisse	,Suisse	,Suissesse	
franc	,Franc	
sourd	,sourd	,sourde	,bruit	
autochtone	,autochtone	,autochtone	
gourmand	,gourmand	,gourmande	
milliardaire	,milliardaire	,milliardaire	
organique	,organisme	
timide	,timide	,timide	
xénophobe	,xénophobe	,xénophobe	
>>>	S_2
contribuable	,impôt	,impôt	
ambulancier	,ambulance	
voyou	,victime	
se caractériser	,caractéristique	
dette	,dette	;argent	
retaper	,drap	;lit	
commérage	,commérage	
jeudi	,semaine	
avocate	,client	,cliente	,cause	
exploité	,exploitant	
enlever	,victime	
interview	,interviewé	
mercredi	,semaine	
boîte aux lettres	,facteur	,factrice	
conclusion	,conclusion	
week-end	,semaine	
testament	,bénéficiaire	
équipe	,sport	
automobile	,véhicule	
université	,universitaire	,universitaire	
aérodrome	,avion	
discours	,auditeur	,auditrice	
vendredi	,semaine	
enveloppe	,contenu	
habillé	,vêtements	;vêtement	
quatre-heures	,goûter	
facteur	,courrier	
entreprendre	,entreprise	
menuisier	,meuble	
se fonder	,fondement	
interdire	,interdit	
multiplier	,multiplicande	
réalisateur	,film	
plein	,réservoir	
nationalisme	,nation	
réussir	,réussite	
ministère	,ministre	,ministre	
lavage	,linge	,linge	,linge	
otage	,ravisseur	,ravisseur	
contenant	,contenu	
priseuse	,tabac	
équivalent	,équivalent	
pension	,pensionné	,pensionnée	
rivière	,course	
jouer	,sport	,instrument	,rôle	
escalader	,obstacle	
emboucher	,instrument à vent	
billet	,spectacle	
criminel	,crime	
juger	,accusé	,accusée	
restaurant	,repas	,plat	
tapis	,sport	
mot	,langue	
visiter	,hôte	,hôte	,hôtesse	
portée	,mère	
représenter	,représentation	
imposer	,contribuable	,contribuable	
menuisière	,meuble	
promenade	,lieu	
bétail	,éleveur	,éleveuse	
miracle	,miraculé	,miraculée	
débiteur	,créancière	,créancier	
messe	,fidèle	
erreur	,erreur	
soulevé	,sentiment	
aidé	,aide	,aide	
purée	,pomme de terre	
honte	,honte	
impôt	,contribuable	,contribuable	
dégager	,enveloppe	
>>>	S_1^usual
coiffer	,coiffeur	,coiffeuse	
judo	,judoka	,judoka	,judokate	
traduction	,traducteur	,traductrice	
poule	,éleveur	,éleveuse	
opéra	,cantatrice	,chanteur	,chanteuse	
naviguer	,navigateur	,navigatrice	
oignon	,cultivateur	,cultivatrice	
toilettage	,toiletteur	,toiletteuse	
nettoyer	,nettoyeuse	,nettoyeur	,chirurgien	,chirurgienne	,nettoyeur	,nettoyeuse	
habiller	,habilleur	,habilleuse	
violence	,violent	
ring	,boxe	,catch	
apiculture	,apiculteur	,apicultrice	
lessive	,laveuse	,lavandière	
goûter	,goûteur	,goûteuse	
blague	,blagueur	,blagueuse	
électronique	,électronicien	,électronicienne	
dépanner	,dépanneur	,dépanneuse	
porte	,meuble	
drame	,dramaturge	,dramaturge	
colère	,coléreuse	,coléreux	,colérique	,colérique	
riz	,riziculteur	,rizicultrice	
pois	,cultivateur	,cultivatrice	
effiler	,coiffeur	,coiffeuse	
raccommoder	,raccommodeur	,raccommodeuse	
piste	,disque	
porc	,éleveur	,éleveuse	;porcher	,porchère	
semoule	,semoulier	
champ	,paysan	,agriculteur	,agricultrice	,paysanne	
ronflements	,ronfleur	,ronfleuse	
démonter	,démonteur	,démonteuse	
se résigner	,résigné	,résignée	
fabriquer	,fabricant	,fabricante	
publicité	,publicitaire	,publicitaire	
vilain	,vilain	,vilaine	
péter	,péteur	,péteuse	
frileux	,frileux	,frileuse	
filet	,pêcheur	,pêcheuse	
museau	,arme à feu	
pleurer	,pleureur	,pleureuse	
préparer	,cuisinier	,cuisinière	
enthousiasme	,enthousiaste	,enthousiaste	
mine	,mineur	
station-service	,pompiste	
piano	,pianiste	,pianiste	
toilette	,toiletteur	,toiletteuse	
installer	,installateur	,installatrice	
poulet	,éleveur	,éleveuse	
diagnostic	,diagnosticien	,diagnosticienne	,diagnostiqueur	,diagnostiqueuse	
masser	,masseur	,masseuse	
navigation	,navigateur	
camping	,campeur	,campeuse	
imprimerie	,imprimeur	
basket	;joueur	,joueuse	,basketteur	,basketteuse	
écrire	,écrivaine	,écrivain	
marchandise	,marchand	,marchande	
flûte	,flûtiste	,flûtiste	
brosser	,peintre	,peintre	
consommer	,consommateur	,consommatrice	
anxiété	,anxieux	,anxieuse	
lavage	,laveur	,laveuse	
planche	,bois	
tableau	,peintre	,peintre	
enseignable	,enseignant	,enseignante	
cheval	,éleveur	,éleveuse	
gueuler	,gueulard	,gueularde	
guichet	,guichetier	,guichetière	
éruptif	,volcan	
portrait	,portraitiste	,portraitiste	
football	;joueur	,joueuse	,footballeur	,footballeuse	
>>>	A_2
observer	,observé	
décevoir	,déçu	
exporter	,exporté	
considération	,considéré	
savoir	,su	,su	
parfumer	,parfumé	
préoccuper	,préoccupé	
éprouvé	,éprouvant	
serrer	,serré	
former	,formé	
profit	,profitable	
victoire	,vaincu	
employer	,employé	
conserver	,conservé	
essouflant	,essouflé	
déchirer	,déchiré	
décalage	,décalé	
occuper	,occupé	,occupé	
raisonner	,raisonné	
intention	,intentionnel	
pension	,pensionné	
essouflé	,essouflant	
défaite	,gagnant	;vainqueur	;victorieux	
étouffer	,étouffé	
réfléchir	,réfléchi	
chiffre	,chiffré	
s’appauvrir	,appauvrissant	
gonfler	,gonflé	
bénévolat	,bénévole	
sinistre	,sinistré	
agresser	,agressé	
consentir	,consenti	
génération	,générateur	
poison	,empoisonné	
livrer	,livrable	
schéma	,schématique	
tissu	,musculaire	
vents	,à	
couleurs	,à	
remplir	,rempli	
éclairer	,éclairé	
électricité	,électrique	
lac	,noyé	
fracture	,fracturé	
tache	,taché	
attrait	,attrayant	
accusation	,visé	,en butte	
rassurer	,rassuré	
air	,sur	
héliporter	,héliporté	
cercueil	,mort	
devoir	,dû	
encombrer	,encombré	
épreuve	,éprouvé	
éblouir	,ébloui	
faute	,fautif	
recouvrir	,recouvert	,recouvert	
habitation	,habité	
surveiller	,surveillé	
désirer	,désirable	
électronique	,électronique	
se distraire	,distrayant	
occupation	,occupé	
conservation	,conservé	
supplément	,supplémentaire	
exploiter	,exploité	
débat	,en	
disputer	,disputé	
composer	,composé	
sport	,sportif	
>>>	S_0Pred
impair	,imparité	
accessible	,accessibilité	
tendre	,tendreté	
raciste	,racisme	
silencieux	,silence	
étanche	,étanchéité	
élégant	,élégance	,élégance	
transpirant	,transpiration	
contradictoire	,contradiction	
distingué	,distinction	
mère	,maternité	
méchant	,méchanceté	
fertile	,fertilité	
dynamique	,dynamisme	
autonome	,autonomie	
calme	,calme	
débrouillard	,débrouillardise	
parfait	,perfection	
fade	,fadeur	
tiède	,tiédeur	
innocent	,innocence	
vrai	,vérité	
clair	,clarté	
proche	,proximité	
nul	,nullité	
chaud	,chaleur	
patient	,patience	
sapide	,sapidité	;goût	
capable	,capacité	
différent	,différence	
convaincu	,conviction	
immortel	,immortalité	
dangereux	,dangerosité	
toxique	,toxicité	
probable	,probabilité	
raide	,raideur	
léger	,légèreté	
anonyme	,anonymat	
vacant	,ardeur	
gratuit	,gratuité	
libre	,liberté	
stable	,stabilité	
fluvial	,fluvialité	
adroit	,adresse	
réel	,réalité	
franc	,franchise	
objectif	,objectivité	
éligible	,éligibilité	
urgent	,urgence	
mécontent	,mécontentement	
incompréhensible	,incompréhensibilité	
tolérant	,tolérance	
policier	,police	
majeur	,majorité	
frileux	,frilosité	
abattu	,abattement	
épais	,épaisseur	
banal	,banalité	
responsable	,responsabilité	
ivre	,ivresse	;coup dans le nez	
fréquent	,fréquence	
jeune	,jeunesse	
fidèle	,fidélité	
rare	,rareté	
saleté	,sale	
doux	,douceur	,douceur	
inconscient	,inconscience	,inconscience	
égal	,égalité	
lâche	,lâcheté	
discipliné	,discipline	
>>>	S_1^prototyp
déchirer	,éclair	;cri	
pare-brise	,véhicule	
pinceau	,poil	,poil	
analogie	,organe	
braguette	,pantalon	
baril	,pétrole	
flash	,appareil photo	
objectif	,appareil photo	
poil	,tapis	,brosse	,pinceau	,pinceau	
paragraphe	,texte	
centime	,euro	
se signer	,catholique	,catholique	
nager	,poisson	
escalope	,bœuf	,veau	;poulet	
mie	,pain	
amont	,fleuve	,rivière	
ramper	,reptile	
tremper	,crime	,crime	
émetteur	,antenne	
nettoyer	,nettoyeur	
discothèque	,client	,cliente	
tour	,château	
apprendre	,enseignant	,enseignante	,professeur	,professeure	,instituteur	,institutrice	,maître	,maîtresse	;instructeur	,instructrice	;formateur	,formatrice	
cigarette	,pantalon	;robe	;jupe	;jean	
caserne	,pompier	
flocons	,céréales	
abbaye	,religieuse	,religieux	
cravate	,drapeau	
dentifrice	,tube	;pâte	,gel	;poudre	,eau	,élixir	
goûter	,enfant	,enfant	
pelouse	,parc	
flocon	,laine	
croasser	,corbeau	,corbeau	
spirale	,cahier	
moustique	,catégorie	,poids	
majorité	,électeur	,électrice	
bateau	,chaussures	;col	;lit	
skis	,motoneige	;véloski	
petit chien	,maman	
cours	,fleuve	,rivière	
bouse	,vache	
aube	,religieux	
remboursable	,dette	
cadran	,montre	
nombril	,égoïste	,égoïste	
rouler	,tonnerre	;tambour	
passerelle	,bateau	
galop	,cheval	
seins	,femme	
avoir	,propriétaire	,propriétaire	
pompes	,cérémonie	
marcher	,appareil	;véhicule	
double	,fenêtre	
répertoire	,musicien	,musicienne	
tonnerre	,applaudissements	
serrure	,valise	,porte	,coffre	,armoire	
élément de langage	,communicant	
galoper	,cheval	
condamner	,juge	
pont	,bateau	
fruitier	,arbre	
cendre	,cigarette	,cigare	,cigarillo	
bonnet	,soutien-gorge	
chapitre	,livre	
souligné	,mot	
maillot	,sportif	,sportive	,nageur	,nageuse	,nageur	,nageuse	
vélo	,cyclotouriste	,cyclotouriste	
poignet	,chemise	,chemisier	
tempête	,neige	;vent	;grêle	;pluie	
couvent	,moine	,religieux	,religieuse	
>>>	Contr
genre	,nombre	
motrice	,voiture	
veille	,lendemain	
longueur	,largeur	,hauteur	,profondeur	
nuque	,gorge	
cuillère	,couteau	,fourchette	
nerf	,muscle	
après-demain	,avant-hier	
ouest	,est	
volant	,rampant	
volé	,voleur	
chaussures	,chaussons	
long	,large	
rampant	,volant	
sud	,nord	
face	,pile	
fenêtre	,porte	
expliquer	,comprendre	
verglas	,neige	
minuit	,midi	
à la rame	,à la voile	
jeunesse	,vieillesse	
chant	,parole	
sortie	,entrée	
matin	,soir	
été	,hiver	
vaches grasses	,vaches maigres	
chaussons	,chaussures	
bruit	,silence	
croûte	,mie	
arrière-petit-fils	,arrière-petite-fille	
arriver	,partir	
ovale	,rond	
chiquer	,priser	
maintenant	,après	,avant	,plus tard	
bonjour	,au revoir	
personnel	,direction	,patronat	
répondre	,demander	
femelle	,mâle	
ceinture	,bretelles	
seul	,ensemble	
audio	,vidéo	
matière	,esprit	,âme	;forme	
maritime	;aérien	
dos	,poitrine	
hiver	,été	
aérien	;aquatique	,marin	;maritime	
Enfer	,paradis	;purgatoire	
bâbord	,tribord	
violon alto	,violon	
tonnerre	,éclair	
cigare	,cigarette	;pipe	
paradis	,Enfer	;purgatoire	
tactique	,stratégique	
vouvoiement	,tutoiement	
droitier	,gaucher	,gaucher	
mon	,ton	
éliminatoire	,finale	
fesses	,seins	
pile	,face	
maître	,esclave	
véhicule	,deux-roues	
nombre	,genre	
se coucher	,se lever	
éclair	,tonnerre	
première	,dernière	
avenue	,boulevard	
appartement	,maison	
chercher	,trouver	
dent	,griffes	
>>>	Gener
réalisateur	,professionnel	;profession	
fierté	,sentiment	
veau	,bovin	,viande	,cuir	
miel	,aliment	,couleur	
juillet	,mois	
septembre	,mois	
joaillier	,artisan	
velours	,tissu	
alcool à brûler	,alcool	
corvidés	,animal	
cravate	,pièce d’habillement	,pièce d’habillement	
rhume	,maladie	
trompette	,instrument à vent	,instrument de musique	,musicien	
serpent	,reptile	
mange-tout	,légume	
marteau	,outil	
proférer	,dire	
jupette	,vêtement	
siècle	,période	
route	,voie	
poussin	,oiseau	,oiseau	
grippe	,maladie	
marais	,plan d’eau	
ressentiment	,sentiment	
allée	,voie	
aversion	,sentiment	
reine	,insecte	
calcul	,discipline	
football canadien	,sport	
pantalon	,vêtement	
éléphant de mer	,animal	
moineau	,oiseau	
polygone	,figure	
chope	,boisson	
aiguisoir	,outil	
bidon	,contenant	
baggy	,vêtement	
étang	,plan d’eau	
industrie	,secteur	
vérifieur	,machine	
réservoir	,récipient	
gilet	,vêtement	,vêtement	
cacao	,graine	,boisson	
vachette	,bovin	
canal	,cours d’eau	
cœur	,organe	,couleur	
galerie	,voie	
amour	,sentiment	
fourmi	,insecte	,insectes	
cycliste	,vêtement	
football australien	,sport	
savon blanc	,savon	,savon	
saucisse	,charcuterie	
causette	,échange verbal	
nièce	,parente	
salle	,construction	
tombeau	,monument	
carafe	,pièce de vaisselle	
estomac	,organe	
douze	,nombre	
rectangle	,forme	,figure	
sentier	,voie	
géranium	,plante	
robe-tablier	,vêtement	
daim	,animal	,cuir	
canard	,oiseau	,viande	,son	,avion	
Japon	,pays	
tornade	;sinistre	
fourche	,outil	
chaise haute	,chaise	
>>>	S_loc
environnement	,Terre	
oiseau	,nid	
fleuve	<lit	
ski	,piste	;station	
nager	,piscine	;cours d’eau	;étang	,lac	,mer	,océan	;piscine	
course	,champ de course	
citron	,citronnier	
imprimer	,imprimerie	
laver	,lavoir	,laverie	,buanderie	,buanderie	,lavomatique	,douche	,lavabos	,salle de bain	,salle d’eau	,salle de douche	
ananas	,ananas	
orange	,oranger	
banane	,bananier	
valises	,yeux	;visage	
chien	,niche	
sortir	,sortie	
coiffeur	,salon	
coton	,cotonnier	
bandit	,repaire	
sandwich	,sandwicherie	
repas	,salle à manger	;cantine	;restaurant	
père	,couvent	
noix	,noyer	
pomme	,pommier	
basket	,terrain	
cerise	,cerisier	
corail	,mer	
haleine	,bouche	
olive	,olivier	
prisonnier	,prison	
plein	,station-service	
emprisonner	,prison	
enterrer	,cimetière	
boulanger	,fournil	
moustique	,marais	,mare	,marécage	
gymnastique	,salle	;gymnase	,salle	;gymnase	
framboise	,framboisier	
raisin	,vigne	
camper	,camping	
assiette	,assiette	
guêpe	,nid	,guêpier	
judo	,tapis	,tatami	;dojo	,salle	
rideau	,scène	
gazon	,pelouse	
corbeau	,nid	,nid	
citadine	,ville	
karaté	,tapis	,tatami	;dojo	,salle	
emprisonné	,prison	
Belgique	,en	
coiffeuse	,salon	
exemple	,exemplier	
rugby	,terrain	;stade	
mère	,couvent	
se laver	,salle de bain	,salle de douche	,salle d’eau	
figure	,dans	,en plein	
boxeur	,ring	
aube	,matin	
prune	,prunier	
noisette	,noisetier	
doucher	,douche	;salle de bain	,salle de douche	
bœuf	,étable	
sport	,salle	;terrain	;palais des sports	
pompier	,caserne	,caserne	
lait	,seins	
diable	,Enfer	
cadavre	,cercueil	,bière	
amande	,amandier	
curé	,cure	;paroisse	
cheval	;box	
éléphant de mer	,mer	
se doucher	,douche	,salle de douche	;salle de bain	
>>>	Cf
gorge	,ventre	
soi	,moi	
disque	,rond	;plat	
couché	,assis	,endormi	,assis	
ordinaire	,habitude	
avocat	,juriste	
ingambe	,jambes	
parquet	,plancher	
analogie	,métaphore	
fête	,anniversaire	
plateau	,plaine	,montagne	,vallée	
allumette	,briquet	
T.G.V.	,corail	,TER	
frelon	,guêpe	
vapeur	,buée	
être	,avoir	
thé	,café	;tisane	
géranium	,pélargonium	
cravate	,nœud papillon	,écharpe	
urine	,excréments	
précaution	,prévention	
rivière	,voie navigable	
tramway	,métro	;chemin de fer	
bar	,pression	
tasse	,verre	,verre	
billet	,argent	
manger	,boire	
anniversaire	,fête	
triple	,double	,double	
frère	,sœur	
do	,ré	,mi	,fa	,sol	,la	,si	
arbre	,buisson	
escargot	,limace	
allonger	,asseoir	
cœur	,carreau	
chaîne	,collier	
moi	,soi	
buée	,vapeur	
source	,eau	
bœuf	,bœuf	,vache	
serviette	,nappe	,tampon	
iceberg	,glaçon	
lièvre	,lapin	
viennoiserie	,pâtisserie	
minute	,seconde	
feu	,fumée	
sien	,mien	
assiette	,plat	
course	,marche	
tendon	,muscle	
prémolaire	,molaire	
foudre	,orage	;tonnerre	
gras	,graisse	
gramme	,kilogramme	,kilo	;tonne	
susceptibilité	,colère	
assis	,couché	,couché	
ré	,do	,mi	,fa	,sol	,la	,si	
shampooing	,savon	
dizaine	,dix	
poumons	,poitrine	
poêle	,casserole	
fromage blanc	,yaourt	
timbre	,son	,cloche	
testicule	,partie	
mission	,devoir	
houle	,vague	
crapaud	,grenouille	
nœud papillon	,cravate	
biscotte	,tartine	
miel	,gelée royale	
>>>	Mult
employé	,personnel	
loi	,code	
os	,ossature	,squelette	
gendarme	,gendarmerie	
client	,clientèle	
membre	,membrure	,groupe	
radis	,botte	
poisson	,banc	
banane	,régime	
patron	,patronat	
poil	,pelage	
homme	,humanité	
tabouret	,rangée	
chèvre	,troupeau	
chèque	,carnet	,chéquier	
appareil	,appareillage	
chaussures	,paire	
famille	,mafia	
fleur	,grappe	
marche	,escalier	,marches	
ciseaux	,paire	
pétales	,corolle	
arme	,armement	
fauteuil	,rangée	
meuble	,mobiler	
pièce de vaisselle	,vaisselle	
poireau	,botte	
pin	,pinède	,pineraie	,pinière	
lettre	,correspondance	
navire	,flotte	,flottille	
poussin	,couvée	
fiche	,fichier	
voyou	,bande	,gang	,horde	
comprimé	,boîte	
mouche	,nuage	,nuée	
carte	,jeu	
mouton	,troupeau	,cheptel	
saleté	,saleté	
employée	,personnel	
vents	,ensemble	
assiette	,pile	
punaise	,colonie	
chaussons	,paire	,paire	
terme	,terminologie	
musicien	,ensemble	,groupe	
ministre	,gouvernement	,ministère	,cabinet	
corbeau	,bande	,colonie	;nuée	,bande	,colonie	;nuée	
jumelle	,jumelles	
lion	,bande	
saucisse	,chapelet	
cerise	,poignée	
muscle	,musculature	
rabbin	,rabbinat	
pompier	,caserne	,caserne	
dent	,dentition	,denture	,dentelure	
musicienne	,ensemble	,groupe	
verre	,bouteille	
fruit	,grappe	
loup	,bande	,horde	,meute	
guêpe	,colonie	,essaim	,horde	;nuage	,nuée	
vache	,troupeau	;cheptel	
chien	,horde	,meute	
bandit	,bande	,gang	,horde	
paysanne	,paysannat	,paysannerie	
chiffon	,tas	
sous-vêtement	,sous-vêtement	
siège	,rangée	
criminel	,bande	,gang	,mafia	,milieu	,pègre	
chaise	,rangée	
nuage	,masse	,entassement	
>>>	Sing
cheveu	,cheveu	
crème	,pot	
karaté	,combat	<compétition	,tournoi	<championnat	
crinière	,cheveu	
sable	,grain	
crime	,crime	;crime	
gendarmerie	,gendarme	,gendarme	,gendarmette	
maïs	,grain	<boîte	
gâteau	,part	,tranche	
sucre	;grain	<cuillerée	,pincée	;morceau	,sucre	<pain	
mayonnaise	,pot	
code	,loi	
bière	,bouteille	,verre	,bière	,canette	,chope	,demi	<pinte	
mayo	,pot	
beurre	,noisette	,noix	;motte	
vin	,verre	<bouteille	
toison	,cheveu	
alcool	,verre	<bouteille	
treize	,joueur	
parc	,arbre	;pelouse	;allée	
farine	;sac	
riz	,grain	
opéra	,air	
cheveux	,cheveu	
billard	,jeu	,partie	
lentilles	,boîte	
neige	,flocons	;boule	
ski	,championnat	,compétition	
flottille	,bateau	
saleté	,saleté	
ail	<gousse	<tête	<botte	
savon	;bloc	,bout	,goutte	,morceau	,pain	,savon	
sueur	,goutte	
appareillage	,appareil	
mois	,semaine	<jour	
football	,match	,partie	,football	<compétition	,tournoi	<championnat	
moutarde	,pot	,verre	
pain	,miette	<bout	,morceau	,tranche	
branchage	,branche	
volley-ball	,match	,partie	,volley-ball	<compétition	,tournoi	<championnat	
pluie	,gouttelette	<goutte	
escalier	,marche	
sauciflard	,rondelle	
ping-pong	,match	,partie	,ping-pong	<compétition	,tournoi	
rôti	,tranche	
chéquier	,chèque	
laser	,rayon	
rabbinat	,rabbin	
saucisse sèche	,rondelle	
raisin	,grain	
correspondance	,lettre	
clientèle	,client	,cliente	
tramway	,ligne	
basket	,match	,partie	,basket	<compétition	,tournoi	<championnat	
boxe	<combat	,match	<compétition	,tournoi	<championnat	
dentition	,dent	
mobiler	,meuble	
yaourt	,pot	,yaourt	<boîte	
denture	,dent	
klaxon	,coup	
laitue	,feuille	
sel	,grain	
saucisson	,rondelle	
chevelure	,cheveu	
lessive	,cuillère	,dose	,poignée	;dosette	,pastille	<baril	,boîte	
marches	,marche	
tennis	,match	,partie	,tennis	<compétition	,open	,tournoi	
champagne	,verre	
feuillage	,feuille	
pelage	,poil	
>>>	Syn_⊂^sex
débitante	,débitant	
inconnue	,inconnu	
citatrice	,citateur	
ouvrière	,ouvrier	
passionnée	,passionné	
menteuse	,menteur	
baigneuse	,baigneur	
condamnée	,condamné	
attaquante	,attaquant	,attaquant	
belligérante	,belligérant	
douanière	,douanier	
Indienne	,Indien	
informaticienne	,informaticien	
impératrice	,empereur	
célibataire	,célibataire	
montreuse	,montreur	
messagère	,messager	
pêcheuse	,pêcheur	
médecin légiste	,médecin légiste	
alcoolo	,alcoolo	,alcoolique	
responsable	,responsable	
soiffarde	,soiffard	
gendarmette	,gendarme	
fuyarde	,fuyard	
optimiste	,optimiste	
politicarde	,politicard	
inconsciente	,inconscient	
invitée	,invité	
médecin-expert	,médecin-expert	
provocatrice	,provocateur	
volontaire	,volontaire	
lice	,chien de chasse	
compétitrice	,compétiteur	
Chinoise	,Chinois	
châtelaine	,châtelain	
balayeuse	,balayeur	
emprunteuse	,emprunteur	
députée	,député	
perdante	,perdant	
administrée	,administré	
papetière	,papetier	
colérique	,colérique	
enquêteuse	,enquêteur	
méchante	,méchant	
toubib	,toubib	
médecin	,médecin	
vendeuse	,vendeur	
skieuse	,skieur	
athlète	,athlète	
soldate du feu	,soldat du feu	
éducatrice	,éducateur	,éduc	
chrétienne	,chrétien	
assoiffée	,assoiffé	
tricheuse	,tricheur	
couturière	,couturier	
hôtesse	,hôte	
Occidentale	,Occidental	
orthodontiste	,orthodontiste	
journaleuse	,journaleux	
collégienne	,collégien	
organisatrice	,organisateur	
continentale	,continental	
panseuse	,panseur	
participante	,participant	
barmaid	,barman	
compatriote	,compatriote	
médecin-major	,médecin-major	
hospitalisée	,hospitalisé	
gagnante	,gagnant	
pirate	,pirate	
