>>>	Syn_∩
récit	,exposé	
actif	,sur les dents	,travailleur	,dynamique	,efficace	,bien	
largesse	,générosité	
cheval de bataille	,sujet	
s’introduire	,entrer	
illusoire	,irréel	
se serrer	,se rapprocher	
sucrer les fraises	,vieillir	
prince charmant	,chevalier servant	,amoureux	
se taire	,cesser	,ne pas desserrer les dents	
libéré	,libre	,verser	
flâner	,se promener	,se balader	
diluer	,allonger	
pot de chambre	,pot	
touffe	,brosse	
du coup	,si bien	
grondement	,grognement	
réputé	,renommé	,déclaré	
personnellement	,en personne	,soi-même	,nommément	,nominalement	
taxe	,impôt	
défoncer	,enfoncer	
manuel	,à la main	;à main	
fourrure	,pelage	
précocement	,tôt	,vite	
se révolter	,s’opposer	,ruer dans les brancards	
corrompu	,malhonnête	
écouter	,entendre	,obéir	,se soumettre	
faussement	,fautivement	
volcan	,champ de mines	,poudrière	,geyser	;festival	
se creuser	,se dessiner	
mouton noir	,brebis galeuse	
exagérer	,pousser	,pousser le bouchon trop loin	;tartiner	,en faire des tartines	,en mettre des tartines	,en rajouter	,amplifier	
nostalgie	,regret	,mélancolie	
téléguider	,télécommander	
mine	,tronche	
tout cru	,complètement	
médaille	,collier	,pendentif	,prix	
torse nu	,demi-nu	
nouvelles	,actualités	
colorant	,couleur	,teintant	
autorisation	,bénédiction	
apprivoiser	,domestiquer	
idiote	,cornichonne	,imbécile	
enjôler	,séduire	
relaxer	,reposer	
tonnerre de Dieu	,tonnerre	,destin	,sort	
se faire du cinéma	,s’imaginer	;se faire des illusions	
tête de linotte	,étourdi	,étourdie	
narine	,narines	
stable	,établi	,durable	
>>>	S_0
central	,centre	,centre	
estimer	,estimation	
germanique	,Allemagne	,germanique	
domestique	,maison	
canadien	,Canada	
désespéré	,désespoir	
rafraîchir	,rafraîchissement	
arabe	,Arabie	
urger	,urgence	
mûrir	,mûrissement	
redresser	,redressement	,redressement	
tennistique	,tennis	
espérer	,espoir	,espoir	
plonger	,plongeon	
ciliaire	,cils	
circulaire	,cercle	
contraindre	,contrainte	
terroriste	,terrorisme	
surveiller	,surveillance	
ajouter	,ajout	,ajout	,ajout	
sculpter	,sculpture	,sculptage	
articulatoire	,articulation	
préhistorique	,préhistoire	
eurasien	,Eurasie	
timidement	,timidité	
déchirer	,déchirement	,déchirement	
rampement	,ramper	
buccal	,bouche	
pardonner	,pardon	
sourcilier	,sourcils	
clair	,clair	
hygiéniquement	,hygiène	
continuer	,continuation	
grammairien	,grammaire	
forestier	,forêt	
sourire	,sourire	
saluer	,salutations	
étouffer	,étouffement	
planétaire	,planète	
habituellement	,habitude	
électronique	,électronique	,électron	
orange	,orange	
nocturne	,nuit	
matraquer	,matraquage	
marxiste	,marxisme	
inonder	,inondation	
explorer	,exploration	
plus blanc que blanc	,plus blanc que blanc	,plus blanc que blanc	
diffuser	,diffusion	,diffusion	,diffusion	
allègrement	,allégresse	
>>>	A_2Perf
dresser	,dressé	,vertical	,droit	
salissant	,sale	
neiger	,enneigé	,neigeux	
éplucher	,épluché	
fonder	,fondé	,fondé	
boucher	,bouché	
oublier	,oublié	
dissimuler	,sous le tapis	
déterminer	,déterminé	
promettre	,promis	
indiquer	,indiqué	
insulter	,insulté	
inonder	,inondé	
entendre	,entendu	
voiler	,voilé	
réaliser	,réalisé	
gonfler	,gonflé	
enfermer	,enfermé	
renouveler	,nouveau	
décorer	,décoré	,décoré	
bourrer	,bourré	
hacher	,haché	
plisser	,plissé	
se détendre	,détendu	
attendrir	,attendri	
amputer	,amputé	
prénommer	,prénommé	
plier	,plié	
diminution	,diminué	
appauvrir	,pauvre	
incliner	,incliné	
diplômer	,diplômé	
amuser	,amusé	
domestiquer	,domestique	
restreindre	,restreint	
contraindre	,contraint	
user	,usé	
diminuer	,diminué	
explorer	,exploré	
asseoir	,assis	
habiller	,habillé	,habillé	
menotter	,menotté	
ouvrir	,ouvert	
exercer	,exercé	
encadrer	,encadré	,encadré	
enfoncer	,enfoncé	
étourdir	,étourdi	
égarer	,égaré	
soumettre	,soumis	,soumis	
animer	,animé	,animé	
>>>	Anti
initial	,final	,terminal	
corps composé	,corps simple	
majeur	,mineur	,mineur	,mineur	
réveillé	,endormi	
chaud	,froid	
utile	,inutile	
indirectement	,directement	
politesse	,impolitesse	
mains propres	,mains sales	
approximatif	,exact	,précis	;détaillé	
vieillir	,rajeunir	,rajeunir	
inflammable	,ininflammable	
quelque chose	,rien	
incapacité	,capacité	
levant	,couchant	
charger	,décharger	
accord	,désaccord	
égal	,inégal	,inégal	
incorporel	,corporel	,corporel	
oublier	,se souvenir	,se rappeler	
irrespirable	,respirable	
matériel	,spirituel	
final	,initial	
attentif	,inattentif	
en	,y	
interne	,externe	,externe	
impossible	,possible	
antonyme	,synonyme	,synonyme	
anion	,cation	
bienveillant	,malveillant	
étroit	,large	
intra-	,extra-	
embellir	,enlaidir	,s’enlaidir	,enlaidir	
clair	,foncé	;sombre	
favorablement	,défavorablement	
lier	,délier	
détendre	,tendre	
intelligence	,inintelligence	
indestructible	,destructible	
anti-	,pro-	
équilibre	,déséquilibre	,déséquilibre	
populaire	,impopulaire	
sujet	,objet	,objet	
moins	,plus	
avancer	,reculer	,reculer	
désinstaller	,installer	
désagréable	,agréable	
pousser	,tirer	
contrôlable	,incontrôlable	
déshabiller	,habiller	
>>>	S_res
gonfler	,gonflage	
politique	,fruit	,résultat	
cadrer	,cadre	;photographie	,prise de vue	,cadre	
vieillir	,vieillesse	
réunion	,réunion	
match	,résultat	
étourdir	,étourdissement	
écarter	,écart	,écart	
jugement	,jugement	
chanter	,chant	
érotiser	,érotisme	
coup de foudre	,amour	
dessiner	,dessin	;figure	
observation	,observation	;résultat	
condamner	,condamnation	
effort	,résultat	
déchirer	,déchirure	
mélange	,mélange	,mélange	;mélange	
course	,résultat	
mesurer	,mesure	
enquête	,résultat	,résultat	
lever de soleil	,jour	
trébucher	,chute	
se décaler	,décalage	
négociation	,résultat	
bilan	,bilan	;compte de bilan	,bilan	
abonner	,abonnement	
caresser	,caresse	
opération escargot	,ralentissement	;bouchon	,embouteillage	
tomate	,tomate	
chambouler	,désordre	
scrutin	,résultat	
encadrer	,encadrement	
se couper	,coupure	
coucher de soleil	,nuit	
abonnement	,abonnement	
soustraction	;différence	;résultat	
glaçage	,glaçage	,glaçage	,glaçage	
pluie	,eau	
test	,résultat	
opération	,résultat	,résultat	
épuiser	,épuisement	
critique	,critique	,critique	
évaluation	,résultat	
orienter	,orientation	
addition	,somme	;résultat	
se déplacer	,déplacement	
cracher	,crachat	,crachat	
se fracturer	,fracture	
étude	,résultat	
>>>	Syn_⊃
orpheline	,pupille	
amas	,nuage	
opéra	,maison lyrique	
gamin	,marmot	,marmot	
se positionner	,se ranger	
bovidés	,bœuf	
célébration	,cérémonie	,cérémonie	
jardin	,potager	
patrimoine	,capital	
malfaiteur	,délinquant	,malfrat	,racaille	,voyou	;escroc	,truand	;bandit	,gangster	;brigand	;hors-la-loi	
enseignant	,maître	;enseignant-chercheur	
méfait	,acte criminel	,crime	
potage	,velouté	
avoir froid	,cailler	,geler	,se geler les fesses	
décidé	,convenu	,résolu	
rêve	,cauchemar	
soucoupe	,sous-tasse	
marquer	,aplatir	
faible	,affaibli	,la veuve et l’orphelin	
gelée	,blanc-manger	
naviguer	,louvoyer	
charge	,fardeau	
se soustraire	,échapper	
train	,T.G.V.	,TER	,corail	;express	,omnibus	,rapide	
élément du corps	,partie du corps	
gros	,obèse	
facile	,de la tarte	,du gâteau	
étendue d’eau	,pièce d’eau	,plan d’eau	
laid	,vilain	
individu	,spécimen	
fumer	,cloper	;crapoter	
terrain	,court	,lopin	
vent	,air	
alcool	,alcool	;alcool	
mère	,maman	,mémère	,maman	
munitions	,balle	,cartouche	
abandon	,cession	
pente	,côte	
cellule familiale	,famille	
dessous	;soutien-gorge	;culotte	;bas	
crier	,hurler	,hurler	,hurler	
se fourrer	,se blottir	
communication	,parole	
main	,menotte	,mimine	;paluche	,pogne	;main droite	,main gauche	;poing	,main droite	,main gauche	,adresse	
chanteur	,choriste	
sale	,cracra	,crade	,cradingue	,crado	,cradoque	,craspec	,crasseux	<dégueulasse	,dégueu	,crade	,crado	,cradoque	,crasseux	<dégueulasse	,dégueu	,cracra	,crade	,cradingue	,crado	,cradoque	,crasseux	,dégueu	,dégueulasse	,cracra	,crade	,cradingue	,crado	,cradoque	,craspec	,crasseux	<dégueulasse	,dégueu	,cracra	,crade	,cradingue	,crado	,cradoque	<dégueulasse	,dégueu	,crade	,cradingue	,crado	,cradoque	,craspec	<dégueulasse	,dégueu	,cracra	,crade	,cradingue	,crado	,cradoque	,craspec	<dégueulasse	,dégueu	,dégueulasse	,dégueu	
tornade	,trombe	
tordu	,crochu	
boire	,siroter	;lamper	,s’enfiler	,siffler	,caresser la bouteille	
liquide	,boisson	
>>>	S_1
bagages	,voyageuse	,voyageur	
polluer	,polluant	
vacances	,vacancier	;vacancière	
environnement	,humain	
carie	,dent	
inventer	,inventeur	,inventrice	
exporter	,exportateur	
grignoter	,grignoteur	,grignoteuse	
voler	,pilote	;aviateur	,aviatrice	,voyageur	,voyageuse	;passager	,passagère	,voleur	,voleuse	,voleur	,voleuse	,voleur	,voleuse	
vote	,votant	,votante	;électeur	,électrice	
chipoteur	,chipoteur	,chipoteuse	,chipoteur	,chipoteuse	,chipoteur	,chipoteuse	
fume-cigarette	,fumeur	,fumeuse	
poirier	,poire	
jazz	,jazzman	,jazzwoman	
fusil	,tireur	,tireuse	
acheter	,acheteuse	,acheteur	
télévision	,téléspectateur	,téléspectatrice	
mode de transport	,usager	,usagère	
islam	,musulman	,musulmane	
vélo	,cycliste	,cycliste	,cycliste	,cycliste	
écouter	,écouteur	
bavarder	,bavard	,bavarde	
flotte	,bateau	
billet	,spectateur	,spectatrice	;visiteur	,visiteuse	
débuts	,débutant	,débutante	
réalisé	,réalisation	
distraire	,distraction	
suspense	,suspense	,auteur	,auteure	
ramadan	,musulman	,musulmane	
grain	,plante	
affirmation	,affirmateur	
orbiter	,satellite	
domestique	,mouche	,moineau	,plante	
orgue	,organiste	
à décorner les cocus	,vent	
mammifère	,mammifères	
adopter	,adoptant	,adoptante	
cotonnier	,coton	
médiéval	,médiéval	
aryténoïde	,cartilage	
affiché	,affiche	
cadavre exquis	,joueur	,joueuse	
écorce	,arbre	
réfléchissant	,surface	
danser	,danseuse	,danseur	;danseur	,danseuse	
concevoir	,concepteur	,conceptrice	
mot doux	,amoureux	,amoureuse	
accompagner	,accompagnateur	,accompagnatrice	,accompagnement	,accompagnatrice	,accompagnateur	
cratère	,volcan	
noblesse	,noble	
>>>	Conv_21
toucher	,connaître	
visiter	,recevoir	
affaiblir	,s’affaiblir	
adoptif	,adoptif	,adoptif	
alimenter	,marcher	
colorer	,se colorer	
amuser	,s’amuser	
marcher	,faire	,alimenter	
s’affoler	,affoler	
désespérer	,désespérer	,désespérer	,se désespérer	
résultat	,cause	
quand bien même	,bien que	
alors	,car	
subir	,transformer	
désintéresser	,se désintéresser	
se passionner	,passionner	
au-dessus	,au-dessous	
intéresser	,s’intéresser	
tenir	,maintenir	,tenir	,tenir	
postérieur	,antérieur	
maintenir	,tenir	
donc	,car	
connaître	,toucher	
abriter	,s’abriter	
antérieur	,postérieur	
à droite	,à gauche	
partir	,avoir	
appauvrissement	,appauvrissement	,appauvrissement	
se coucher	,coucher	,coucher	,coucher	,coucher	
car	,donc	,en conséquence	,par conséquent	
couvrir	,se couvrir	
recevoir	,visiter	
au-dessous	,au-dessus	
coucher	,se coucher	,se coucher	,se coucher	,se coucher	
renverser	,passer	
en dessus	,en dessous	
cadet	,aîné	
à gauche	,à droite	
en conséquence	,car	
affoler	,s’affoler	
se désoler	,désoler	
s’agacer	,agacer	
s’inquiéter	,inquiéter	
sensible	,sensible	,sensible	
en dessous	,en dessus	
alarmer	,s’alarmer	
piquer	,se piquer	,piquer	,piquer	
manger la laine sur le dos	,se laisser bouffer	
s’abriter	,abriter	
posséder	,appartenir	
>>>	A_0
ongles	,ongulaire	
futur	,futur	
île	,insulaire	
cils	,ciliaire	
critique	,critique	
politiquement	,politique	,politique	
ONU	,onusien	
catholicisme	,catholique	
politique	,politique	,politique	
mobiler	,mobilier	
courbe	,courbe	
beige	,beige	
gratuitement	,gratuit	
soustraire	,soustractif	
interrogativement	,interrogatif	
cinématographiquement	,cinématographique	
tragédie	,tragique	,tragique	
ministre	,ministériel	
désolation	,désolé	
citoyen	,citoyen	
préhistoire	,préhistorique	
précédemment	,précédent	
silencieusement	,silencieux	
trimestre	,trimestriel	
odorat	,olfactif	
individu	,individuel	
théorie	,théorique	
Lyon	,lyonnais	
fruit	,fruitier	
nager	,natatoire	
mouton	,ovin	
marbre	,marbrier	
chair	,charnel	
monument	,monumental	
Corée	,coréen	
Phocée	,phocéen	
allemand	,allemand	
orthophonie	,orthophonique	
volcan	,volcanique	
russe	,russe	
cheval	,chevalin	,équin	
diaboliquement	,diabolique	
sentimentalité	,sentimental	
cerveau	,cérébral	
instinct	,instinctif	
homosexualité	,homosexuel	
rythme	,rhytmique	
estomac	,stomacal	,gastrique	
entrepreneuriat	,entrepreneurial	
nation	,national	
>>>	Able_1
anglais	,anglophone	
portugais	,lusophone	
avoir ses limites	,limité	
dommages	,dommageable	
réaction	,réactif	
sport	,sportif	
s’enflammer	,inflammable	
éducation	,éducable	
angoisse	,angoissé	
déplacement	,mobile	
absorber	,absorbant	
étouffer	,étouffant	
questionner	,questionneur	
changer	,changeant	
compensation	,compensatoire	
permettre	,permissif	
russe	,russophone	
se casser	,cassant	
autorité	,autoritaire	
en imposer	,imposant	
cogner	,cogneur	
entreprendre	,entreprenant	
se suicider	,suicidaire	
s’emporter	,coléreux	,colérique	,soupe au lait	
exciter	,excitant	
causer	,causant	,causeur	
bavarder	,bavard	
crainte	,craintif	
chipoter	,chipoteur	,chipoteur	,chipoteur	
colère	,coléreux	,colérique	
coopération	,coopératif	
réagir	,réactif	
accélérer	,accélérateur	
voleur	,voleur	
astuce	,astucieux	
espagnol	,hispanophone	
partager	,partageur	
exploser	,explosible	
rouler	,roulant	
ramper	,rampant	,rampant	
distraire	,distrayant	
risque	,risqué	
combattre	,combattant	
rire	,rieur	
aventure	,aventureux	,aventurier	
épouvanter	,épouvantable	
obéir	,obéissant	
tracasser	,tracassier	
s’épuiser	,épuisable	
jouer	,joueur	
>>>	Able_2
nausée	,nauséeux	
communication	,communicable	
ordonner	,ordonnable	
mépriser	,méprisable	
nettoyer	,nettoyable	,nettoyable	,nettoyable	,nettoyable	
honteux	,honteux	
modifier	,modifiable	
douter	,douteux	
maîtriser	,maîtrisable	
débit	,débitable	
imagination	,imaginable	
connaître	,connaissable	
prouver	,prouvable	
libérer	,libérable	
consommer	,consommable	
cultiver	,cultivable	
glisser	,glissant	
définir	,définissable	
boire	,buvable	
attaquer	,attaquable	
s’alarmer	,alarmant	
épouvante	,épouvantable	
respirer	,respirable	
remplacer	,remplaçable	
importer	,importable	
arracher	,arrachable	
calcul	,calculable	
déplier	,dépliable	,dépliant	
ajuster	,ajustable	
paralysie	,paralysant	
attirer	,attirable	
incliner	,inclinable	
comparer	,comparable	
supprimer	,supprimable	
cafard	,cafardeux	
réaliser	,réalisable	
laver	,lavable	,lavable	
voler	,volable	
juger	,jugeable	
compréhension	,compréhensible	
licencier	,licenciable	
participer	,participatif	
prévoir	,prévisible	
exprimer	,exprimable	
vérifier	,vérifiable	
plier	,pliable	,pliant	
partager	,partageable	
remuer	,remuable	
avouer	,avouable	
multiplier	,multipliable	
>>>	Anti_∩
bâcler	,fignoler	,parfaire	,peaufiner	
fragiliser	,renforcer	
dans	,hors	
obésité	,maigreur	
réalité	,idéalité	,illusion	
résigné	,combatif	
dépression	,compression	
verticalement	,couché	,horizontalement	
en herbe	,mûr	
ouvrable	,férié	
parfois	,jamais	,toujours	
mince	,gros	,obèse	
allonger	,rapetisser	,diminuer	,raccourcir	,réduire	,diminuer	,réduire	,abréger	,écourter	,raccourcir	,réduire	,diminuer	,raccourcir	,concentrer	,raccourcir	,replier	
passage	,cul-de-sac	
remonter	,descendre	
lentement	,vite	
atténuant	,aggravant	
inerte	,réactif	
chaleureux	,froid	
à l’abri	,sous	,menacé	
divers	,uniforme	
autour	,loin	
à la diable	,soigneusement	
précédent	,prochain	,prochain	,prochain	
étranger	,autochtone	
levé	,couché	
ici	,nulle part	,nulle part	
s’activer	,ne pas lever le petit doigt	
ressemblance	,différence	,dissimilitude	,dissemblance	,dissimilarité	,dissemblance	
à l’envers	,à l’endroit	
partie	,totalité	
fragilement	,solidement	
marcher sur la tête	,tourner rond	
anonyme	,connu	
rareté	,profusion	,fréquence	
rapide	,long	,récent	,omnibus	
coup d’accélérateur	,coup d’arrêt	
jamais	,parfois	
gonflé	,dégonflé	
quitter	,arriver	,conserver	
arrangeant	,têtu	
retrouver ses jambes de vingt ans	,ne plus avoir de jambes	
bande de circulation	,bande d’arrêt d’urgence	
étrangère	,autochtone	
ne pas avoir de seins	,y avoir du monde au balcon	
finir	,abandonner	,interrompre	
tout	,rien	,personne	
poliment	,grossièrement	
avoir le vin [Y]	,tenir	
couple	,célibat	,singleton	
>>>	Real_1
mission	,remplir	
jupe	,avoir	,porter	
œuvre	,œuvrer	
braguette	,fermer	
rouge	,s’arrêter	
camionnette	,conduire	;rouler	
animal	,avoir	,posséder	
balai	,passer	;manier	;jouer	,passer	
glace	,étendre	;étaler	
bêche	,bêcher	
pont	,traverser	
paresse	,faire preuve	;paresser	
verrou	,mettre	
relâche	,faire	
alcool	;consommer	;boire	,picoler	,boire	,picoler	,s’alcooliser	
parfum	,porter	
tarot	,jouer	
hélicoptère	,piloter	
couvercle	,mettre	
tabac	,fumer	;mâcher	,chiquer	;priser	
train	,voyager	,prendre	,assurer	
pompe	,pomper	,pomper	
projectile	,lancer	
klaxon	,actionner	,klaxonner	
tempête	,affronter	,braver	,défier	,lutter	,faire face	
bélier	,enfoncer	
office	,remplir	
lit	,dormir	;se reposer	,couler	
cadenas	,cadenasser	
voie	,passer	,emprunter	,prendre	,faire	;grimper	,gravir	
seins	,donner	,allaiter	,donner le sein	;montrer	,dévoiler	
triangle	,faire	,jouer	
plateau	,porter	;apporter	,transporter	,manger	
couleurs	,afficher	;arborer	,porter	
cercueil	,avaler	,boire	,consommer	,picoler	
épingle	,épingler	
amour	,aimer	
volant	,tenir	;tourner	
affiche	,afficher	
conte de fées	,raconter	
siège	,asseoir	,occuper	,asseoir	,disposer	;occuper	,siéger	,asseoir	,occuper	
ancre	,jeter	
poitrine	,gonfler	,remplir	
Joyeux anniversaire	,chanter	
bifteck	,manger	,gagner	
W.-C.	,utiliser	,occuper	,se servir	
disque	,lancer	
proverbe	,citer	
pédale	,appuyer	,actionner	,appuyer	
chien	,avoir	,posséder	
>>>	V_0
imitation	,imiter	
témoignage	,témoigner	
tentative	,tenter	
éloignement	,s’éloigner	
approbation	,approuver	,approuver	,approuver	
secours	,secourir	
affrontement	,affronter	
tremblement	,trembler	
avalement	,avaler	
groupement	,grouper	
essuyage	,essuyer	
insistance	,insister	
goûter	,goûter	
développement	,se développer	,développer	,développer	,développer	
assurément	,assurer	
collage	,coller	
accomplissement	,accomplir	,s’accomplir	,accomplir	,s’accomplir	
bouleversement	,bouleverser	
inspiration	,inspirer	,inspirer	
réduit à zéro	,réduire à zéro	
boxe	,boxer	
consentement	,consentir	,consentir	
description	,décrire	
encouragement	,encourager	,encourager	
peignage	,peigner	
rot	,roter	
désespoir	,désespérer	,désespérer	
accueil	,accueillir	
prostitution	,se prostituer	
indice	,indiquer	
grossissement	,grossir	
encerclement	,encercler	
barrissement	,barrir	
clapotis	,clapoter	
traçage	,tracer	
bombardement	,bombarder	
défilé	,défiler	,défiler	
résidence	,résider	
illustration	,illustrer	
illumination	,illuminer	
résultat	,résulter	
exaspération	,exaspérer	
adaptation	,s’adapter	
exercice	,exercer	,s’exercer	
frimeur	,frimer	
tirage	,tirer	,tirer	
faim	,avoir faim	;manger des briques à la sauce caillou	
prière	,prier	
anticipation	,anticiper	
soins	,soigner	
>>>	S_3
supérette	,client	,cliente	,clientèle	
bandit	,victime	
admiration	,objet	,source	
boulanger	,client	,cliente	
autopsie	,résultat	
nommer	,nom	;prénom	,nom	
honneur	,honneur	
bijouterie	,client	,cliente	
coup de feu	,arme à feu	
imposer	,impôt	
combat	,sport de combat	
malade	,partie du corps	,maladie	,maladie	
procès	,affaire	
papeterie	,papier	
exposer	,public	
péage	,péagiste	,péagiste	
couvre-feu	,heure	
grandeur	,unité de mesure	
télévision	,téléspectateur	,téléspectatrice	
cuir	,article	
boucher	,client	,cliente	
observer	,observation	
envoi	,destinataire	,destinataire	
se lier	,molécule	
accès	,accès	
addition	,client	,cliente	
menuisière	,bois	
abandonner	,sportif	,sportive	
service	,restaurant	
analogie	,analogie	,point commun	
colis	,destinataire	,destinataire	
drame	,comédien	,comédienne	
juger	,délit	;crime	,jugement	,jugement	;avis	,opinion	
chèque	,bénéficiaire	,bénéficiaire	;porteur	
fonder	,fondement	
empoisonner	,poison	
classe	,classe	
décharger	,chargement	
clinique	,soins	
alimenter	,aliment	
leçon	,élève	,élève	,collégien	,collégienne	,lycéen	,lycéenne	,étudiant	,étudiante	
piocher	,pioche	
somme	,somme	
travailler	,employeur	,employeuse	,patron	,patronne	;employeur	
administrable	,administrateur	
similitude	,similitude	,point commun	
restaurant	,clientèle	;client	,cliente	
emprunté	,emprunteur	,emprunteuse	
similarité	,similarité	,point commun	
loyer	,location	
>>>	A_1
économie	,économe	
se succéder	,successif	
maladroit	,maladroit	
affoler	,affolant	
respect	,respectueux	
vivre	,vivant	
survivre	,survivant	
vie	,vivant	,en	
tardivement	,tardif	
condamnée	,condamné	
ruminants	,ruminant	
pendre	,suspendu	
découragement	,découragé	
s’ébahir	,ébahi	
soif	,assoiffé	
déplacement	,en	,en	
bâtard	,bâtard	
grelotter	,grelottant	
se situer	,situé	
appauvrir	,appauvrissant	
s’orienter	,orienté	
stérilité	,stérile	
réticence	,réticent	
transport	,transporté	
se passionner	,passionné	
frayeur	,effrayé	
moche	,moche	,moche	
zèle	,plein	,rempli	
Sud-Coréen	,sud-coréen	
racisme	,raciste	
pourrir	,pourrissant	
organiser	,organisateur	
moderne	,moderne	,moderne	
goût	,sapide	;à	
ronger	,rongeur	
fluvialité	,fluvial	
ignorer	,ignorant	
précision	,précis	
dangerosité	,dangereux	
Suédoise	,suédois	
encombrer	,encombrant	
Indien	,indien	
remplir	,rempli	
sapidité	,sapide	
ravissement	,ravi	
Irlandaise	,irlandais	
coopérer	,coopérant	
adolescente	,adolescent	
tromper	,trompeur	
singularité	,singulier	
>>>	S_2^prototyp
tête	,liste	,sondage	
sirop	,fraise	,menthe	
élément de langage	,politicien	,politicienne	
chiffon	,poussière	
patiente	,médecin	,médecin	,docteur	,docteure	
envoi	,colis	,lettre	
passage	,passage	,passage	
monopoliser	,antenne	
allonger	,café	,figure	,gueule	,mine	,tête	,tronche	,visage	,bras	;cou	;doigt	;jambes	;main	,coup	
tablette	,chocolat	
casque	,ordinateur	,télévision	,baladeur	
passement	,bras	;jambes	
siège	,ville	
champ	,blé	,formulaire	,arme à feu	
poteaux	,rugby	
position	,yoga	
huile	,mécanisme	,moteur	
piloter	,avion	,avionnette	,hélicoptère	,auto	,automobile	,voiture	;bateau	
conduire	,auto	,moto	,automobile	,train	,voiture	,véhicule	
fondant	,chocolat	
fond de volaille	,sauce	
baguette	,bois	
se cailler	,fesses	,miches	
victime	,maladie	;accident	;catastrophe	
profaner	,tombe	
quai	,gare	;métro	,métro	,train	
amputer	,membre	
cracher	,chewing-gum	
diète	,médecin	,médecin	,docteur	,doctoresse	,docteure	
hold-up	,banque	;bijouterie	;magasin	
fonder	,famille	
porter	,vêtement	;pièce d’habillement	
geler	,salaire	
orbiter	,astre	;étoile	
nappe	,table	
signature	,courriel	
patins	,luge	
nœud	,cravate	
bouchère	,viande	
dépression	;fluide	;gaz	,liquide	
jambe	,porc	;bœuf	
collaborer	,Allemand	
enregistré	,registre	
filet	,tennis	
user ses fonds de culotte	,école	
joue	,bœuf	
cercueil	,cadavre	,corps	,défunt	,défunte	,macchab	,macchabée	,mort	,morte	
débrancher	,wagon	
satellite	,pays	
dresser	,table	,table	
>>>	Syn_⊃^sex
favori	,favorite	
imprimeur	,imprimeuse	
bossu	,bossue	
héritier	,héritière	
misérable	,misérable	,misérable	
chasseur	,chasseuse	;chasseresse	
citoyen	,citoyenne	
malfaiteur	,malfaitrice	
joueur	,joueuse	,joueuse	,joueuse	
vaincu	,vaincue	
soudeur	,soudeuse	
prof	,prof	,professeure	
homme-orchestre	,femme-orchestre	
internaute	,internaute	
instit	,instit	,institutrice	
avare	,avare	
chef	,chef	
producteur	,productrice	
poissonnier	,poissonnière	
exploitant	,exploitante	
éléphant	,éléphante	
avocat du diable	,avocate du diable	
maître	,maîtresse	,maîtresse	,maîtresse	,maîtresse	
idiot	,idiote	
droitier	,droitière	
milliardaire	,milliardaire	
fabuliste	,fabuliste	
sportif	,sportive	
diable	,diablesse	
marcheur	,marcheuse	
avocaillon	,avocaillonne	
mécano	,mécano	,mécano	
adopté	,adoptée	
filleul	,filleule	
cousin	,cousine	
sans-abri	,sans-abri	
anxieux	,anxieuse	
porcher	,porchère	
parachutiste	,parachutiste	
mouchard	,moucharde	
installateur	,installatrice	
expéditeur	,expéditrice	
pisseur de copie	,pisseuse de copie	
Africain	,Africaine	
villageois	,villageoise	
éleveur	,éleveuse	
agité	,agitée	
Sud-Coréenne	,Sud-Coréen	
compatriote	,compatriote	
professionnel	,professionnelle	
>>>	Adv_0
souple	,souplement	
interrogatif	,interrogativement	
direct	,directement	
bizarre	,bizarrement	
expérience	,expérimentalement	
juste	,justement	
héroïque	,héroïquement	
démocratique	,démocratiquement	
énergie	,énergiquement	,énergétiquement	,énergétiquement	
formidable	,formidablement	,formidablement	
exact	,exactement	
général	,généralement	
principal	,principalement	
justesse	,juste	
ingratitude	,ingratement	
habile	,habilement	
religion	,religieusement	
fonctionnel	,fonctionnellement	
molécule	,moléculairement	
lenteur	,lentement	
militaire	,militairement	
indiscret	,indiscrètement	
sainteté	,saintement	
homme	,humainement	
incroyable	,incroyablement	
méchant	,méchamment	
innocent	,innocemment	
international	,internationalement	
potentiel	,potentiellement	
cruel	,cruellement	
contredire	,contradictoirement	
manuel	,manuellement	
odieux	,odieusement	
mère	,maternellement	,maternellement	
individu	,individuellement	
authentique	,authentiquement	
paresseux	,paresseusement	
supérieur	,supérieurement	
geste	,gestuellement	
actif	,activement	
conceptuel	,conceptuellement	
instinct	,instinctivement	
frère	,fraternellement	
aucun	,aucunement	
infini	,infiniment	
merveilleux	,merveilleusement	
convenir	,convenablement	
grossier	,grossièrement	,grossièrement	
bénévole	,bénévolement	
synthèse	,synthétiquement	
>>>	S_instr
zapper	,télécommande	
coiffeuse	,ciseaux	;brosse	,peigne	;sèche-cheveux	
faire de l’essence	,pompe	
bain	,baignoire	
chant	,larynx	,corde vocale	
voiture	,voiture	
badminton	,volant	;raquette	
triangle	,baguettes	
condamner	,jugement	,verdict	
communication	,téléphone	
se laver	,lavabo	,baignoire	,douche	;savon	,gel douche	
basket	,ballon	;panier	
matraquer	,matraque	
éventer	,éventail	
mécanicien	,outil	
gauche	,main gauche	
boxeur	,gants	
déboucher	,tire-bouchon	
se doucher	,douche	
ski	;bâton	;chaussures	;skis	
harnacher	,harnais	
coup de poing	,coup de poing	
donner le sein	,seins	
dentiste	,davier	;fraise	;roulette	,davier	;fraise	;roulette	
allaiter	,seins	
articuler	,articulateur	
voyager	,avion	,autocar	,train	,voiture	
escalader	,bicyclette	,vélo	
tourner	,caméra	
aller	,moyen de transport	
imaginer	,imagination	
douche	,douche	;fleur de douche	
sucer	,bouche	,lèvres	,bouche	
rugby	,ballon	;buts	,poteaux	
nourrir	,seins	
klaxon	,klaxon	
dormir	,lit	
téléphoner	,téléphone	
observer	,microscope	,loupe	,lunette	
boucher	,couteau	;crochet	,esse	
mesure	,mètre	,règle	;instrument de mesure	
bêcher	,bêche	
flatter	,compliment	
boulanger	;pétrin	;four	
ramer	,rame	,rame	
crime	,arme	
doucher	,douche	
mécanicienne	,outil	
moudre	,moulin	;moulin à café	
punaiser	,punaise	
>>>	Syn_⊂
jus de chaussette	,café	
naître	,commencer	
carburant	,combustible	
roche	,matière	
miroir	,surface	
contracter	,attraper	
velouté	,potage	,soupe	
affaibli	,faible	
cheminement	,déplacement	
callipyge	,fessu	
parfum	,odeur	
tout en longueur	,long	
sollicitation	,demande	
secouer le cocotier	,se débarrasser	
strident	,aigu	
chaud	,température	
remplir	,causer	
réacteur	,moteur	
clabaudage	,bavardage	
avancé	,situé	
ménage	,couple	,couple	
capital social	,capital	
appuyer	,placer	
Conseil national de la comptabilité	,organisation	
tortillard	,train	
suceur	,embout	
hibernation	,sommeil	
fortune	,somme	,évènement	
tapi	,caché	
leader	,entreprise	
crème	,liqueur	,gentil	
à se rouler par terre	,drôle	
section	,forme	,partie	
synthèse	,élaboration	
cavaler	,courir	
nez	,avant	,cap	
maladie honteuse	,maladie	
entrer	,se déplacer	,placer	,commencer	
coup d’œil	,regard	
grand-père	;petit vieux	,vieux	
sans	,sans	
tomber	,se déplacer	,mourir	,éprouver	,ressentir	,avoir lieu	,arriver	
diable vauvert	,lieu	
se crêper le chignon	,se battre	
titiner	,chanter	
lie	,dépôt	
millier	,mille	
purée	,purée	
grand frisson	,émotion	,frisson	,orgasme	
débarrasser	,enlever	
>>>	Syn
se casser le bol	,se casser la tête	
déjeuner	,déj	
tache de son	,tache de rousseur	
vin rouge	,rouge	
texto	,sms	
hélicoptère	,hélico	
cure-pipe	,nettoie-pipe	
collabo	,collaborateur	,collaboratrice	
dîner	,souper	,souper	
désert	,purgatoire	,vide	
car	,autocar	
magnet	,aimantin	
aéronef	,véhicule volant	
BMX	,bicross	
valoches	,valises	
musulman	,islamique	
ruiné	,en ruine	
faire mauvaise figure	,faire pâle figure	,faire piètre figure	,faire triste figure	
semblable	,identique	
réprimander	,botter les fesses	
peur	,frousse	,trouille	
papillon	,brasse-papillon	
crotte	,étron	,caca	,merde	
se mélanger les pédales	,s’emmêler les pédales	
lave-linge	,machine	
posséder	,coucher	
faire triste figure	,faire mauvaise figure	,faire pâle figure	,faire piètre figure	
boulange	,boulangerie	
linge	,petit linge	
collation	,en-cas	
picoler	,boire	,boire	
s’accaparer	,accaparer	
appart	,appartement	
mastiquer	,mâcher	
paysannerie	,paysannat	
feu rouge	,feu de signalisation	
râlement	,râle	
pleuvoir	,flotter	
grand chemin	,route	
nullement	,aucunement	
dix mille	,10 000	
garo	,clope	,tige	,schmer	,cigarette	,sèche	,cancéreuse	,cibiche	
quatre-heures	,goûter	,goûter	
s’endormir	,mourir	,décéder	,disparaître	,périr	,perdre la vie	
lancer	,jeter	
aimantin	,magnet	
glaviot	,crachat	
mamelles	,seins	
à cheval	,à califourchon	
barbe	,barbouze	
>>>	S_1Pred
anonyme	,anonyme	,anonyme	
faible	,faible	
beau	,beauté	
allemand	,Allemand	,Allemande	
connerie	,con	
espagnol	,Espagnol	,Espagnole	
héroïque	,héros	,héroïne	
alcoolique	,alcoolique	,alcoolique	
fabulateur	,fabulateur	,fabulatrice	
timide	,timide	,timide	
russophone	,russophone	,russophone	
canadien	,Canadien	,Canadienne	
myope	,myope	,myope	
angliche	,Angliche	,Angliche	
bavard	,bavarde	,bavard	
agressé	,agressé	,agressée	
riverain	,riverain	,riveraine	
orphelin	,orphelin	,orpheline	,orphelin	,orpheline	,orphelin	
rusé	,rusé	,rusée	
portugais	,Portugais	,Portugaise	
gallois	,Gallois	,Galloise	
boche	,Boche	,Boche	
blessé	,blessé	,blessée	
suédois	,Suédois	,Suédoise	
bizarre	,bizarrerie	
accidenté	,accidenté	,accidentée	
nord-coréen	,Nord-Coréen	,Nord-Coréenne	
ordinaire	,ordinaire	
juif	,juif	,juive	
symptomatique	,symptôme	,symptôme	
fidèle	,fidèle	
original	,original	,original	
frisé	,frisé	,frisée	
indien	,Indien	,Indienne	,Indien	,Indienne	
voyou	,voyou	
fouetteur	,fouetteur	,fouetteuse	
nord-américain	,Nord-Américain	,Nord-Américaine	
australien	,Australien	,Australienne	
jeune	,jeune	,jeune	
anorexique	,anorexique	,anorexique	
français	,Français	,Française	
anglophone	,anglophone	,anglophone	
lâche	,lâche	,lâche	
rival	,rival	;rivale	
chinois	,Chinoise	,Chinois	
titulaire	,titulaire	
aîné	,aîné	,aînée	
célibataire	,célibataire	,célibataire	
rouge	,rouge	,rouge	
américain	,Américain	,Américaine	,Américain	,Américaine	
>>>	S_2
prévision	,prévision	,prévision	
résultat	,calcul	,opération	
pondre	,œuf	
dentifrice	,dent	
billet	,spectacle	
charbonnière	,charbon	
tartiner	,tartine	
desservir	,arrêt	,station	
Internet	,site	
tramway	,arrêt	,station	
jumeau	,bœuf	
dentiste	,patient	,patiente	,patient	,patiente	
arriver	,arrivage	
samedi	,semaine	
déception	,déception	
interpeler	,suspect	
toaster	,toast	
dieu	,croyant	,croyante	
illustré	,illustration	
somme	,terme	,montant	
soutien-gorge	,poitrine	,seins	
posséder	,possession	;propriété	,bien	
service	,client	,cliente	
aérodrome	,avion	
sonde	,sondage	
cafetière	,café	
dimension	,dimension	
vicié	,vice	
maman	;enfant	
enterrer	,mort	,morte	;cadavre	
débuter	,début	
prédiction	,prédiction	
déficit	,déficit	;montant	,valeur	
dire	,propos	
station	,activité	
messe de minuit	,fidèle	
automobile	,véhicule	
volant	,véhicule	,badminton	
dette	,dette	;argent	
combat	,adversaire	,adversaire	
chien de chasse	,chasse	
cauchemar	,cauchemar	
purée	,pomme de terre	
analyser	,analysant	
chiffre	,nombre	,chiffre	
appareiller	,bateau	
afficher	,affiche	
téléspectateur	,télévision	
réussir	,réussite	
réalisateur	,film	
>>>	S_1^usual
mouton	,berger	,bergère	;éleveur	,éleveuse	
graver	,graveur	,graveuse	
sauce	,saucier	
toilettage	,toiletteur	,toiletteuse	
enculer les mouches	,enculeur de mouches	,enculeuse de mouche	
skier	,skieur	,skieuse	
servir	,serveur	,serveuse	
car	,conducteur	,conductrice	,chauffeur	
rugby	;joueur	,joueuse	,rugbyman	,rugbyman	,rugbywoman	
sauciflard	,charcutier	,charcutière	
montrer	,montreur	,montreuse	
tambour	,joueur	,joueuse	,tambour	
magie	,mage	;magicien	,magicienne	
coiffage	,coiffeur	,coiffeuse	
tableau	,peintre	,peintre	
caricature	,caricaturiste	,caricaturiste	
tamponneur	,auto	
jardin	,jardinier	,jardinière	
guichet	,guichetier	,guichetière	
commenter	,commentateur	,commentatrice	
xylophone	,musicien	,musicienne	,percussionniste	,percussionniste	
se résigner	,résigné	,résignée	
peigne	,tisseur	,tisseuse	
collection	,livre	
prévision	,prévisionniste	,prévisionniste	
design	,designer	
ramer	,rameur	,rameuse	
guignol	,marionnettiste	,marionnettiste	
nettoyer	,nettoyeuse	,nettoyeur	,chirurgien	,chirurgienne	,nettoyeur	,nettoyeuse	
chou	,cultivateur	,cultivatrice	
lessive	,laveuse	,lavandière	
maquiller	,maquilleur	,maquilleuse	
ronronner	,chat	
déménager	,déménageur	,déménageuse	
entêtement	,têtu	,têtue	
découper	,découpeur	,découpeuse	
vigne	,vigneron	,vigneronne	
spongieux	,éponge	
couverture	,couvreur	
former	,formateur	,formatrice	
trompette	,trompettiste	,trompettiste	
drame	,dramaturge	,dramaturge	
goûter	,goûteur	,goûteuse	
station-service	,pompiste	
riz	,riziculteur	,rizicultrice	
toiletter	,toiletteur	,toiletteuse	
fable	,fabuliste	,fabuliste	,fabulateur	,fabulatrice	
navigation	,navigateur	
lavage	,laveur	,laveuse	
ivre	,ivrogne	,ivrogne	,ivrognesse	
>>>	Magn
observation	,strict	
peine	,grand	<dévastation	
tornade	,violent	,terrible	,violent	,violent	
blesser	,grièvement	,gravement	,profondément	,profondément	
fesses	,rebondi	,dodu	<gros	,gras	,d’éléphant	
chargé	,surchargé	
descente	,drôle	;bon	<sacré	
penser	,mûrement	
cinéma	,vrai	
enveloppe	,gros	,important	
intensité	,fort	
crime	,grave	<énorme	<abominable	,inqualifiable	;contre nature	;du siècle	,affreux	,brutal	<horrible	,atroce	,abominable	,inqualifiable	,odieux	;sordide	;contre nature	;du siècle	
gribouillis	,illisible	
fond	,fin	,fin	,fin	
imagination	,fou	,galopant	
allonger	,considérablement	
observer	,attentivement	
cuisine	,sacré	
bête	,à manger du foin	
analogie	,singulier	,saisissant	,évident	,remarquable	,singulier	<frappant	,saisissant	,évident	,fort	,remarquable	,profond	,grand	<étroit	<absolu	,complet	,parfait	
ennemi	<juré	<pire	<juré	,farouche	,pire	
bière	,fort	
couleur	,ardent	,brillant	,vif	;foncé	,sombre	,puissant	
mère	,notre _N à tous	,vrai	
suspense	,haletant	,gros	
à ravir	,bien	
nase	,gros	
rebond	,fort	,net	
assis	,bien	<solidement	,bien	,solidement	
pioncer	,comme un sonneur	,comme un loir	
obéir	,au doigt et à l’œil	
galérer	,à mort	
similarité	,grand	,frappant	
problème	,gros	,sérieux	<insurmontable	,difficile	,gros	,sérieux	<majeur	
chant	,puissant	
con	,connard	
drôle	,à se rouler par terre	
lumineux	,éclatant	,resplendissant	;éblouissant	
cadrer	,bien	<parfaitement	
vache	,sale	,gros	
mal	;bien	,très	,de chien	,de chien	,de chien	
relation	,étroit	,intime	,étroit	;intime	
surveillé	,étroitement	
franchement	,très	;en tout [Y]	
muet	,comme une tombe	
frisson	,grand	,grand	
bandit	,de grand chemin	
avoir	,bien	,complètement	
soleil	,plein	,éblouissant	
malaise	,profond	
>>>	A_2
ébahir	,ébahi	
génération	,générateur	
bague	,bagué	
habitation	,habité	
proche	,prochain	
miracle	,miraculé	
raisonner	,raisonné	
emprise	,sous	
écouter	,écouté	
accusation	,visé	,en butte	
pension	,pensionné	
habitude	,habituel	
inquiéter	,inquiet	
amour	,amoureux	
exporter	,exporté	
désespérer	,désespéré	
occupation	,occupé	
imputer	,imputable	
serrer	,serré	
disputer	,disputé	
vents	,à	
attrait	,attrayant	
remplir	,rempli	
surmonter	,au-dessous	
habiter	,habité	
suspecter	,suspect	
héliporter	,héliporté	
exploiter	,exploité	
émouvoir	,ému	
éclairer	,éclairé	
gonfler	,gonflé	
origine	,originaire	
abattre	,abattu	,abattu	,abattu	
encombrer	,encombré	
considérer	,considéré	
éducation	,éducateur	
recouvrir	,recouvert	,recouvert	
désirer	,désirable	
éprouvé	,éprouvant	
droite	,droit	
débat	,en	
concerner	,concerné	
prendre à la gorge	,pris à la gorge	
déprimer	,déprimé	
former	,formé	
consentir	,consenti	
obliger	,obligé	
victoire	,vaincu	
faute	,fautif	
profit	,profitable	
>>>	Contr
intégration verticale	,intégration horizontale	
priser	,chiquer	
maritime	,terrestre	;aérien	
à la rame	,à la voile	
droit	,obligation	,devoir	,gauche	,gauche	
plein	,vide	
Merci	,De rien	,Il n’y a pas de quoi	
de femmes	,d’hommes	
Amérique du Nord	,Amérique du Sud	
chiquer	,priser	
blanc	,rouge	
occident	,orient	
sel	,poivre	
premier	,dernier	,dernier	
cash	,chèque	
finale	,éliminatoire	
actuel	,ancien	,prochain	
algèbre	,géométrie	
comédie	,tragédie	
hier	,aujourd’hui	,demain	,aujourd’hui	,demain	
d’hommes	,de femmes	,de jupons	
chanter	,parler	
feu	,eau	;glace	
titre de placement	,titre de participation	
nord	,sud	
brouillon	,propre	
sud	,nord	
temps	,espace	
monarchique	,démocratique	,républicain	
ensemble	,seul	
terre	,ciel	,mer	,ciel	
ancien	,actuel	
notre	,votre	
voussoiement	,tutoiement	
manuel	,intellectuel	
sans excès	,avec excès	
simple	,double	
toi	,moi	
critique	,public	
collaboration	,Résistance	
réactant	,produit	
voussoyer	,tutoyer	
république	,monarchie	
plafond	,sol	
magistrature assise	,magistrature debout	
au revoir	,bonjour	
minuit	,midi	
votre	,notre	
dictature	,démocratie	,démocratie	
décollage	,atterrissage	
>>>	S_0Pred
homosexuelle	,homosexualité	
statique	,statisme	
frais	,fraîcheur	,fraîcheur	
célèbre	,célébrité	
majeure	,majorité	
capillaire	,capillarité	
moderne	,modernité	
nécessaire	,nécessité	
calculateur	,calcul	
vieux	,vieillesse	
localisé	,localisation	
uniforme	,uniformité	
brutal	,brutalité	
agile	,agilité	
constant	,constance	
paresseux	,paresse	
indulgent	,indulgence	
probable	,probabilité	
tyran	,tyrannie	
débutant	,débuts	,début	
mécontent	,mécontentement	
oblique	,obliquité	
ambigu	,ambiguïté	,ambiguïté	
fou	,folie	
majoritairement	,majorité	
tiède	,tiédeur	
prioritaire	,priorité	
gratuit	,gratuité	
varié	,variété	
impatient	,impatience	
capable	,capacité	
tendre	,tendreté	,tendresse	
quotidien	,quotidienneté	
sérieux	,sérieux	
égal	,égalité	
soulagé	,soulagement	
original	,originalité	
jeune	,jeunesse	
limpide	,limpidité	
propre	,propreté	,propreté	,propreté	
cruel	,cruauté	
généreux	,générosité	
solide	,solidité	,solidité	
raciste	,racisme	
génial	,génie	
bête	,bêtise	
vulgaire	,vulgarité	
réticent	,réticence	
digne	,dignité	
esclave	,esclavage	
>>>	S_1^prototyp
abbaye	,religieuse	,religieux	
studio	,cinéma	
clé	,robinet	,sol	;fa	
mellification	,abeilles	
averse	,larme	
éducateur	,équipe	
toison	,mouton	,bélier	
banc	,poisson	,nuage	
s’étirer	,chat	,chatte	
pâteux	,pâte	,pâte	,bouche	
officier	,prêtre	
bave	,mollusques	
propre	,voiture	,transports	,énergie	
cailler	,lait	;sang	,présure	
addition	,barman	,barmaid	,serveur	,serveuse	
nucléaire	,énergie	
dru	,neige	,pluie	,neiger	,pleuvoir	
angle	,appareil photo	;caméra	
accoudoir	,fauteuil	
gueule	,arme à feu	;fusil	
souligné	,mot	
suspense	,histoire	;film	,roman	,enquête	,procès	,compétition	
main gauche	,singe	,musicien	,musicienne	
cible	,tireur	,tireuse	,archer	
tétons	,femme	,chatte	,chienne	
honneur	,dieu	,Dieu	
analogie	,organe	
embouteiller	,vin	
fruitier	,arbre	
dossier	,banc	,canapé	,chaise	,fauteuil	,siège	
lit	,fleuve	,rivière	,ruisseau	,torrent	
cabine	,bateau	
vélo	,cyclotouriste	,cyclotouriste	
radiateur	,véhicule	;voiture	
ampoule	,médicament	
vengeur	,acte	,action	
sévir	,tempête	
dîner	,dîneur	,dîneuse	
bouse	,vache	
col	,chemise	
poil	,tapis	,brosse	,pinceau	,pinceau	
se cailler	,lait	;sang	
bec	,tortue	
rebondissement	,affaire	,enquête	
décolleté	,robe	
nuage	,pluie	;neige	;grêle	,lait	;crème	,point	;mot	
bonnet	,soutien-gorge	
couverture	,livre	
juger	,juge	;tribunal	,juge	;tribunal	
pendule	,horloge	,pendule	
>>>	Redun
cailler	,de froid	
vocation	,religieux	
plateau	,jeu	
triangle	,pubien	,signalisation	
aimant	,naturel	
flûte	,pain	
précipitation	,atmosphérique	
huile	,alimentaire	
compétition	,sportif	
désirer	,physiquement	,sexuellement	
États-Unis	,Amérique	
temple	,protestant	,religieux	
voie	,ferré	
chevaux	,fiscal	
épreuve	,sportif	
poche	,ventral	
gare	,ferroviaire	
composé	,chimique	
ticket	,entrée	
diversité	,ethnique	
forme	,linguistique	
aube	,matinal	
pays d’accueil	,touristique	
thèse	,doctorat	,doctoral	
Noël	,chrétien	
réactant	,chimique	
carte	,à jouer	
corps	,sans vie	,constitué	
grappe	,raisin	
théorie	,scientifique	
équation	,chimique	,chimique	
lunettes	,paire	
plage	,horaire	
prise	,électrique	
anniversaire	,de naissance	
droit commun	,régime	
dessous	,féminin	
position	,sexuel	
course	,hippique	,cheval	
comme il faut	,bien	
dégoût	,physique	
carré	,infanterie	
genre	,grammatical	
serveur	,informatique	
nombre	,grammatical	
pur	,chimiquement	
vapeur	,eau	
pompe	,à huile	,à essence	
fil	,linge	
infarctus	,myocarde	
>>>	AntiBon
bouteille	,mauvais	
élève	,mauvais	,cancre	,mauvais	,cancre	
jour	,sans	
écrit	,gribouillage	
lit	,grabat	
avocate	,mauvais	<piètre	;avocaillonne	
repas	,immangeable	,indigeste	;gras	
assiette	,cassé	,ébréché	,fêlé	
vent	,âpre	;mauvais	
parler	,baragouiner	,comme une vache espagnole	,baragouiner	
serviette	,humide	<mouillé	;sale	
film	,navet	
dormir	,à la dure	,mal	,insuffisamment	
politique	,mauvais	<catastrophique	,désastreux	,politicard	
écrivain	,gribouilleur	;pisseur de copie	
navire	,mauvais	,rafiot	
croûte	,dur	
dent	,carié	,pourri	,gâté	,vilain	;déchaussé	;ébréché	<cassé	,chicot	;creux	
gosse	,sale	;chiard	,sale	
jambes	,faible	,mauvais	,faible	,mauvais	
assis	,mal	
installé	,mal	
divorce	,pour faute	;aux torts exclusifs	;par assignation	;aux torts partagés	
personnel	,incompétent	,incompétent	
avocat	,mauvais	<piètre	;avocaillon	
femme politique	,politicarde	
négocier	,chipoter	
figure	,de carême	
réponse	,Normand	
odeur	,irrespirable	
mouchoir	,sale	
se lever	,se lever du pied gauche	
vélo	,clou	
forme	,petit	<mauvais	,petit	,mauvais	
ostensible	,ostentatoire	
manger	,mal	,gras	
effet	,méfait	
chien	,indiscipliné	;agressif	,hargneux	,teigneux	<enragé	
chaussures	,usé	;éculé	
violon	,crin-crin	
nappe	,sale	,taché	,contaminé	;pollué	
lac	,sombre	,impur	,boueux	,fangeux	;noir	,opaque	;houleux	
gueule	,de _N de long	
chaussons	,usé	,usé	
marcher	,mal	;au ralenti	
pluie	,dévastateur	,dévastateur	
aller	,mal	
fond	,bas-fond	,vieux	,mauvais	,méchant	
colline	,abrupt	
tête	,de _N de long	
>>>	Mero
tortue marine	,bec	;carapace	;nageoire	
tortue de mer	,bec	;carapace	;nageoire	
mot	,lettre	
omelette	,œuf	
jambes	,chevilles	;mollets	;genou	;cuisses	;pieds	
éléphant	,trompe	
cheveu	,naissance	;racine	;bulbe	
fleuve	,méandres	;amont	,aval	;embouchure	;estuaire	,delta	;bouche	;berge	,bord	,rive	
crachat	,salive	
pomme de terre	,pomme de terre	
soutien-gorge	,bonnet	
bateau	,coque	,quille	,passerelle	,pont	;cabine	,carré	,cockpit	,mess	,poste d’équipage	,écoutille	,hublot	;cale	,ballast	,soute	,mât	;cheminée	;proue	,étrave	;bord	,bâbord	,tribord	;poupe	,étambot	
étang	,bonde	;bord	
nuage	,vapeur	
tomate	,tomate cerise	,cœur de bœuf	
table	,plateau	,pied	;bord	,bout	,centre	,milieu	,coin	
métro	,rame	,métro	;métro	,station	,quai	;voie	
Système solaire	,Soleil	;Terre	,Mars	;Lune	
glaçon	,glace	,glace	
substance	,particule	
gamme	,do	,sol	
haricot	,haricot	,haricot	
air	,oxygène	
rivière	,méandres	;amont	,aval	;berge	,bord	,rive	;gué	,fermoir	
brosse	,dos	;poil	,fibre	;manche	,poil	,fibre	;manche	,poil	,fibre	
cheval	,crinière	
école	,école	,école	
voie ferrée	,rails	
tétons	,tétons	
fauteuil	,accoudoir	,bras	,coussin	,dossier	,oreilles	,patte	,pied	,siège	
lavande	,lavande	
poitrine	,seins	;sternum	,lard	
canapé	,accoudoir	,coussin	,dossier	
graine de lin	,lin	
aspirateur	,brosse	,suceur	;tuyau	;sac	;fil	
couronne	,branche	,feuille	
balai	,manche	,pommeau	
plan comptable général	,bilan	
cheminée	,foyer	
chaise	,dossier	,patte	,siège	
patate	,patate	
rayon	,alvéole	
thorax	,sternum	;côte	
mère	,bactérie	
avion	,aile	,hélice	,moteur	,réacteur	,train d’atterrissage	;cockpit	;siège	,ceinture	;soute	;queue	;carlingue	,fuselage	
route	,chaussée	,voie	;bord	;revêtement	
main	,dos	
ongles	,kératine	
zigzag	,tournant	,virage	
soupe au lait	,lait	
>>>	Fact_0
fond	,remonter	,remonter	
véhicule volant	,voler	
écureuil	,grimper	,sauter	,conserver	,garder	;économiser	
bouilloire	,chauffer	
bateau	,naviguer	
archéologue	,fouiller	
boulanger	,boulanger	
avocate	,exercer	
casserole	,chauffer	
campeuse	,camper	
couleurs	,flotter	
tombe	,contenir	,renfermer	;receler	
bus	,rouler	;circuler	
magie	,opérer	
travailleur	,travailler	
transporteur	,transporter	
coureuse	,courir	
bronzeur	,bronzer	
bicyclette	,rouler	,circuler	
dormeur	,dormir	,dormir	
véhicule	,rouler	,se déplacer	;avancer	,circuler	,se déplacer	
balai	;balayer	
parturiente	,accoucher	
oiseau	,voler	
train	,rouler	,circuler	,avancer	,se déplacer	
corbeau	,voler	,voler	
moustique	,voler	
coup	,retentir	
cigarette	,se consumer	
guêpe	,voler	
voiture	,rouler	;avancer	,circuler	;se déplacer	,rouler	
escargot	,ramper	,traîner	
autocar	,rouler	
car	,rouler	
couple	,embrasser	;enlacer	
réactif	,réagir	
dormeuse	,dormir	,dormir	
avocat	,exercer	
sorcier	,envoûter	
flocons	,tomber	;voler	;neiger	
prédiction	,se réaliser	
père	,officier	
alcoolique	,boire	,boire	
douche	,couler	,fonctionner	
aspirateur	,aspirer	
crocodile	,marcher	;nager	;ramper	
balayeuse	,balayer	
aéronef	,voler	
collaboratrice	,collaborer	
musicienne	,jouer	
>>>	Gener
bac	,véhicule flottant	,examen	,épreuve	
goût	,sens	,qualité	
zéro	,chiffre	,nombre	
T8	,habitation	,logement	
historienne	,scientifique	
Paris-Brest	,gâteau	,pâtisserie	
histoire	,discipline	;science	
F4	,habitation	,logement	
Sahel	,territoire	
volcan	,élément du relief	
voie rapide	,voie	
avoine	,végétal	,céréales	
camionnette	,véhicule	
confirmer	,dire	
caméléon	,reptile	,reptiles	
vache à lait	,vache	
former	,créer	
judo	,art martial	;sport de combat	
animé	,vivant	
chemisier	,vêtement	
été	,saison	
batraciens	,classe	,espèce	,famille	;ordre	;animal	
action	,procédure	
convertible	,meuble	;pièce d’ameublement	
pigeon	,oiseau	,oiseaux	
germanique	,langue	
bureau	,meuble	;pièce d’ameublement	,pièce	,lieu de travail	
joaillier	,artisan	
opération escargot	,mouvement social	
rouge-queue	,oiseau	,oiseaux	;passereaux	
tuberculose	,maladie	
Conseil d’État	,institution	
valeur vénale	,valeur	
faux bourdon	,insecte	,insectes	
maisonnette	,construction	;habitation	
auriculaire	,doigt	
diplodocus	,dinosaure	
douche écossaise	,douche	
éliminatoire	,évènement sportif	
couettes	,coiffure	
fuchsia	,coloré	,plante	;fleur	,couleur	
combat	,compétition	;épreuve	;évènement sportif	
bilan écologique	,bilan	
flan	,entremets	,tarte	
abri	,habitation	
banc	,siège	
baggy	,vêtement	
mollusques	,classe	,espèce	,famille	;animal	
éléphant de mer	,animal	
champ	,vin	;boisson	;boisson alcoolisée	
>>>	S_loc
volley-ball	,terrain	
ananas	,ananas	
Belgique	,en	
café	,caféier	
oiseau	,nid	
dormir	,dortoir	
ski	,piste	;station	
ver de terre	,terre	
grappe	,vigne	
coiffeur	,salon	
boxeur	,ring	
chair de poule	,peau	
chaussures	,boîte	;meuble	
herbe	,pelouse	
orpheline	,orphelinat	
voter	,bureau de vote	
faire de l’essence	,station-service	
repas	,coin-repas	,salle à manger	;cantine	;restaurant	
valises	,yeux	;visage	
couché	,lit	
lait	,seins	
cadavre	,cercueil	,bière	
villageois	,village	
pompier	,caserne	,caserne	
framboise	,framboisier	
bandit	,repaire	
récif corallien	,mer	
pneumonie	,poumons	
père	,couvent	
sport	,salle	;terrain	;palais des sports	
prune	,prunier	
boxe	,ring	
rivière	<lit	<piste	;champ de course	,stade	
courriel	,adresse électronique	;boîte aux lettres	
lièvre	,terrier	
avocat	,avocatier	
terrier	,sol	;terre	
foire	,champ de foire	
uriner	,urinoir	;toilettes	
lotus	,yoga	
étalage	,étal	
imprimer	,imprimerie	
soleil	,ciel	
citron	,citronnier	
aube	,matin	
tombe	,cimetière	
emprisonné	,prison	
réunion	,salle de réunion	
cuisine	,cuisine	
orphelin	,orphelinat	
>>>	Oper_1
sale boulot	,faire	
causette	,faire	
bouclier humain	,servir	,agir	
insulte	,adresser	,proférer	
carcinome	,avoir	,souffrir	
table rase	,faire	
sprint	,faire	,faire	,piquer	,pousser	
coup de collier	,donner	
office	,célébrer	
tour	,jouer	
allergie	,souffrir	
coup double	,faire	
fierté	,avoir	,éprouver	,ressentir	
ascèse	,pratiquer	
le cul entre deux chaises	,avoir	
cadavre	,être	
service	,rendre	
sueur froide	,avoir	
bras long	,avoir	
chant	,faire	
angine	,avoir	,souffrir	
frite	,avoir	
concert	,donner	,se produire	
frustration	,avoir	,éprouver	,ressentir	
compte	,faire	
bougeotte	,avoir	
bouteille à la mer	,jeter	,lancer	,mettre	
devinette	,poser	
BMX	,faire	
fourmis dans les jambes	,avoir	
haut-le-corps	,avoir	
risque	,courir	
mère	,être	,être	,être	
carapace	,avoir	,posséder	
volley-ball	,faire	;jouer	,faire	,se faire	
empathie	,avoir	,éprouver	,ressentir	;faire preuve	,manifester	,montrer	
emprise	,avoir	;exercer	
nausée	,avoir	,éprouver	,ressentir	,avoir	,éprouver	,ressentir	
putsch	,commettre	,faire	,perpétrer	
études	,faire	
coudées franches	,avoir	
coup de filet	,mener	
question	,poser	
préjugé	,avoir	;nourrir	
mal de l’air	,avoir	,éprouver	,ressentir	
atomes crochus	,avoir	
cancer du sein	,avoir	,souffrir	
gymnastique	,faire	,faire	,faire	,se faire	
tasse	,boire	
sermon	,prononcer	,faire	
>>>	Cf
do	,ré	,mi	,fa	,sol	,la	,si	
verglacé	,verglas	
livre	,kilogramme	
bouclier	,épée	,glaive	
majorité	,unanimité	
datte	,figue	
absolu	,vérité	
parquet	,plancher	
quelque part	,quelque chose	,quelqu’un	
nénuphar	,lotus	
larve	,ver	
recoucher	,coucher	
lavage	,rinçage	,séchage	,rinçage	,séchage	,repassage	,rinçage	,essorage	,séchage	
imam	,prêtre	,pasteur	,pope	
serpillière	,éponge	
rat	,souris	
court métrage	,long métrage	,moyen métrage	
ochlophobe	,agoraphobe	,agoraphobe	
presse	,imprimante	
ketchup	,mayonnaise	;moutarde	
cinéma	,film	
ordinaire	,habitude	
syntaxique	,grammatical	
volant	,guidon	,aérien	
bourgeon	,bouton	
géranium	,pélargonium	
averse	,orage	;ciel	
tasse	,verre	,verre	,noyade	
exercice	,devoirs	
sexies	,duodecies	;quinquies	
coquille	,carapace	
cloche	,timbre	
avertissement	,sanction	
futur	,passé	
marcher	,nager	,ramper	,voler	
shampooing	,savon	
jour des Morts	,Toussaint	
soucoupe	,assiette	
elle	,il	
dizaine	,dix	
assise	,dossier	,accoudoir	
moi	,soi	
moléculaire	,élémentaire	
noyade	,tasse	
sévérité	,méchanceté	
patins	,chaussons	
rire	,sourire	,sourire	
annuel	,mensuel	,trimestriel	
processus	,évènement	
limace	,escargot	
>>>	Sing
alphabet	,lettre	
terrorisme	,acte	
courrier	,courrier	
ketchup	,bouteille	,flacon	
cheveux	,cheveu	
chéquier	,chèque	
sable	,grain	
cornichon	,rondelle	,tranche	
chevelure	,cheveu	
tarte	,part	
vinaigre	,bouteille	
neige	,flocons	;cristal	;boule	,boule de neige	
cresson	,botte	
membrure	,membre	
laitue	,feuille	
bouteille	,verre	
égouts	,égout	
pâtes	,paquet	
années	,année	
soupe	,assiette	,assiettée	;bol	
tramway	,ligne	
gâteau	,part	,tranche	
titulature	,titre	
averse	,goutte	
pharmacopée	,médicament	
karaté	,combat	<compétition	,tournoi	<championnat	
poivre	,grain	
glace	,cristal	;glaçon	;bloc	,boule	,pain	;glaçon	;cube de glace	
industrie	,industrie	
champagne	,coupe	,flûte	,verre	,champagne	<bouteille	
gendarmerie	,gendarme	,gendarme	,gendarmette	
lessive	,cuillère	,dose	,poignée	;dosette	,pastille	<baril	,bidon	,boîte	,bouteille	,carton	,flacon	,paquet	
escalade	,escalade	
vent	,brin	<souffle	,bouffée	;courant d’air	
feuillage	,feuille	
sueur	,goutte	
or	,pépite	
appareillage	,appareil	
encre	,cartouche	
miel	,pot	
parfum	,goutte	<flacon	
cours	,séance	,cours	
colère	,bouffée	
mayo	,flacon	,pot	,tube	
sucre	;grain	<cuillerée	,pincée	;morceau	,sucre	<pain	;sachet	
voirie	,voie	
pain	,miette	<bout	,morceau	,tranche	
guerre	,bataille	
muguet	,brin	
lentilles	,boîte	,paquet	
>>>	Mult
siège	,rangée	
industrie	,industrie	
volcan	,chaîne	
journaliste	,équipe	,groupe	;horde	,meute	;presse	;équipe	,groupe	;horde	,meute	;presse	
année	,années	
assiette	,pile	
punaise	,colonie	
muscle	,musculature	
saucisse	,chapelet	
loup	,bande	,horde	,meute	
fruit	,grappe	
jambes	,paire	
os	,ossature	,squelette	
raisin	,raisin	
terme	,terminologie	
grappe	,raisin	
employé	,personnel	
poussin	,couvée	
nuage	,masse	,amas	,amoncellement	,entassement	;couche	
appareil	,appareillage	
bataille	,guerre	,conflit	
outil	,panoplie	,outillage	
chiffon	,tas	
rock	,rock	
pin	,pinède	,pineraie	,pinière	
part	,capital	
entité chimique	,espèce chimique	
parent	,famille	
fiche	,fichier	
guêpe	,colonie	,essaim	,horde	;nuage	,nuée	
corbeau	,bande	,colonie	;nuée	,bande	,colonie	;nuée	
pièce de vaisselle	,vaisselle	
cours	,cours	
abeille	,colonie	,essaim	;horde	,nuage	,nuée	
famille	,mafia	
chaussettes	,paire	
voyou	,bande	,gang	,horde	
loi	,code	
éléphant	,troupeau	
datte	,grappe	,régime	
lectrice	,lectorat	
égout	,égouts	
oiseau	,volée	
banane	,régime	
jour	,semaine	,semaine	<mois	,mois	
élément	,ensemble	
chaussures	,paire	
pétales	,corolle	
membre	,membrure	,groupe	
bouton	,plaque	
>>>	Hypo
véhicule roulant	;autobus	,motocyclette	,deux-roues	,moto	,bicyclette	,voiture	,automobile	;auto	,véhicule	,vélo	,bus	,autocar	;car	,train	,tramway	;voiture	,wagon	
fonction	,dérivée	
connecteur	,implication	
bilan	;bilan instrumental	,bilan standardisé	;bilan écologique	;bilan de renouvellement	;bilan d’investigation	,bilan de contrôle	;bilan pré-opératoire	,bilan post-opératoire	;bilan pré-implantation	
sacrement	,baptême	
jour	,lundi	,mardi	,mercredi	,jeudi	,vendredi	,samedi	,dimanche	
appartement	,meublé	;penthouse	;garçonnière	;studio	;loft	;duplex	;triplex	;quadruplex	,une-pièce	;F1	,T1	;deux-pièces	,F2	,T2	;trois-pièces	,F3	,T3	;quatre-pièces	,F4	,T4	;cinq-pièces	,F5	,T5	;six-pièces	,F6	,T6	;sept-pièces	,F7	,T7	;huit-pièces	,F8	,T8	;neuf-pièces	,F9	,T9	;dix-pièces	,F10	,T10	
piano	,piano droit	,piano à queue	,piano crapaud	
fonds commun de placement	,fonds commun de placement à risque	
message	,courriel	,sms	
arme blanche	,épée	
cycle	,vélo	,bicyclette	,tricycle	,tandem	
nombre	,entier	,singulier	,pluriel	,duel	
vitesse	,première	,deuxième	,troisième	
examen	,bac	
exclamation	,misère	
instrument de mesure	,mètre	
discipline	,sport	,sprint	
escargot	,escargot de Bourgogne	,petit-gris	
homme de loi	,avocat	,magistrat	
volcan	,volcan gris	,volcan rouge	;guyot	
porte	,porte à tambour	
provision	,provision pour risques et charges	
champ de foire	,emplacement	
eau	,eau de pluie	
dispositif	,additionneur	
pierre fine	,grenat	
argot	,loucherbem	
crime	,crime	;cambriolage	,vol	;délit	,forfait	;kidnapping	,enlèvement	,rapt	;viol	;fraude	
respiration	,petit chien	
geste	,doigt d’honneur	
lampe	,lampe-tempête	
marsupial	,kangourou	
son	,coup	
gâteau	,palet	
volley	,volley de plage	,beach-volley	,volley de plage	,beach-volley	
orifice	,narines	
biscuit	,pâtisserie	
voiture	,voiture-bar	,voiture-restaurant	,wagon-restaurant	;voiture-couchettes	,wagon-couchettes	;voiture-lits	,wagon-lits	
siège	;banc	;canapé	;chaise	;fauteuil	;tabouret	
femme de loi	,avocate	,magistrate	
tâche ménagère	,ménage	,repassage	
cétacé	,baleine	
saint	,saint patron	
champ	,objet	
voilier	,jonque	
document	,enregistrement	
pain	,pain polaire	
contraceptif	,pilule	
drogue	,herbe	
>>>	Fact_2
accompagnateur	,accompagner	,accompagner	
accompagnatrice	,accompagner	,accompagner	
combattant	,combattre	,se battre	
dentifrice	,laver	,nettoyer	
chanteur	,chanter	
aide	,aider	,aider	
four	,cuire	,brûler	
administrateur	,administrer	
présure	,cailler	
dent	,mordre	;croquer	;broyer	,s’emboîter	,broyer	,déchirer	
chat	,attraper	;toucher	
combattante	,combattre	,se battre	
garant	,garantir	
composant	,composer	
tempête	,s’abattre	;balayer	;frapper	
coiffeuse	,coiffer	;couper les cheveux	
bouchère	,couper	,découper	;débiter	;dépecer	
voyou	,agresser	,tabasser	;racketter	,voler	
trieur	,trier	
vétérinaire	,examiner	;s’occuper	;soigner	,traiter	,examiner	;s’occuper	;soigner	,traiter	
avocate	,conseiller	;représenter	;défendre	,défendre	;lutter	,militer	
car	,transporter	
véhicule	,véhiculer	,transmettre	
bol	,contenir	
savon	,laver	,nettoyer	,laver	,nettoyer	
arracheur	,arracher	
bateau	,transporter	
bastion	,protéger	
concepteur	,concevoir	
tyran	,tyranniser	
représentation	,représenter	
vague	,frapper	,heurter	;submerger	
mécanicienne	,conduire	
ami	,aider	;protéger	,aider	;encourager	;protéger	
bocal	,contenir	
garante	,garantir	
porteur	,porter	
agresseur	,agresser	
journaliste	,couvrir	;enquêter	,couvrir	;enquêter	
semeur	,semer	
étagère	,supporter	
camionnette	,transporter	
facteur	,fabriquer	
chasseuse	,chasser	
avocat	;conseiller	;représenter	;défendre	,défendre	;lutter	,militer	
boulangère	,faire	;préparer	
accusatrice	,accuser	
semeuse	,semer	
bandit	,commettre	,se livrer	
bouchon	,boucher	,obstruer	
>>>	SingS_1
synagogue	,rabbin	
carré	,fantassin	,soldat	,femme soldat	,militaire	,militaire	
putsch	,putschiste	
table	,convive	,convive	,serveur	,serveuse	;cuisinier	,cuisinière	;chef	
poissons	,poisson	
russe	,Russe	,Russe	;russophone	,russophone	
turc	,Turc	,Turque	
pineraie	,pin	
nippon	,Nippon	,Nippone	
fichier	,fiche	
allemand	,Allemand	,Allemande	;germanophone	,germanophone	
paysannat	,paysan	,paysanne	
Corée	,Coréen	,Coréenne	
théâtre	,comédien	,comédienne	,acteur	,actrice	
pays	,habitant	,habitante	;citoyen	,citoyenne	,pays	
enfance	,enfant	,enfant	
aire de jeux	,enfant	,enfant	
Hollande	,Hollandais	,Hollandaise	
anglais	,Anglais	,Anglaise	;anglophone	,anglophone	
bordel	,prostituée	
chleuh	,Chleuh	,Chleuh	,Chleuh	
oiseaux	,oiseaux	,oiseau	
Corée du Nord	,Nord-Coréen	,Nord-Coréenne	
Nouvelle-Zélande	,Kiwi	
maison close	,prostituée	
Turquie	,Turc	,Turque	
occupant	,occupant	
émigration	,émigré	,émigrée	
vers	,ver	
conseil municipal	,conseiller municipal	,conseillère municipale	,conseiller municipal	,conseillère municipale	
italien	,Italien	,Italienne	
salariat	,salarié	,salariée	
orchestre	,musicien	,musicienne	
français	,Français	,Française	;francophone	,francophone	
mairie	,conseiller municipal	,conseillère municipale	
Corée du Sud	,Sud-Coréen	,Sud-Coréenne	
flore	,végétal	
Espagne	,Espagnol	,Espagnole	
gorge chaude	,rapace	
faune	,animal	
pinière	,pin	
bureau	,secrétaire	,trésorier	,trésorière	,employé	,employée	,collègue	;collègue	
chinois	,Chinois	,Chinoise	;sinophone	,sinophone	
fratrie	,frère	,sœur	
Triangle	,étoile	
breton	,Breton	,Bretonne	
direction	,directeur	,directrice	
Japon	,Japonais	,Japonaise	,Nippon	,Nippone	
brosserie	,brosse	
Moyen-Âge	,médiéval	
>>>	Syn_⊂^sex
obèse	,obèse	
religieuse	,religieux	
capitaine	,capitaine	,capitaine	,capitaine	
sujette	,sujet	
collaboratrice	,collaborateur	,collaborateur	,collabo	
championne	,champion	
recruteuse	,recruteur	
muette	,muet	
détentrice	,détenteur	
ajusteuse	,ajusteur	
Québécoise	,Québécois	
guérisseuse	,guérisseur	
xénophobe	,xénophobe	
alcoolo	,alcoolo	,alcoolique	
gentille	,gentil	
bachelière	,bachelier	
anglophone	,anglophone	
contradictrice	,contradicteur	
ancienne	,ancien	,ancien	
excentrique	,excentrique	
assaillante	,assaillant	
instructrice	,instructeur	
encadreuse	,encadreur	
footeuse	,footeux	
gendarme	,gendarme	
moche	,moche	
tisseuse	,tisseur	
ourse	,ours	
merlette	,merle	
rameuse	,rameur	
bergère	,berger	
conceptrice	,concepteur	
médecin-chef	,médecin-chef	
Suissesse	,Suisse	
faux-cul	,faux-cul	
puînée	,puîné	,cadet	
luthière	,luthier	
charcutière	,charcutier	,charcutier	
karatéka	,karatéka	
dévoreuse	,dévoreur	,dévoreur	
ex	,ex	
intellectuelle	,intellectuel	
rivale	,rival	
tennisman	,tennisman	
louve	,loup	
toubib	,toubib	
monitrice	,moniteur	
bouchère	,boucher	,boucher	
villageoise	,villageois	
princesse	,prince	
