>>>	Syn_∩
prix	,tarif	,médaille	
grande gueule	,crâneur	
rai	,rayon	
dilapider	,engouffrer	,gaspiller	,dissiper	,claquer	,croquer	,flamber	;manger son blé en herbe	
fatigué	,usé	
cliqueter	,tinter	
charcutière	,bouchère-charcutière	,bouchère-charcutière	
garçon de course	,coursier	
ticket	,entrée	,équipe	
se battre	,en venir aux mains	,se mettre sur la figure	;faire le coup de poing	
braquage	,hold-up	
recevoir	,subir	,aspirer	;capter	,accueillir	
incurable	,inconsolable	
prélever	,percevoir	,aspirer	
fan	,adorateur	,adoratrice	
obligé	,forcé	
alcoolique	,ivrogne	,boit-sans-soif	,meurt-de-soif	,pochard	,pochetron	,poivrot	,sac à vin	,soiffard	,saoulard	,ivrogne	,ivrogne	,boit-sans-soif	,ivrognesse	,pocharde	,pochetronne	,poivrote	,soiffarde	,saoularde	,ébrieux	
seulement	,juste	,à peine	
serrer les dents	,accuser le coup	;résister	,souffrir	
atténuer	,diminuer	
soupir	,silence	
tue-mouche	,tapette	
vagabonder	,errer	
privilégier	,favoriser	,prioriser	;avantager	
ne [X] pas	,sans	
flânerie	,promenade	
déconfiture	,défaite	,échec	;veste	
drille	,soldat	
avouer	,vider son sac	
déboucher	,ouvrir	,arriver	,aboutir	,s’ouvrir	,finir	,conduire	,finir	
roche	,colline	,montagne	
bovin	,bête	
squelette	,ossature	
marcher à la baguette	,obéir	
aptitude	,capacité	;disposition	;rapidité	
avec armes et bagages	,complètement	
rapière	,épée	
froissé	,fripé	,fracturé	
transportable	,déplaçable	
marcher	,fonctionner	,utiliser	,tourner	,rouler	;se tenir	,tenir la route	,fonctionner	,avancer	,progresser	,défiler	,participer	,fonctionner	,avancer	,progresser	,se promener	
théoriquement	,sur le coup	
se fendre	,se couper	
parasol	,ombrelle	;parapluie	
en amont	,avant	
excentré	,excentrique	
compagnie	,troupe	,société	,maison	
fracturer	,casser	
caméléon	,changeant	
hisser	,lever	
mûr	,prêt	
envahir	,gagner	
concession	,exploitation	
encaisser	,accuser le coup	
lâcheté	,couardise	
se déshabiller	,tomber la veste	
majorité	,plupart	
angliche	,anglais	
demi	,demi-pièce	
teinte	,couleur	
grognement	,grommellement	,ronchonnement	,vocifération	,bougonnement	,hurlements	,mécontentement	,grogne	
célibataire	;homme seul	;homme libre	;garçon	,seul	,femme seule	
tronche	,tête	;visage	,visage	,fraise	
charrier	,emporter	,se moquer	,faire marcher	,pousser	,exagérer	,pousser le bouchon trop loin	
rude	,rugueux	
noblesse	,élégance	,aristocratie	,générosité	
chaleur humaine	,tendresse	;chaleur	
injurier	,insulter	
coup de chien	,coup de tabac	
festival	,geyser	,volcan	
commettre	,perpétrer	
en vigueur	,en cours	,valide	
geyser	,fontaine	,rivière	,fleuve	,torrent	;coulée	,volcan	;festival	,éruption	;jet	
se référer	,renvoyer	
imposé	,obligatoire	
rhytmique	,régulier	
en guise	,comme	,pour	
lever les fesses	,se lever	
limite	,frontières	,seuil	,portée	,frontière	,pratiquement	,presque	,suffisant	,exagéré	;inacceptable	,maximum	
tête-à-tête	;audience	,entretien	,rencontre	,entrevue	;conversation	,dialogue	,discussion	
marche du podium	,rang	
attaquant	,assaillant	
substance	,corps	,élément	,essentiel	,contenu	,drogue	
caserne	,brigade	
casser la baraque	,savonner la planche	;faire un malheur	,faire un malheur	
en nombre	,nombreux	
effacer	,balayer	
bel et bien	,bien	
carnation	,couleur	
comme un cochon	,comme un porc	;salement	,beaucoup	,comme un porc	
clos	,fermé	
coûteux	,cher	
la tête à l’envers	,déprimé	
épaules	,tête	
aux pièces	,pressé	
se scinder	,se séparer	
prompt	,rapide	,rapide	
dragée	,comprimé	,capsule	,cachet	,gélule	,pastille	,pilule	
écart	,écartement	,intervalle	,différence	,différence	,excentricité	
tome	,volume	
climat	,temps	,ambiance	,atmosphère	
>>>	S_0
conserver	,conservation	
équin	,cheval	
se battre	,bataille	
vocalement	,voix	
lectoral	,lecture	
menacer	,menace	,menace	
élever	,élévation	,élévation	,élevage	
se suicider	,suicide	
synthétiquement	,synthèse	
semoulier	,semoule	
helvétique	,Suisse	
inviter	,invitation	
auriculaire	,oreilles	
disposer	,disposition	
métropolitain	,métropole	
assouplir	,assouplissement	
hospitaliser	,hospitalisation	
user	,usure	
portugais	,Portugal	
palatin	,palais	
communiquer	,communication	
dominer	,domination	
sanctionner	,sanction	
rebondir	,rebond	,rebondissement	,rebondissement	,rebond	
trembler	,tremblement	
avancer	,avancée	,avancement	,avancement	,avancée	,avance	,avancée	
cubital	,coude	
après coup	,après-coup	
palmaire	,paume	
fonctionner	,fonctionnement	,fonctionnement	
criminel	,crime	
rejeter	,rejet	
restructurer	,restructuration	
transformer	,transformation	
manger des briques à la sauce caillou	,faim	
punir	,punition	
se partager	,partage	
automobile	,auto	,automobile	,voiture	
chipoter	,chipotage	,chipotage	,chipotage	
sauver	,sauvetage	
plager	,plage	
substituer	,substitution	
vouvoyer	,vouvoiement	
labial	,lèvres	
décorer	,décoration	,décoration	
barrir	,barrissement	
sculpter	,sculpture	,sculptage	
appartenir	,appartenance	,appartenance	
proverbial	,proverbe	
respirer	,respiration	
arachnéen	,araignée	
frimer	,frime	
collaborer	,collaboration	,collaboration	
hurler	,hurlement	,hurlement	,hurlement	,hurlements	
gagner	,victoire	,victoire	
s’agiter	,agitation	
rassembler	,rassemblement	
approcher	,approche	
rompre	,rupture	
s’élever	,élévation	
nuitamment	,nuit	
brun	,brun	
gémir	,gémissement	
payer	,paiement	
connecter	,connexion	
australien	,Australie	,Australie	
commémorer	,commémoration	
herbacé	,herbe	
s’arrêter	,arrêt	,arrêt	
éteindre	,extinction	
raccompagner	,raccompagnement	
se suivre	,suite	
fort	,force	
échapper	,échappée	
mouiller	,mouillage	,mouillement	
exporter	,exportation	,export	
éléphantin	,éléphant	
garer	,garage	
luxueusement	,luxe	
gymnique	,gymnastique	
gustatif	,goût	,goût	
blond	,blond	
pleurer	,pleurs	
administrer	,administration	,administration	
endommager	,dommages	
s’étirer	,étirement	
rugbystique	,rugby	
toiletter	,toilette	
vendre	,vente	
accentuel	,accent	
palatal	,palais	
chevaucher	,chevauchée	
croire	,croyance	
consolider	,consolidation	
pratiquement	,pratique	
organiser	,organisation	
affectionner	,affection	
détourner	,détournement	,détournement	
provoquer	,provocation	
cardiaque	,cœur	
>>>	A_2Perf
inonder	,inondé	
enlever	,enlevé	,enlevé	
soulager	,soulagé	
accepter	,accepté	
écrire	,écrit	
indiquer	,indiqué	
percer	,percé	
enfermer	,enfermé	
endormir	,endormi	,endormi	
aider	,aidé	
hospitaliser	,hospitalisé	
asseoir	,assis	
surprendre	,surpris	
écarter	,écarté	
extraire	,extrait	
consommer	,consommé	
coudre	,cousu	
imposer	,imposé	
gonfler	,gonflé	
admettre	,admis	,admissible	
étrangler	,étranglé	
engager	,engagé	
habiller	,habillé	,habillé	
étourdir	,étourdi	
renouveler	,nouveau	
avertir	,averti	
enrouler	,enroulé	
neiger	,enneigé	,neigeux	
déconnecter	,déconnecté	
bourrer	,bourré	
licencier	,licencié	
enchaîner	,enchaîné	
clouer	,cloué	,cloué	,cloué	,cloué	
soumettre	,soumis	,soumis	
lacer	,lacé	
raidir	,raide	
abonner	,abonné	
tordre	,tordu	
convaincre	,convaincu	
illuminer	,lumineux	
entamer	,entamé	
râper	,râpé	
trancher	,tranché	
réveiller	,réveillé	,réveillé	
autoriser	,autorisé	
appauvrir	,pauvre	
souligner	,souligné	
charger	,chargé	
dégoûter	,dégoûté	
inscrire	,inscrit	
entourer	,entouré	
ruiner	,ruiné	
diminuer	,diminué	
abandonner	,abandonné	
entendre	,entendu	
envahir	,envahi	,envahi	
empoisonner	,empoisonné	
contrainte	,contraint	
voler	,volé	
promettre	,promis	
dresser	,dressé	,vertical	,droit	
afficher	,affiché	
retraitement	,retraité	
allumer	,allumé	,allumé	,allumé	
punir	,puni	
interdire	,interdit	
décourager	,découragé	
élaborer	,élaboré	
détruire	,détruit	,détruit	
doubler	,doublé	
insulter	,insulté	
épuiser	,épuisé	
sécher	,sec	
nettoyer	,nettoyé	,nettoyé	,nettoyé	,nettoyé	,nettoyé	,nettoyé	,nettoyé	,nettoyé	,nettoyé	,nettoyé	
décider	,décidé	
plier	,plié	
emprisonner	,emprisonné	
corruption	,corrompu	
détourner	,détourné	,détourné	
diviser	,divisé	
restreindre	,restreint	
oublier	,oublié	
disposer	,disposé	
accentuer	,accentué	,accentué	,accentué	
emprunter	,emprunté	
fendre	,fendu	
garnir	,garni	
contraindre	,contraint	
enflammer	,enflammé	
aérer	,aéré	
griller	,grillé	
ouvrir	,ouvert	
approvisionner	,approvisionné	
enchanter	,enchanté	
vaincre	,vaincu	
noyer	,noyé	
lever	,levé	,debout	,levé	,levé	,levé	,levé	
décoration	,décoré	,décoré	
envelopper	,enveloppé	
blesser	,blessé	
>>>	Anti
exagérer	,minimiser	
complètement	,incomplètement	
achever	,commencer	
capacité	,incapacité	
officiel	,inofficiel	
proprement	,salement	,salement	,salement	,salement	,salement	
désunir	,unir	
inauthentique	,authentique	
majeur	,mineur	,mineur	,mineur	
original	,copie	;faux	
désespérer	,espérer	,espérer	,espérer	
sincérité	,insincérité	
exploitable	,inexploitable	
incompris	,compris	
se coucher	,se lever	
décrocher	,accrocher	,raccrocher	
égal	,inégal	,inégal	
malheureusement	,heureusement	
polluant	,propre	
décéder	,naître	
lendemain	,veille	
subjectivité	,objectivité	
intolérance	,tolérance	
pratique	,pragmatique	
actif	,inactif	,inactif	
s’écarter	,se rapprocher	
débarquer	,embarquer	
maladroit	,adroit	,adroit	
favorable	,défavorable	,défavorable	,défavorable	
pro-	,anti-	
impardonnable	,pardonnable	
déplaisir	,plaisir	
inflammable	,ininflammable	
immoral	,moral	
pardonnable	,impardonnable	
tacher	,détacher	
minuscule	,majuscule	
indéfinissable	,définissable	
confortable	,inconfortable	
diminuer	,augmenter	
direct	,indirect	
ordre	,désordre	
grammaticalité	,agrammaticalité	
antimatière	,matière ordinaire	
froncer	,défroncer	
mineur	,majeur	,majeur	,majeur	
dansable	,indansable	
défense	,accusation	
ne pas se faire que des amis	,ne pas se faire que des ennemis	
soustraire	,additionner	
violemment	,doucement	
insuccès	,succès	
inexprimable	,exprimable	
pertinent	,impertinent	
corps composé	,corps simple	
favorablement	,défavorablement	
explicitement	,implicitement	
rare	,fréquent	
se désengager	,s’engager	
plus	,moins	
proue	,poupe	
provisoire	,définitif	
allumé	,éteint	,éteint	,éteint	
indépendant	,dépendant	
déplanter	,planter	
désuni	,uni	
marcher	,péricliter	
étambot	,proue	
inconsolable	,consolable	
silence	,parole	,signe de vie	
se recoucher	,se relever	
incorrect	,correct	
grammatical	,lexical	,agrammatical	
manquer	,avoir	,attraper	,avoir	
confort	,inconfort	
désabonnement	,abonnement	
poilu	,glabre	
dépendant	,indépendant	
racontable	,inracontable	
imitable	,inimitable	
facile	,difficile	
s’envoler	,chuter	
bonheur	,malheur	
pluriel	,singulier	
complétude	,incomplétude	
goûteux	,insipide	
indiscrètement	,discrètement	
éteint	,allumé	,allumé	,allumé	
terrien	,extraterrestre	
en haut	,en bas	,en bas	
obligatoire	,facultatif	
incapable	,capable	
irréel	,réel	
récupérable	,irrécupérable	
s’accélérer	,ralentir	
importer	,exporter	
faveur	,défaveur	
à long terme	,à court terme	
guérissable	,inguérissable	,incurable	
preste	,lent	
>>>	S_res
confondre	,confusion	
trouer	,trou	
dévastation	,dévastation	,dévastation	
dégradation	,dégradation	
se couper	,coupure	
épouvanter	,épouvante	
doubler	,double	
aimer	,sexe	
évaluation	,résultat	
mélange	,mélange	,mélange	;mélange	
caca	,caca	
bilan	,bilan	;compte de bilan	,bilan	
maquette	,maquette	
jugement	,jugement	
renverser	,renversement	
ioniser	,ion	,anion	,cation	
opération	,résultat	,résultat	
infecter	,infection	
s’engager	,engagement	
addition	,somme	;résultat	
dessiner	,dessin	;figure	
tempête	,houle	
encadrer	,encadrement	
tordre	,torsion	
affaiblir	,faiblesse	
match	,résultat	
expérimentation	,résultat	
analyse	,résultat	
extinction des feux	,extinction des feux	
test	,résultat	
cracher	,crachat	,crachat	
muscler	,muscles	
réunion	,réunion	
incliner	,inclinaison	
constater	,constat	
enquête	,résultat	,résultat	
ranger	,rang	,rangée	
cadrer	,cadre	;photographie	,prise de vue	,cadre	
constatation	,constat	
tomate	,tomate	
mélanger	,mélange	;mélange	
enfermer	,enfermement	
collectionner	,collection	
coucher de soleil	,nuit	
soustraction	;différence	;résultat	
suer	,sueur	
s’endormir	,sommeil	
division	,quotient	;résultat	
humilier	,humiliation	
s’affaiblir	,faiblesse	
observation	,observation	;résultat	
plisser	,pli	
abonnement	,abonnement	
étude	,résultat	
zébrer	,zébrure	
déchirer	,déchirure	
scrutin	,résultat	
course	,résultat	
enrouler	,enroulement	
entassement	,entassement	,entassement	,entassement	,entassement	
s’éprendre	,amour	
effort	,résultat	
écrire	,écriture	
vote	,résultat	
polluer	,pollution	,pollution	
déprimer	,déprime	,dépression	
juger	,jugement	
critique	,critique	,critique	
concours	,résultat	
souffler	,souffle	
laver	,lavis	,aquarelle	,lavis	
envelopper	,enveloppement	
s’éloigner	,éloignement	
politique	,fruit	,résultat	
chanter	,chant	
résumer	,résumé	
orienter	,orientation	
mesurer	,mesure	
se déplacer	,déplacement	
se décaler	,décalage	
aimanter	,aimant	
lever de soleil	,jour	
réaliser	,réalisation	
enfler	,enflure	
s’enrhumer	,rhume	
écarter	,écart	,écart	
compétition	,résultat	
coup de foudre	,amour	
caresser	,caresse	
étourdir	,étourdissement	
interdire	,interdiction	
se brûler	,brûlure	
condamner	,condamnation	
pluie	,eau	
tournoi	,résultat	
se décourager	,découragement	
gonfler	,gonflage	
arranger	,arrangement	,arrangement	
abonner	,abonnement	
décalage	,décalage	
>>>	Syn_⊃
gagnant	,champion	
piquet	,sardine	
baisser	,chuter	
dent	,chicot	,crocs	
couleur	,couleur	
chute	,avalanche	
citoyen	,concitoyen	;national	,ressortissant	
griller	,toaster	,cloper	
façade	,devanture	
chose	,objet	
cricoïdien	,cricoïde	
bouffer	,déjeuner	;dîner	;goûter	;petit-déjeuner	;souper	;dévorer	
consommer	,finir	
étirer	,filer	
marché	,bazar	,souk	
réunion	,réunion publique	,conférence	
jour	,jour	
beaucoup	,trop	,tartine	,trésors	
individu	,spécimen	
cravate	,lavallière	,régate	
baiser	,tirer un coup	
orgue	,positif	
organe	,émonctoire	
équin	,chevalin	
sapide	,goûteux	
Coréen	,Nord-Coréen	,Sud-Coréen	
proche	,prochain	,prochain	
intéressant	,passionnant	
mort	,décédé	,défunt	;abattu	
demande	,sollicitation	
nid	,guêpier	
précipitation	,averse	
laid	,vilain	
chercher	,rechercher	
savon	,savonnette	;savon blanc	,savon d’Alep	,savon de Marseille	,savon noir	
politicien	,politicard	
vélo	,tandem	;bicross	,BMX	,vélo tout chemin	,VTC	,vélo tout terrain	,VTT	
diffuseur	,diffuseur	
désordre	,chaos	
portrait	,autoportrait	
en venir aux mains	,se crêper le chignon	
repas	,petit-déjeuner	,petit-déj	;déjeuner	;collation	,goûter	;dîner	,souper	,petit-déjeuner	,petit-déj	;déjeuner	,goûter	;dîner	,souper	
habillement	,costume	
manque	,pénurie	
année	,année	
casser	,voler en éclats	
très	,fort	
superfamille	,famille	
figure	,minois	;figure	,statuette	
peser	,trébucher	
renoncule	,bouton-d’or	
monument	,mémorial	
célibataire	,mère célibataire	,fille mère	
enlèvement	,kidnapping	
cigare	,havane	,barreau de chaise	;cigarillo	
gagnante	,championne	
craquelure	,cheveu	
tomber la veste	,travailler	
cuisses	,genoux	
se dérouler	,avancer	,progresser	
violoniste	,violon	,violon	
virage	,épingle à cheveux	
terrain	,court	,lopin	
maladie	,maladie génétique	;maladie honteuse	,maladie vénérienne	;maladie infantile	;maladie mentale	
au revoir	,adieux	
chercheur	,enseignant-chercheur	
promeneur	,flâneur	
ruelle	,ruelle	
décidé	,convenu	,résolu	
donner	,allonger	
allemand	,boche	
par terre	,au tapis	
rabaisser	,aplatir	
trompettiste	,trompette	,trompette	
conduit	,narine	;pipe	
gay	,tante	
bleu	,lavande	;myosotis	;pervenche	
cou	,encolure	
tige	,jambe	
coller	,suivre	
trépasser	,s’éteindre	,succomber	,passer l’arme à gauche	
bête	,animal	
cradoque	,dégueu	,dégueulasse	,dégueu	,dégueulasse	,dégueu	,dégueulasse	
Allemand	,Boche	,Chleuh	
pathologie	,maladie	
casser les pieds	,casser les oreilles	
brun	,marron	,noisette	
empreinte	,influence	
mourir	,succomber	,passer l’arme à gauche	,s’éteindre	
homo	,tante	
tortue	,tortue de mer	,tortue marine	
immobile	,cloué	
ouverture	,gueule	;écoutille	
pourrissant	,pourri	
prison	,centrale	
utiliser	,faire usage	
élogieux	,dithyrambique	
zob	,cigare	,phallus	
muscle	,muscles	;muscle	,bifteck	,steak	
espèce	,essence	
>>>	S_1
territoire	,animal	
désert	,anachorète	,ermite	
kaki	,kaki	
volume	,son	
aube	,jour	,journée	
voyageur	,voyageur	,voyageuse	
charcuterie	,charcutier	,charcutière	,charcutier	,charcutière	
étrangler	,étrangleur	,étrangleuse	
sans-gêne	,sans-gêne	
souci	,souci	
accompagner	,accompagnateur	,accompagnatrice	,accompagnement	,accompagnatrice	,accompagnateur	
propriété physique	,substance	
malade	,malade	,malade	
coco	,coco	,noix de coco	
cueillir	,cueilleur	,cueilleuse	
dictature	,dictateur	,dictatrice	
rock	,rocker	,rockeuse	
numéro atomique	,élément	,atome	
coulisse	,théâtre	
régir	,règle	
porter	,mère	,mère	
goulot	,bouteille	
grimper	,plante	
tabac	;priseur	,priseuse	;chiqueur	,chiqueuse	
frimer	,frimeur	,frimeuse	
fleuve des Enfers	,mort	
érudit	,érudit	
thèse	,thésard	,thésarde	
enlever	,ravisseur	
bosse	,bossue	,bossu	
citronnier	,citron	
Allemagne	,Allemagne	
marcher	,marcheur	,marcheuse	;randonneur	,randonneuse	,soldat	,soldate	,militaire	,militaire	
saint	,saint	,sainte	
suspension	,véhicule	
aimé	,amoureux	,amoureuse	
lait	,mère	
longueur	,nageur	,nageuse	,vin	
presse	,presse	
allaiter	,mère	;nourrice	
épaules	,animal	,vêtement	
ciel	,Dieu	
rêve	,rêveur	,rêveuse	
amateur	,amateur	,amatrice	
bagué	,doigt	;main	
rame	,papier	
méchant	,méchant	,méchante	
bras	,grue	,cheval	
tatami	,art martial	
plus _Adv que la musique	,vite	,vite	
détruire	,destructeur	,destructrice	
aînesse	,aînée	,aîné	
escalader	,cycliste	,cycliste	
sprint	,sprinter	,sprinteuse	,sprinter	,sprinteuse	
riche	,riche	;richard	;richarde	
développer	,développeur	,développeuse	
créer	,créateur	,créatrice	
démocratie	,démocrate	,démocrate	
prison	,prisonnier	,prisonnière	
Pays-Bas	,Pays-Bas	
réagir	,réactif	,réactant	
hétérosexualité	,hétérosexuel	,hétérosexuelle	
faux-cul	,faux-cul	,faux-cul	
exécuter	,exécuteur	,exécutrice	
chaussure	,ouvrier	,ouvrière	,chausseur	,chausseuse	
abstinence	,buveur	,buveuse	
hélicoptère	,pilote	
métro	,passager	,passagère	;voyageur	,voyageuse	,usager	,usagère	,métro	
fouiller	,fouilleur	
tyrannie	,tyran	,tyran	
gomme	,arbre	
guérir	,guérisseur	,guérisseuse	
lier	,chimiste	,chimiste	
ruminant	,ruminants	
atome	,molécule	
noyer	,noix	
débuts	,débutant	,débutante	
téléphone	,appelant	,appelante	
cambrioler	,cambrioleur	,cambrioleuse	
ionisation	,atome	,molécule	
prendre le volant	,conducteur	
conduite	,conducteur	,conductrice	
oreilles	,cochon	,porc	,bol	;casserole	,cocotte	,fauteuil	
bonheur	,heureux	,heureuse	
vaccinable	,êtres animés	
donner	,donateur	,donatrice	
molécule	,atome	
ovni	,extraterrestre	,extraterrestre	
pommier	,pomme	
château	,châtelain	,châtelaine	
musée	,visiteur	,visiteuse	
couleur	,carte	
agresser	,agresseur	,agresseuse	
adopter	,adoptant	,adoptante	
essence	,arbre	
concevoir	,concepteur	,conceptrice	
lacté	,blanc	
orgue	,organiste	
mousseux	,mousseux	
moustachu	,chat	
>>>	Conv_21
intéresser	,s’intéresser	
adoptif	,adoptif	,adoptif	
s’abriter	,abriter	
amuser	,s’amuser	
posséder	,appartenir	
avoir	,aller	,partir	
manquer	,manquer	,manquer	,manquer	,manquer	
composer	,se composer	
se passionner	,passionner	
alors	,car	
expliquer	,s’expliquer	
s’intégrer	,intégrer	,intégrer	
tenir	,maintenir	,tenir	,tenir	
se désespérer	,désespérer	
tenir à cœur	,tenir à cœur	,tenir à cœur	
coucher	,se coucher	,se coucher	,se coucher	,se coucher	
cadet	,aîné	
se rappeler	,revenir	
occuper	,s’occuper	
car	,donc	,en conséquence	,par conséquent	
se divertir	,divertir	
donc	,car	
partir	,avoir	
abriter	,s’abriter	
déprimer	,déprimer	,déprimer	
se souvenir	,revenir	
couvrir	,se couvrir	
résultat	,cause	
s’expliquer	,expliquer	
piquer	,se piquer	,piquer	,piquer	
se couvrir	,couvrir	
par conséquent	,car	
derrière	,devant	
s’occuper	,occuper	
creusé	,creusé	,creusé	
se piquer	,piquer	
entrer	,comprendre	
s’agacer	,agacer	
s’intéresser	,intéresser	
passer	,renverser	
quand bien même	,bien que	
résulter	,causer	
s’affoler	,affoler	
désintéresser	,se désintéresser	
se composer	,composer	
désoler	,se désoler	
déclencher	,se déclencher	
mourir	,tuer	,emporter	
au-dessous	,au-dessus	
intégrer	,s’intégrer	,s’intégrer	
commencer	,commencer	,ouvrir	,commencer	,s’ouvrir	
alarmer	,s’alarmer	
colorer	,se colorer	
aller	,avoir	
recevoir	,visiter	
conséquence	,cause	
appartenir	,posséder	
à droite	,à gauche	
s’amuser	,amuser	
postérieur	,antérieur	
toucher	,connaître	
marcher	,faire	,alimenter	
créancière	,débitrice	
en conséquence	,car	
à gauche	,à droite	
affoler	,s’affoler	
créancier	,débiteur	
passionner	,se passionner	
revenir	,se souvenir	,se rappeler	
s’ébahir	,ébahir	
se coucher	,coucher	,coucher	,coucher	,coucher	
antérieur	,postérieur	
manger la laine sur le dos	,se laisser bouffer	
se désoler	,désoler	
craindre	,effrayer	
en dessous	,en dessus	
ébahir	,s’ébahir	
sensible	,sensible	,sensible	
causer	,résulter	,tenir	
désespérer	,désespérer	,désespérer	,se désespérer	
se laisser bouffer	,manger la laine sur le dos	
visiter	,recevoir	
cause	,conséquence	,effet	,résultat	
aîné	,cadet	
devant	,derrière	
affaiblir	,s’affaiblir	
maintenir	,tenir	
subir	,transformer	
s’alarmer	,alarmer	
en dessus	,en dessous	
appauvrissement	,appauvrissement	,appauvrissement	
s’inquiéter	,inquiéter	
se terminer	,terminer	,terminer	
effet	,cause	
agacer	,s’agacer	
ouvrir	,commencer	
transformer	,subir	
angoisser	,angoisser	,angoisser	
connaître	,toucher	
divertir	,se divertir	
>>>	A_0
buriner	,buriné	
rabat-joie	,rabat-joie	
pudiquement	,pudique	
instinct	,instinctif	
domicile	,domiciliaire	
physique	,physique	,physique	
électron	,électronique	
atomiquement	,atomique	
circonstance	,circonstanciel	
ascèse	,ascétique	
cérébralement	,cérébral	
région	,régional	
modérément	,modéré	
hypnotisme	,hypnotique	
savon	,savonnier	
expressément	,exprès	
démocratie	,démocratique	
synthétiquement	,synthétique	
simplement	,simple	
rareté	,rarement	
diversement	,divers	
pipe	,pipier	
femme	,féminin	
paupières	,palpébral	
allergie	,allergique	
ministre	,ministériel	
extérieurement	,extérieur	
sacrifier	,sacrificiel	
turc	,turc	
musée	,muséal	
dieu	,divin	
mer	,marin	,maritime	
bizarrement	,bizarre	
caravane	,caravanier	
désespoir	,désespéré	
normalement	,normal	
qualité	,qualitatif	
vase	,vaseux	
athlétisme	,athlétique	
supplémentairement	,supplémentaire	
télévision	,télévisuel	
contester	,contestataire	
paysan	,paysan	
insulter	,insultant	
moléculairement	,moléculaire	
Japon	,japonais	,nippon	
authentiquement	,authentique	
toucher	,tactile	
étudiante	,estudiantin	,étudiant	
politique	,politique	,politique	
lymphe	,lymphatique	
commercialement	,commercial	
Sahara	,saharien	
affectueusement	,affectueux	
blond	,blond	
théatre	,théâtral	
relation	,relationnel	
banane	,bananier	
urgemment	,urgent	
Phocée	,phocéen	
précisément	,précis	
similairement	,similaire	
docteur	,doctoral	
comparaison	,comparatif	
Arabie	,arabe	
seins	,mammaire	
évidemment	,évident	
éducation	,éducationnel	
général	,général	
guerre	,guerrier	
Paris	,parisien	
grève	,gréviste	
soupe au lait	,soupe au lait	
précédemment	,précédent	
collégienne	,collégien	
état	,national	
individuellement	,individuel	
phobie	,phobique	
langage	,langagier	
marbre	,marbrier	
odorat	,olfactif	
individu	,individuel	
bronchite	,bronchiteux	
calendrier	,calendaire	
atome	,atomique	
mélancolie	,mélancolique	
cancer	,cancéreux	
manuellement	,manuel	
pertinemment	,pertinent	
vaincue	,vaincu	
cheval	,chevalin	,équin	
plan	,plan	
schématiquement	,schématique	
possiblement	,possible	
énergie	,énergétique	,énergétique	
préfet	,préfectoral	
mixité	,mixte	
imbécilement	,imbécile	
espagnol	,espagnol	
fisc	,fiscal	
>>>	Able_1
chipoter	,chipoteur	,chipoteur	,chipoteur	
distraire	,distrayant	
tracasser	,tracassier	
accélérer	,accélérateur	
russe	,russophone	
flamber	,inflammable	
expliquer	,explicatif	
suspecter	,suspicieux	
flatter	,flatteur	
travailler	,bosseur	,travailleur	
réaction	,réactif	
tempête	,exposé	
perturber	,perturbant	,perturbant	
convaincre	,convaincant	
se casser	,cassant	
ruse	,rusé	
fabuler	,fabulateur	
en imposer	,imposant	
anxiété	,anxieux	
portugais	,lusophone	
éruption	,éruptif	
déplacement	,mobile	
phobie	,phobique	
astuce	,astucieux	
détruire	,destructif	
soupçonner	,soupçonneux	
tenter	,tentateur	;tentant	
se débrouiller	,débrouillard	
distinguer	,distinctif	
absorber	,absorbant	
s’épuiser	,épuisable	
rire	,rieur	
désobéir	,désobéissant	
éducation	,éducable	
service	,serviable	
entreprendre	,entreprenant	
s’évaporer	,évaporable	
obéir	,obéissant	
s’enflammer	,inflammable	
ébahir	,ébahissant	
caprice	,capricieux	
malade	,maladif	
trouille	,trouillard	
compensation	,compensatoire	
bagarre	,bagarreur	
sale	,salissant	
partager	,partageur	
angoisse	,angoissé	
pleurer	,pleureur	
ramper	,rampant	,rampant	
envahir	,envahissant	
pécher	,peccable	
anglais	,anglophone	
crier	,criard	
avoir ses limites	,limité	
crainte	,craintif	
coopération	,coopératif	
charité	,charitable	
désespérer	,désespérant	
se soumettre	,soumis	
épouvanter	,épouvantable	
exciter	,excitant	
changer	,changeant	
compenser	,compensatoire	
espagnol	,hispanophone	
peur	,peureux	
inspirer	,inspirant	
risque	,risqué	
oublier	,oublieux	
voyager	,voyageur	
alarmer	,alarmant	
conserver	,conservateur	
voler	,volant	
agresser	,agressif	
incendie	,incendiaire	
bavarder	,bavard	
craindre	,craintif	
sport	,sportif	
mourir	,mortel	
amuser	,amusant	
réagir	,réactif	
frousse	,froussard	
attirer	,attractif	
rigoler	,rigoleur	
exploser	,explosible	
créer	,créatif	
casser	,cassant	
étouffer	,étouffant	
questionner	,questionneur	
résister	,résistant	
permettre	,permissif	
chinois	,sinophone	
se suicider	,suicidaire	
observer	,observateur	
cogner	,cogneur	
guérir	,guérissant	
rouler	,roulant	
aventure	,aventureux	,aventurier	
allemand	,germanophone	
dommages	,dommageable	
>>>	Able_2
définir	,définissable	
facture	,facturable	
améliorer	,améliorable	
détester	,détestable	
soupçonner	,soupçonnable	;suspect	
dater	,datable	
déprimer	,déprimant	
confort	,confortable	
citer	,citable	
mépris	,méprisable	
se passionner	,passionnant	
oublier	,oubliable	
gouverner	,gouvernable	
organiser	,organisable	
sympathie	,sympathique	,sympa	
imagination	,imaginable	
prévoir	,prévisible	
manger	,mangeable	,comestible	
opposer	,opposable	
exécuter	,exécutable	
épuiser	,épuisable	
traduire	,traduisible	
partager	,partageable	
juger	,jugeable	
orienter	,orientable	
deviner	,devinable	
douter	,douteux	
allonger	,allongeable	
cafard	,cafardeux	
se désoler	,désolant	
trouver	,trouvable	
admettre	,admissible	
achetable	,acheter	
repérer	,repérable	
vendre	,vendable	
franchir	,franchissable	
pardonner	,pardonnable	
supprimer	,supprimable	
boire	,buvable	
calcul	,calculable	
agacement	,agaçant	
débit	,débitable	
croire	,crédible	,crédible	
contrôler	,contrôlable	,contrôlable	
vaccin	,vaccinable	
réaliser	,réalisable	
inonder	,inondable	
compenser	,compensable	,compensable	
tempête	,exposé	
remuer	,remuable	
composer	,composable	
comprendre	,compréhensible	
digérer	,digérable	
expliquer	,explicable	
prolonger	,prolongeable	
écraser	,écrasable	
exporter	,exportable	
attirer	,attirable	
connaissance	,connaissable	
observer	,observable	
scier	,sciable	
glisser	,glissant	
acheter	,achetable	
nausée	,nauséeux	
tolérer	,tolérable	
plier	,pliable	,pliant	
régler	,réglable	
épouvante	,épouvantable	
loger	,logeable	
réalisation	,réalisable	,réalisable	
déplacer	,déplaçable	
classer	,classable	
respirer	,respirable	
bicyclette	,cyclable	
se marier	,mariable	
labourer	,labourable	,arable	
adopter	,adoptable	
ajuster	,ajustable	
réparer	,réparable	
mesurer	,mesurable	
administrer	,administrable	,administrable	
proposer	,proposable	
détacher	,détachable	
élire	,éligible	
nettoyer	,nettoyable	,nettoyable	,nettoyable	,nettoyable	
mépriser	,méprisable	
toucher	,touchable	
naviguer	,navigable	
détruire	,destructible	,destructible	
constater	,constatable	
explorer	,explorable	
accès	,accessible	
remplacer	,remplaçable	
multiplier	,multipliable	
déplier	,dépliable	,dépliant	
constatation	,constatable	
enseigner	,enseignable	
vélo	,cyclable	
décrire	,descriptible	
transformer	,transformable	
>>>	Anti_∩
voie	,cul-de-sac	
connaissance	,ignorance	
s’achever	,commencer	
tardivement	,tôt	,vite	
coup d’arrêt	,coup d’accélérateur	
léger	,gros	
relevé	,rabattu	
modeste	,prétentieux	,ambitieux	
tout	,rien	,personne	
ivre	,sobre	
côté	,dos	,ventre	
faux seins	,seins	
ouvrir la route	,bloquer	
tracassier	,arrangeant	
protecteur	,ennemi	
propre	,malpropre	,étranger	,malhonnête	,sale	
seul	,collectivement	,conjointement	
humour	,balai dans le cul	
petit	,long	
accélérer	,ralentir	
cul-de-sac	,passage	,voie	
fluide	,solide	
perdre	,trouver	,retrouver	
célibat	,couple	
détendu	,mal à l’aise	
s’allonger	,rétrécir	,diminuer	,diminuer	,diminuer	,se replier	,diminuer	
désencadrer	,encadrer	
mourir	,naître	
mal	,bien	,bien	,correctement	,convenablement	,honnêtement	
entrer	,flotter	
rouge	,blanc	;blême	;livide	;pâle	,vert	
svelte	,gros	,obèse	
partir	,aller	
silence	,information	
identiquement	,différemment	
respirer	,suffoquer	
rapetisser	,grandir	,allonger	
flasque	,dur	,ferme	
de	,à	
sifflets	,acclamations	
marcher sur la tête	,tourner rond	
distinct	,similaire	,analogue	
train de sénateur	,précipitation	
toujours	,parfois	,longtemps	
méprisable	,admirable	
avoir les deux pieds dans le même sabot	,se débrouiller	
compression	,dépression	
élever	,baisser	
se cacher	,se découvrir	
comme chien et chat	,ami	
gazeux	,liquide	,solide	
clarté	,obscurité	,ambiguïté	
déplacé	,convenable	,comme il faut	
prolixe	,bref	,concis	
obscurité	,clarté	
noyer	,assécher	
en herbe	,mûr	
pessimisme	,optimisme	
similitude	,dissimilarité	,différence	
entre deux eaux	,franc	
différent	,similaire	,analogue	,proche	
intelligent	,bête	,idiot	
méchanceté	,bonté	,gentillesse	
faux	,authentique	
prendre l’habit	,quitter la robe	
passage	,cul-de-sac	
honnêtement	,mal	
colorer	,décolorer	,décolorer	,décolorer	,décolorer	,décolorer	
gaieté	,tristesse	,tristesse	
jeune	,âgé	,vieux	,vieux	
coup de chaleur	,coup de froid	
fiction	,réel	
déplier	,replier	
vite	,lentement	,tardivement	
rudesse	,douceur	
peaufiner	,bâcler	
dissimilarité	,analogie	,ressemblance	,similitude	
chacun	,personne	
cauchemar	,rêve	
dynamisant	,affaiblissant	
y avoir du monde au balcon	,ne pas avoir de seins	
se dépêcher	,tarder	,traîner	
chaud	,froid	
repousser	,céder	
malpropre	,propre	
fierté	,honte	
bide	,tabac	
ancien	;prochain	;nouveau	,moderne	,futur	;proche	,récent	
fragilement	,solidement	
inerte	,réactif	
post-	,avant	
baisser les bras	,relever ses manches	;relever le gant	
déraison	,bon sens	
gonflé	,dégonflé	
tourner rond	,marcher sur la tête	
information	,silence	
médiocre	,extraordinaire	,remarquable	
lisse	,rugueux	
assécher	,noyer	
illusion	,réalité	
>>>	Real_1
seins	,donner	,allaiter	,donner le sein	;montrer	,dévoiler	
sondage	,sonder	
chatte	,avoir	,posséder	
lac	,remplir	
appartement	,habiter	,résider	,vivre	,loger	,occuper	
bancs	,siéger	
épingle	,épingler	
cadre	,respecter	
vin	,consommer	;déguster	;boire	,picoler	
xylophone	,faire	,jouer	
désert	,déserter	
fable	,dire	,raconter	,fabuler	
administrateur	,administrer	
bouchon d’oreille	,mettre	
roupillon	,piquer	
tampon	,avoir	,porter	
dent	,laver	,brossé	,entraîner	,montrer les dents	
personnel	,bosser	,œuvrer	,travailler	,travailler	
serviette	,essuyer	,sécher	,avoir	,porter	
coude	,plier	,replier	;déplier	
tarot	,jouer	
rame	,ramer	
tempête	,affronter	,braver	,défier	,lutter	,faire face	
banc	,asseoir	,occuper	,asseoir	,siéger	
orbite	,décrire	,orbiter	
Joyeux anniversaire	,chanter	
en danseuse	,pédaler	
ascenseur social	,bénéficier	,profiter	
chaussures	,avoir	,porter	
destin	,accomplir	
robe	,avoir	,porter	,porter	
habit	,avoir	,porter	,porter	,porter	
placard	,remplir	,afficher	,apposer	,coller	,placarder	,afficher	,apposer	,distribuer	
gibier	,chasser	
marché de Noël	,aller	,visiter	
goûter	,goûter	
éventail	,agiter	
dette	;honorer	,régler	;acquitter	,payer	
toilette	,avoir	,porter	
escargots	,manger	
vêtements	,porter	;avoir	
train	,voyager	,prendre	,assurer	
volet	,fermer	
mail	,se promener	
bélier	,enfoncer	
klaxon	,actionner	,klaxonner	
tabouret	,asseoir	,occuper	
laitue	,manger	
mayonnaise	,consommer	,manger	
route	,marcher	,rouler	;sillonner	,suivre	,prendre	,faire	,emprunter	;découvrir	,se promener	,visiter	
baragouin	,baragouiner	
cravate	,avoir	,porter	;porter	;arborer	
pays	,habiter	,vivre	,habiter	,vivre	
couleurs	,afficher	;arborer	,porter	
citation	,reprendre	;emprunter	
atome	,maîtriser	;dominer	
gorge	,couler	
mot	,prononcer	,écrire	
histoire	,raconter	
cheval	,manger	
chasse-mouche	,utiliser	
jogging	,avoir	,porter	
jeu	,tirer	
douche	,doucher	,se doucher	
pipe	,fumer	
armoire	,remplir	
vêtement	,porter	;avoir	
couvercle	,mettre	
escalier	,gravir	,grimper	,monter	;descendre	
peur	,céder	,succomber	,trembler	,pâlir	,s’évanouir	,hurler	
savon	,savonner	;se laver	,se savonner	
relâche	,faire	
affiche	,afficher	
accent	,mettre	,accentuer	,mettre	,accentuer	
gants	,enfiler	
maison	,habiter	
punaise	,enfoncer	;punaiser	
oreilles	,entendre	,distinguer	,saisir	
pédales	,appuyer	
drap	,dormir	
marche	,faire	,participer	<ouvrir	,fermer	,faire	,composer	,monter	
bifteck	,manger	,gagner	
escargot	,élever	;ramasser	
manteau	,avoir	,porter	
côte	,grimper	
cadavre	,enterrer	,inhumer	
balai	,passer	;manier	;jouer	,passer	
têtu	,s’entêter	
narine	,respirer	;inspirer	;expirer	
mesure	,prendre	
vin chaud	,boire	,avaler	
dortoir	,dormir	
plateau	,porter	;apporter	,transporter	,manger	
voie	,passer	,emprunter	,prendre	,faire	;grimper	,gravir	
vitesse	,passer	
camion	,conduire	
chewing-gum	,mâcher	
pioche	,piocher	
pédale	,appuyer	,actionner	,appuyer	
alcool	;consommer	;boire	,picoler	,boire	,picoler	,s’alcooliser	
>>>	V_0
étreinte	,étreindre	,étreindre	,étreindre	
enfilage	,enfiler	
prostitution	,se prostituer	
accentuation	,accentuer	,accentuer	,s’accentuer	,accentuer	
doute	,douter	
option	,opter	
passage	,passer	,passer	,passer	,passer	,passer	
émigration	,émigrer	
protestation	,protester	
embarquement	,embarquer	
jouissance	,jouir	,jouir	
flottement	,flotter	
bénédiction	,bénir	
direction	,diriger	
massage	,masser	
amélioration	,améliorer	,s’améliorer	
dîner	,dîner	
confrontation	,confronter	
exceptionnellement	,excepter	
envoi	,envoyer	
aération	,aérer	
attrapeur	,attraper	
adaptatif	,s’adapter	
prolongation	,prolonger	
soumission	,se soumettre	,soumettre	
affolement	,affoler	,s’affoler	
révélation	,révéler	
liaison	,lier	,se lier	
attente	,attendre	
déroulement	,dérouler	,se dérouler	
passage à tabac	,passer à tabac	
cigare	,fumer	
pesée	,peser	
contribution	,contribuer	
rigolade	,rigoler	
aspiration	,aspirer	
vantardise	,se vanter	
chatouilles	,chatouiller	
domination	,dominer	
frimeur	,frimer	
incorporation	,incorporer	,incorporer	
dressage	,dresser	
triage	,trier	
manquement	,manquer	
toucher	,toucher	
rétrécissement	,rétrécir	,rétrécir	
combat	,combattre	,se battre	
érotisation	,érotiser	
simplifiable	,simplifier	
exaspération	,exaspérer	
consolation	,consoler	
alimentation	,alimenter	
pansement	,panser	
invitation	,inviter	
gazouillement	,gazouiller	
onirique	,rêver	
barrissement	,barrir	
séduction	,séduire	
installation	,installer	,installer	
permission	,permettre	
recommandation	,recommander	
encombrement	,encombrer	
rédaction	,rédiger	
annonce	,annoncer	
accompagnement	,accompagner	,accompagner	,accompagner	
ralentissement	,ralentir	
triche	,tricher	
raccompagnement	,raccompagner	
consultation	,consulter	
pet	,péter	
kidnappage	,kidnapper	
visite	,visiter	,visiter	
débat	,débattre	,débattre	
dépense	,dépenser	
proposition	,proposer	
commandement	,commander	
disposition	,disposer	,se disposer	
défilement	,défiler	
dévoration	,dévorer	,dévorer	
refroidissement	,refroidir	,refroidir	
protection	,protéger	,protéger	
extinction	,éteindre	
enculage de mouches	,enculer les mouches	
succion	,sucer	
rajout	,rajouter	
télécommande	,télécommander	
éloge	,louer	
broyage	,broyer	
sauveur	,sauver	,sauver	
alimenté	,alimenter	
allumage	,allumer	
regard	,regarder	
détermination	,déterminer	
empoisonnement	,empoisonner	
crevaison	,crever	
indice	,indiquer	
invention	,inventer	
maltraitance	,maltraiter	
jeûne	,jeûner	
péché	,pécher	
>>>	S_3
course	,taxi	;fiacre	
différence	,différence	
tirage	,tirage	
appareiller	,appareil	
boucher	,client	,cliente	
abandonner	,sportif	,sportive	
lectorat	,éditeur	
bilan	,patient	
juger	,délit	;crime	,jugement	,jugement	;avis	,opinion	
papeterie	,papier	
bagage	,domaine	,discipline	
réaction	,réaction	,réaction	
coup de grâce	,coup de grâce	
alimenter	,aliment	
panser	,pansement	
attaché	,attache	
maire	,administré	,administrée	
similitude	,similitude	,point commun	
loyer	,location	
racket	,victime	
péage	,péagiste	,péagiste	
consolation	,consolation	
boulangère	,client	,cliente	
débitrice	,dette	
épicerie	,client	,cliente	
théâtre	,public	
pansement	,pansement	
diriger	,direction	
collège	,collégien	,collégienne	
couleur	,poker	
bijouterie	,client	,cliente	
bombarder	,bombe	,bombardier	
multiplier	,multiplicateur	
musique	,auditeur	,auditrice	
subvention	,subvention	
voler	,volé	
plateau	,tir	;ball-trap	
juge	,tribunal	
hypermarché	,client	,cliente	,clientèle	
gommer	,gomme	
mairie	,administré	,administrée	
travailler	,employeur	,employeuse	,patron	,patronne	;employeur	
accès	,accès	
remédier	,remède	,remède	
colis	,destinataire	,destinataire	
visiter	,affaires	;charité	
addition	,client	,cliente	
touche	,tournoi	
pâtisserie	,cliente	,client	
accentuation	,accent	,accent	
vendre	,acheteur	;acheteuse	
unanimité	,élection	;vote	
voter	,élection	
expédier	,destinataire	,destinataire	
nettoyage	,nettoyeur	
carré	,jardin	,potager	
inspecteur	,inspection	
coiffer	,coiffure	
poissonnerie	,client	,cliente	
menuisier	,bois	
combat	,sport de combat	
envoi	,destinataire	,destinataire	
arracher	,arracheuse	
boîte aux lettres	;courrier	
enveloppe	,destinataire	,destinataire	,bénéficiaire	,bénéficiaire	
imposer	,impôt	
leçon	,élève	,élève	,collégien	,collégienne	,lycéen	,lycéenne	,étudiant	,étudiante	
baraque à frites	,cliente	,client	
victoire	,bataille	;guerre	
fonder	,fondement	
honneur	,honneur	
coiffage	,peigne	,brosse	
récompense	,récompense	
taille	,vêtement	
bus	,arrêt	
tailler	,vêtement	
discuter	,sujet	,thème	
différer	,différence	
criminel	,victime	
film	,acteur	,actrice	,comédien	,comédienne	
charcuterie	,client	,cliente	
comprimé	,substance active	
botter les fesses	,faute	
arnaquer	,arnaque	
vocabulaire	,langue	
débiteur	,dette	
restaurant	,clientèle	;client	,cliente	
clinique	,soins	
tracasser	,tracasserie	
compte	,banque	
encadrer	,cadre	
se lier	,molécule	
timbre	,colis	;enveloppe	,lettre	
plein	,véhicule	
apprendre	,élève	,élève	,étudiante	,étudiant	,expérience	
explication	,explication	
cirer	,cire	
piéger	,piège	
habiller	,habits	,vêtements	
déshabiller	,habits	,vêtements	
>>>	A_1
tolérance	,tolérant	
frisson	,frissonnant	,frissonnant	,frissonnant	
admirer	,admiratif	
orgueil	,orgueilleux	
admiration	,transporté	<soulevé	,rempli	,admiratif	<plein	,en	
dormir	,endormi	,dormant	,endormi	,dormant	
domicile	,domicilié	
modifier	,modificateur	,modificatif	,modifiant	
collaborer	,collaborateur	
parfum	,parfumé	
bronchite	,bronchiteux	
participer	,participant	
tuerie	,délicieux	
ami	,ami	
coller	,collant	
séduire	,séduisant	,séduisant	
énormité	,énorme	
migraine	,migraineux	
hépatique	,hépatique	,hépatique	
faux	,faux	
brutalité	,brutal	
gémir	,gémissant	
mystère	,mystérieux	
extravagante	,extravagant	
bois	,boisé	
agressivité	,agressif	
bonne à rien	,bon à rien	
songer	,songeur	
maladresse	,maladroit	
déterminer	,déterminant	
réactivité	,réactif	
Turc	,turc	
avare	,avare	,avare	
légèreté	,léger	
vieillir	,vieillissant	
mélancolie	,mélancolique	,mélancolique	
saint	,saint	
bienveillance	,bienveillant	
imminence	,imminent	
ressembler	,ressemblant	
anorexie	,anorexique	
esclave	,esclave	,esclave	,esclave	
pertinence	,pertinent	
couleurs	,coloré	
rareté	,rare	,rare	
encombrer	,encombrant	
enthousiasme	,enthousiaste	
conversation	,en	<plongé	
fortune	,fortuné	
insister	,insistant	
désolation	,désolé	
droitier	,droitier	
gaspiller	,gaspilleur	
effroi	,effrayé	
accident	,accidenté	
Bretonne	,breton	
cancer	,cancéreux	
origine	,originel	
nuage	,nuageux	
boiteux	,boiteux	
pus	,purulent	
rhume	,enrhumé	
bizarrerie	,bizarre	
Moyen-Âge	,médiéval	
Japonais	,japonais	
décourager	,décourageant	
avec	,accompagné	
avancer	,avancé	,avancé	
exactitude	,exact	
se situer	,situé	
handicap	,handicapé	
ravissement	,ravi	
remplir	,rempli	
éloge	,élogieux	
complexe	,complexé	
tombeau	,décédé	,défunt	,mort	
oubliettes	,à	
déplacement	,en	,en	
se désespérer	,désespéré	
étrangeté	,étrange	
fleurir	,fleurissant	
main verte	,à	
creuser	,creusé	
Coréenne	,coréen	
déprimer	,déprimé	
déraison	,déraisonnable	
condamnée	,condamné	
désespérer	,désespéré	
valet	,soumis	
États-unienne	,États-unien	
force	,fort	
réticence	,réticent	
goût	,sapide	;à	
gravier	,graveleux	
ronger	,rongeur	
héros	,héroïque	
évidence	,évident	
possessivité	,possessif	
ne plus tenir debout	,fatigué	
gallois	,gallois	
>>>	S_2^prototyp
cadre	,entreprise	,parti	,armée	
mise en scène	,photographe	,photographe	
balayer	,nuage	
avoir des nouvelles	,avocat	
pièce d’ameublement	,pièce	;appartement	,maison	
compatir	,douleur	;malheur	;tristesse	
fondant	,chocolat	
habit	,catholicisme	,bouddhisme	
apprendre	,savoir	;discipline	
poteaux	,rugby	
élément	,société	,armée	
personne	,âgé	,seul	
embarquer	,véhicule	
paille	,boisson	
présure	,lait	
baguettes	,riz	
plaque	,épitaphe	
colis abandonné	,train	
transporté	,admiration	
champ	,blé	,formulaire	,arme à feu	
ébloui	,lumière	
hisser	,voile	;drapeau	
moelleux	,chocolat	,citron	,orange	
tourner	,film	
racine de bruyère	,pipe	
culture	,plante	
régime	,sujet	,objet	
éléments de langage	,politicien	,politicienne	
célébrante	,mariage	;messe	
aéroporté	,avion	,hélicoptère	
escalader	,montagne	;rocher	,col	,côte	
réserviste	,armée	,police	
partie	,chasse	,pêche	
élément de langage	,politicien	,politicienne	
machine à coudre	,tissu	
gratter	,guitare	,gratte	
main gauche	,instrument de musique	
amarre	,bateau	
fondre	,sentiment	,sensation	
analogie	,organe	
baguette	,bois	
fonder	,famille	
fumeur	,cigare	,cigarette	,pipe	;tabac	
gauche	,cœur	
bol	,soupe	
conducteur	,voiture	,véhicule	,automobile	,moto	,auto	,autobus	,autocar	,bus	,camion	,car	,métro	,train	,tramway	
amputation	,membre	
porter	,vêtement	;pièce d’habillement	
produire	,papiers	
posture	,yoga	
essence	,véhicule	
cracher	,chewing-gum	
confisquer	,antenne	
hold-up	,banque	;bijouterie	;magasin	
cultiver	,plante	
assis	,siège	,fauteuil	,chaise	
rôti	,bœuf	,porc	
collaboration	,Allemand	
casque	,ordinateur	,télévision	,baladeur	
se coucher	,lit	
panier	,basket	
robinet	,eau	;gaz	;fluide	
bétonné	,béton	
envoi	,colis	,lettre	
s’allonger	,lit	
lait	,nourrisson	;bébé	,enfant	,enfant	,nouveau-né	,nouvelle-née	;petit	,petite	
clafoutis	,cerise	
monopoliser	,antenne	
lin	,huile	;huile	
design	,meuble	;site	
station	,bus	,métro	
infirmerie	,patient	,patiente	,malade	,malade	
jambe	,porc	;bœuf	
péage	,autoroute	
escalade	,montagne	;rocher	,col	,côte	
tabac	,tabac	
simplifier	,expression	,fraction	
célébrer	,mariage	;messe	
patins	,luge	
éplucher	,document	
mobiler	,pièce	
bracelet	,chevilles	;poignet	
fumeuse	,cigare	,cigarette	,pipe	;tabac	
plan	,film	
conduire	,auto	,moto	,automobile	,train	,voiture	,véhicule	
geler	,salaire	
métro	,terminus	
parapluie	,pluie	
battre	,adversaire	,adversaire	,compétitrice	,compétiteur	;record	,carte	,campagne	,sentier	,chemin	,crème	,pâte	,fer	,blé	,ennemi	
s’éponger	,front	
porteur	,chèque	
bonbec	,sucre	
nez	,fruit	,fruit rouge	,cerise	,framboise	;épice	
piste	,aéroport	
croquant	,amande	,noisette	
nappe	,table	
siège	,ville	
miellerie	,miel	
boulanger	,pain	;viennoiserie	
chaussée	,véhicule roulant	,véhicule	
>>>	Syn_⊃^sex
combattant du feu	,combattante du feu	
fiancé	,fiancée	
chat	,chatte	
buraliste	,buraliste	
garde	,garde	
continental	,continentale	
banquier	,banquière	
provocateur	,provocatrice	
magicienne	,magicien	
empoté	,empotée	
invité	,invitée	
organisateur	,organisatrice	
clandestin	,clandestine	
ex	,ex	
homme politique	,femme politique	
brun	,brune	
installateur	,installatrice	
saint	,sainte	
responsable	,responsable	
diagnostiqueur	,diagnostiqueuse	
pêcheur	,pêcheuse	
kidnappé	,kidnappée	
bodybuilder	,bodybuildeuse	
Québécois	,Québécoise	
cigarier	,cigarière	
reporter	,reporter	,reportrice	
encadreur	,encadreuse	
dîneur	,dîneuse	
Espagnol	,Espagnole	
intervieweur	,intervieweuse	
anxieux	,anxieuse	
chaisier	,chaisière	
ambitieux	,ambitieuse	
vigneron	,vigneronne	
entrepreneur	,entrepreneuse	
chef de bord	,chef de bord	
sportif	,sportive	
collègue	,collègue	
administrateur	,administratrice	
formateur	,formatrice	
citadin	,citadine	
communiste	,communiste	
raté	,ratée	
débutant	,débutante	
étudiant	,étudiante	
survivant	,survivante	
vivant	,vivante	
exposant	,exposante	
compétiteur	,compétitrice	
déclarant	,déclarante	
recruteur	,recruteuse	
sourd	,sourde	
pompiste	,pompiste	
pompier	,pompier	,femme pompier	,pompière	
taulard	,taularde	
allié	,alliée	
trafiquant	,trafiquante	
laboureur	,laboureuse	
émigré	,émigrée	
chauve	,chauve	
hypnotiseur	,hypnotiseuse	
fonctionnaire	,fonctionnaire	
manieur	,manieuse	
créateur	,créatrice	
maquilleur	,maquilleuse	
tireur	,tireuse	
israélite	,israélite	
voyant	,voyante	
enthousiaste	,enthousiaste	,enthousiaste	
imaginatif	,imaginative	
vilain	,vilaine	
patient	,patiente	
parlementaire	,parlementaire	
accidenté	,accidentée	
hôtelier	,hôtelière	
guetteur	,guetteuse	
commerçant	,commerçante	
paralytique	,paralytique	
âne	,ânesse	
hépatique	,hépatique	
agressé	,agressée	
Américain	,Américaine	,Américaine	
rabat-joie	,rabat-joie	
pensionné	,pensionnée	
animateur	,animatrice	,animatrice	
intime	,intime	
misogyne	,misogyne	
masseur	,masseuse	
magistrat	,magistrate	
médecin-major	,médecin-major	
préfet	,préfète	
vengeur	,vengeresse	
collabo	,collaboratrice	,collabo	
météorologue	,météorologue	
raccommodeur	,raccommodeuse	
directeur	,directrice	
droitier	,droitière	
récoltant	,récoltante	
imbécile	,imbécile	
expéditeur	,expéditrice	
>>>	Adv_0
profitable	,profitablement	
nuit	,nuitamment	
exact	,exactement	
immédiat	,immédiatement	
histoire	,historiquement	
timidité	,timidement	
sain	,sainement	
famille	,familialement	,familialement	
innocent	,innocemment	
allégresse	,allègrement	
quotidien	,quotidiennement	
lenteur	,lentement	
clandestin	,clandestinement	
superficiel	,superficiellement	
isolé	,isolément	
banal	,banalement	
anonyme	,anonymement	
horizontal	,horizontalement	
molécule	,moléculairement	
pertinent	,pertinemment	
comparer	,comparativement	
informatique	,informatiquement	
proportionnel	,proportionnellement	
synthétique	,synthétiquement	
uniforme	,uniformément	
force	,fort	,fortement	
urgent	,urgemment	
amical	,amicalement	
lamentable	,lamentablement	
nombre	,numériquement	,numériquement	
délicieux	,délicieusement	
collectif	,collectivement	
subtil	,subtilement	
scène	,scéniquement	
prudent	,prudemment	
fille	,filialement	
réalité	,réellement	
brutal	,brutalement	
inconscient	,inconsciemment	
torrentiel	,torrentiellement	
digne	,dignement	
pratique	,pratiquement	
religieux	,religieusement	,religieusement	
imaginaire	,imaginairement	
incroyable	,incroyablement	
gué	,à gué	
religion	,religieusement	
suffire	,suffisamment	
bien	,bien	
initial	,initialement	
national	,nationalement	
illisible	,illisiblement	
furieux	,furieusement	
tourisme	,touristiquement	
allusif	,allusivement	
semblable	,semblablement	
miel	,mielleusement	
excentricité	,excentriquement	,excentriquement	
identique	,identiquement	
supplément	,supplémentairement	
géographie	,géographiquement	
cérébral	,cérébralement	
contraire	,contrairement	
éternel	,éternellement	
extrême	,extrêmement	
voix	,vocalement	
géométrie	,géométriquement	
courant	,couramment	
humble	,humblement	
danger	,dangereusement	
frileux	,frileusement	
exception	,exceptionnellement	,exceptionnellement	
militaire	,militairement	
conceptuel	,conceptuellement	
invincible	,invinciblement	
solide	,solidement	
acceptable	,acceptablement	
diabolique	,diaboliquement	
moral	,moralement	
vaste	,vastement	
obligatoire	,obligatoirement	
superbe	,superbement	
artificiel	,artificiellement	
moléculaire	,moléculairement	
méchant	,méchamment	
philosophie	,philosophiquement	
inverse	,inversement	
moyen	,en moyenne	,moyennement	
oblique	,obliquement	
musculaire	,musculairement	
concept	,conceptuellement	
savant	,savamment	,savamment	
effectif	,effectivement	
bizarrerie	,bizarrement	
synthétiser	,synthétiquement	
ordinaire	,ordinairement	
expérience	,expérimentalement	
lent	,lentement	
grossier	,grossièrement	,grossièrement	
certain	,certainement	
>>>	S_instr
klaxonner	,klaxon	
allaiter	,seins	
coiffeuse	,ciseaux	;brosse	,peigne	;sèche-cheveux	
lavis	,pinceau	
imprimer	,presse	;imprimante	
imaginer	,imagination	
musique	,instrument de musique	,instrument de musique	,instrument de musique	
klaxon	,klaxon	
communication	,téléphone	
harnacher	,harnais	
dentiste	,davier	;fraise	;roulette	,davier	;fraise	;roulette	
coiffeur	,ciseaux	;brosse	,peigne	;sèche-cheveux	
odorat	,nez	,nez	
se baigner	,baignoire	
goût	,langue	;papilles	;palais	
distinguer	,oreilles	
jogging	,baskets	
se moucher	,mouchoir	;doigt	
plage	;parasol	,paillasse	,tapis de plage	;maillot	,serviette	;bouée	,palmes	,masque	,tuba	
crucifier	,croix	
plein	,pompe	
basket	,ballon	;panier	
volley-ball	,ballon	;filet	
coup de poing	,coup de poing	
boulangère	,pétrin	;four	
sucer	,bouche	,lèvres	,bouche	
judo	,kimono	,judogi	
chant	,larynx	,corde vocale	
se laver	,lavabo	,baignoire	,douche	;savon	,gel douche	
douche	,douche	;fleur de douche	
violon	,archet	
médecin	,stéthoscope	,stéthoscope	
déboucher	,tire-bouchon	
coudre	,dé à coudre	;machine à coudre	,machine à coudre	
badminton	,volant	;raquette	
skier	,skis	
faire de l’essence	,pompe	
matraquer	,matraque	
moudre	,moulin	;moulin à café	
gauche	,main gauche	
escalade	,bicyclette	,vélo	
cirer	,cire	,cirage	
laver	,douche	,baignoire	,lavabo	
prêcher	,sermon	
dormir	,lit	
droit	,main droite	
boulanger	;pétrin	;four	
ski	;bâton	;chaussures	;skis	
crime	,arme	
droite	,main droite	
mécanicienne	,outil	
menotter	,menottes	
clôturer	,clôture	
hold-up	,arme	
aller	,moyen de transport	
courriel	;boîte mail	;serveur	
respirer	,nez	,narines	,narine	
tourner	,caméra	
bain	,baignoire	
voler	,aile	,avion	,avion	
voiture	,voiture	
éventer	,éventail	
téléphoner	,téléphone	
flûte	,flûte	
rugby	,ballon	;buts	,poteaux	
mécanicien	,outil	
crayonner	,crayon	
entendre	,oreilles	
donner le sein	,seins	
uriner	,urinoir	;toilettes	
mesurer	,règle	,mètre	;instrument de mesure	
nourrir	,seins	
tout oreilles	,oreilles	
tennis	,balle	;raquette	;filet	
piquer	,seringue	
seller	,selle	
condamner	,jugement	,verdict	
boxeur	,gants	
s’éventer	,éventail	
battre	,fouet	,batteuse	
zapper	,télécommande	
bouchère	,couteau	;crochet	
bêcher	,bêche	
football	,ballon	;buts	,cage	
coup de couteau	,couteau	
trajet	,bus	,tramway	
pompier	,camion	;lance	;bouche d’incendie	,camion	;lance	;bouche d’incendie	
triangle	,baguettes	
se doucher	,douche	
pieuter	,lit	,pieu	,paddock	,pageot	
ramer	,rame	,rame	
mesure	,mètre	,règle	;instrument de mesure	
se réveiller	,réveil	
poignarder	,poignard	
chanter	,corde vocale	,larynx	,larynx	,corde vocale	
toilette	,gant de toilette	,linge	,objet	,parure	;gel douche	,produit	,savon	;affaires	,nécessaire	
doucher	,douche	
ping-pong	,balle	;raquette	;ping-pong	,table de ping-pong	
boucher	,couteau	;crochet	,esse	
renifler	,nez	;nez	
>>>	Syn_⊂
coup de chien	,tempête	
compliquer	,causer	
douze	,douzaine	
marin	,aquatique	
dernier carré	,ensemble	
cracra	,sale	,sale	,sale	,sale	,sale	
courir la gueuse	,draguer	
clinique	,hôpital	
hi-han	,braiment	
accuser le coup	,subir	,subir	
parcours du combattant	,équipement	
crottin	,fumier	
dans un mouchoir de poche	,proche	
sorte	,type	
document	,document	
se retourner dans sa tombe	,s’indigner	
réunion publique	,réunion	
mausolée	,tombeau	
appuyer	,placer	
se taper la cloche	,manger	
ski de vitesse	,skis	,ski	
subdivision	,division	,partie	
en deux coups de cuillère à pot	,rapidement	
abattre	,rabattre	,assassiner	
logico-mathématique	,logique	;mathématique	
botter les fesses	,frapper	
casserole	,voiture	
national	,citoyen	
en portefeuille	,plié	
voler en éclats	,casser	
aspirateur	,utilitaire	
catastrophe naturelle	,catastrophe	
coup de boutoir	,slogan	
grappe	,ensemble	,grappe	
carcinome	,cancer	
posture	,position	
coup de grisou	,explosion	
carrosse	,voiture	
convention	,accord	
épisode	,partie	
transport	,déplacement	
cacher son jeu	,dissimuler	
rareté	,objet	
importance	,quantité	
blonde	,cigarette	
ru	,ruisseau	
vacherie	,étable	,propos	
déambulation	,marche	
saigner	,tuer	
assimilable	,similaire	
mouchoir de poche	,mouchoir	,espace	
petit-déjeuner	,repas	,manger	,bouffer	,repas	
dégueu	,sale	<cracra	,crade	,cradingue	,crado	,cradoque	,craspec	,crasseux	,sale	<cracra	,crade	,cradingue	,crado	,cradoque	,sale	<cracra	,crasseux	,crade	,cradingue	,crado	,cradoque	
fou rire	,rire	
chaisière	,chaisier	
se surveiller	,faire attention	
panique	,peur	
lessiver	,laver	
pilier	,jambes	
VTC	,vélo	
casser les oreilles	,agacer	,casser les pieds	
grippé	,malade	
glisse	,déplacement	
beurrer	,tartiner	
sujet	,individu	,spécimen	
filer	,étirer	
mini	,petit	
aéronef	,véhicule	
soixante-dizaine	,soixante-dix	
domicile conjugal	,domicile	
madame tout le monde	,quelqu’un	
spam	,courriel	
pilleur	,voleur	
gourou	,chef	
convenu	,décidé	
pataugeoire	,piscine	
mandibule	,mâchoires	
en coup de vent	,rapidement	
millier	,mille	
réalisation	,transformation	
divagation	,propos	
rubis	,rouge	,rouge	
vapeur	,bateau	
cisailler	,couper	
boîte crânienne	,crâne	
bons pères	,religieux	
s’éteindre	,mourir	,décéder	,disparaître	,périr	,perdre la vie	,casser sa pipe	,clamser	,crever	,trépasser	
portée	,distance	
préfecture	,ville	
réfléchir	,penser	
ouragan	,vent	
navet	,film	
compte de titres	,compte	
se livrer	,faire	
course	,course	,déplacement	,déplacement	
larguer les amarres	,partir	
patienter	,attendre	
zapper	,ignorer	
émetteur	,antenne	
faire l’idiot	,se comporter	
>>>	Syn
hôtesse	,hôte	
pub	,publicité	
océane	,océanique	
Toile	,Internet	
conjugal	,marital	
edelweiss	,étoile d’argent	
reprise	,round	
costume	,costard	
aspirer	,inspirer	
cibiche	,sèche	,cancéreuse	,cigarette	,clope	,garo	,tige	,schmer	
mille cinq cents	,1500	
Suissesse	,Suisse	
clodo	,clochard	,clocharde	
arpion	,panards	,pieds	,ripatons	
bac	,bachot	,baccalauréat	
tuer père et mère	,vendre père et mère	
Merde !	,miel	
éructation	,rot	
instit	,instituteur	,institutrice	
droit	,droite	
roi	,monarque	,souverain	
longueur	,saut en longueur	
dedans	,à l’intérieur	
gerbe d’or	,hélianthème	
heuchère	,désespoir des peintres	
tempête magnétique	,orage magnétique	
sans en avoir l’air	,l’air de rien	
joie	,plaisir	
stature	,taille	
service du chiffre	,chiffre	
noble art	,boxe	
cramé	,brûlé	
parterre	,sol	,champ	
passerose	,rose trémière	
pointe du jour	,aube	
souverain pontife	,pape	,Saint-Père	
cafetière	,caboche	,ciboulot	,cigare	,cerveau	,cervelle	,crâne	,tête	
réveil-matin	,réveil	
tailler une veste	,tailler un costume	
canin	,cyno-	
en-cas	,collation	
chaise haute	,chaise de bébé	
frapper du poing sur la table	,mettre le poing sur la table	,taper du poing sur la table	
mimine	,menotte	
météorologiste	,météorologue	,météorologue	
crever	,casser sa pipe	,clamser	,trépasser	,décéder	,disparaître	,mourir	,perdre la vie	,périr	
F10	,dix-pièces	,T10	
alarme	,système d’alarme	
en écraser	,ronfler	
furibard	,furibond	
vieille	,vioque	
chaise longue	,transat	,transatlantique	
bâtiment et travaux publics	,BTP	
fiancée	,promise	,payse	
linge	,petit linge	
se vêtir	,se fringuer	,s’habiller	,se saper	
dictionnaire	,dico	
pébroque	,pépin	,riflard	,parapluie	
table à repasser	,planche à repasser	
politicienne	,femme politique	
plumard	,paddock	,pageot	,pieu	,pucier	,dodo	,lit	
n’y avoir que	,suffire	
yogourt	,yaourt	,yaourt	
bécane	,meule	,motocyclette	,moto	
bord	,rive	
chibre	,biroute	,bite	,pine	,queue	,zob	,bistouquette	,braquemart	,manche	,membre	,nouille	,teub	,moineau	,quéquette	,zigounette	,zizi	,pénis	,verge	
à fond	,à fond de train	,à fond la caisse	,à fond les ballons	,à fond les manettes	
s’éveiller	,se réveiller	
labour	,labourage	
Las !	,Hélas !	
à fond les ballons	,à fond	,à fond de train	,à fond la caisse	,à fond les manettes	
fesse	,cul	
songe	,rêve	
construire	,bâtir	
femme pasteur	,pasteure	
s’acheminer	,se diriger	,se diriger	
frérot	,frangin	,frère	
apéritif	,apéro	,apéro	
mayo	,mayonnaise	
toubib	,doc	,docteur	,médecin	,doc	,doctoresse	,docteure	,femme médecin	,médecin	
se ramasser	,prendre	,ramasser	,se manger	,se prendre	
cigarette	,cibiche	,garo	,clope	,tige	,schmer	,sèche	,cancéreuse	
Bon app’!	,Bon appétit	
femme pompier	,pompier	,sapeur-pompier	,pompière	,sapeuse-pompière	
pipi-room	,tinettes	,vécés	,wawas	,cabinets	,petit coin	,toilettes	,W.-C.	,waters	,water-closet	,cagoinces	,chiottes	,goguenots	,gogues	,tartisses	,cabinet d’aisances	,commodités	,lieux d’aisances	,sanitaires	
émetteur	,destinateur	
décélérer	,ralentir	,ralentir	
costume-cravate	,costard-cravate	
du gâteau	,de la tarte	
kidnapping	,kidnappage	
bachot	,bac	,baccalauréat	
cradoque	,crasseux	,crado	,cracra	,cradingue	,craspec	,crade	,cracra	,crade	,cradingue	,crado	,cracra	,crade	,cradingue	,crado	,craspec	,crasseux	,cracra	,crade	,cradingue	,crado	,crasseux	,cracra	,crade	,cradingue	,crado	,craspec	,cradingue	
coup de bigophone	,coup de fil	,appel	,coup de téléphone	
auto-stop	,stop	
éducateur	,éduc	,éducatif	
embellir	,s’embellir	
fellation	,pipe	,pompier	,turlute	
e-mail	,mail	,mél	,courriel	,courrier électronique	,mail	,adresse courriel	,adresse de courrier électronique	,adresse électronique	,adresse e-mail	,adresse mail	,mél	,courriel	,courrier électronique	,mail	,mél	
oral	,langage oral	
Mars	,planète rouge	
>>>	S_1Pred
enfant	,enfant	,enfant	
muet	,muet	,muette	
suédois	,Suédois	,Suédoise	
célibataire	,célibataire	,célibataire	
incontournable	,incontournable	,incontournable	
mineur	,mineur	,mineure	
blessé	,blessé	,blessée	
têtu	,têtu	,têtue	<entêté	,entêtée	;cabochard	,cabocharde	,tête de mule	,tête de cochon	
chinois	,Chinoise	,Chinois	
inconnu	,inconnu	,inconnue	
autochtone	,autochtone	,autochtone	
chauve	,chauve	,chauve	
milliardaire	,milliardaire	,milliardaire	
asiatique	,Asiatique	,Asiatique	
nord-américain	,Nord-Américain	,Nord-Américaine	
fort	,fort	
inconscient	,inconscient	,inconsciente	
symptomatique	,symptôme	,symptôme	
affirmatif	,affirmative	
beau	,beauté	
original	,original	,original	
coco	,coco	,coco	
garant	,garant	,garante	
angliche	,Angliche	,Angliche	
favori	,favori	,favorite	
aveugle	,aveugle	,aveugle	
frisé	,frisé	,frisée	
européen	,Européen	,Européenne	
voyant	,voyant	,voyante	
héroïque	,héros	,héroïne	
timide	,timide	,timide	
fouetteur	,fouetteur	,fouetteuse	
australien	,Australien	,Australienne	
musulman	,musulman	,musulmane	
lâche	,lâche	,lâche	
arabe	,Arabe	,Arabe	
gentil	,gentil	,gentille	
sud-américain	,Sud-Américain	,Sud-Américaine	
riverain	,riverain	,riveraine	
suisse	,Suisse	,Suisse	,Suissesse	
communiste	,communiste	,communiste	
germanique	,Germanique	,Germanique	
futé	,futé	,futée	
coréen	,Coréen	,Coréenne	
franc	,Franc	
végétarien	,végétarien	,végétarienne	
mauvais	,mauvais	
boulimique	,boulimique	,boulimique	
accidenté	,accidenté	,accidentée	
chleuh	,Chleuh	,Chleuh	,Chleuh	,Chleuh	
germanophone	,germanophone	,germanophone	
célèbre	,célébrité	
titulaire	,titulaire	
belge	,Belge	,Belge	
ingrat	,ingrat	,ingrate	
bienheureux	,bienheureux	
solide	,solide	
tentateur	,tentateur	,tentatrice	
cul-de-jatte	,cul-de-jatte	,cul-de-jatte	
impair	,nombre	;chiffre	
irlandais	,Irlandais	,Irlandaise	
coupable	,coupable	,coupable	
merveilleux	,merveille	
protestant	,protestant	,protestante	
canadien	,Canadien	,Canadienne	
idiot	,idiot	,idiote	
court	,vin	
infirme	,infirme	,infirme	
acquéreur	,acquéreur	
femelle	,femelle	
myope	,myope	,myope	
anglophone	,anglophone	,anglophone	
bavard	,bavarde	,bavard	
fabulateur	,fabulateur	,fabulatrice	
rival	,rival	;rivale	
gourmand	,gourmand	,gourmande	
connerie	,con	
indien	,Indien	,Indienne	,Indien	,Indienne	
féminin	,femme	
débutant	,débutant	,débutante	
moche	,moche	,moche	;mocheté	
boche	,Boche	,Boche	
puni	,puni	,punie	
débrouillard	,débrouillard	,débrouillarde	
orphelin	,orphelin	,orpheline	,orphelin	,orpheline	,orphelin	
bon	,bon	
liquide	,liquide	
espagnol	,Espagnol	,Espagnole	
portugais	,Portugais	,Portugaise	
vivant	,vivant	;vivante	
juif	,juif	,juive	
aîné	,aîné	,aînée	
lusophone	,lusophone	,lusophone	
anonyme	,anonyme	,anonyme	
fidèle	,fidèle	
mélomane	,mélomane	,mélomane	
turc	,Turc	,Turque	
tyrannique	,tyran	
hollandais	,Hollandais	,Hollandaise	
pauvre	,pauvre	,pauvre	
>>>	S_2
tapis vert	,jeu	
bouchon	,pêcheur	
aire de jeux	,jouer	
bouffer	,bouffe	;bouffetance	;nourriture	
sentir	,odeur	
soutif	,poitrine	,seins	
ministère	,ministre	,ministre	
jeudi	,semaine	
administrable	,administrateur	
tramway	,arrêt	,station	
réussir	,réussite	
citation	,citation	
véhicule	,passager	,passagère	;cargaison	,chargement	;fret	
vêtu	,vêtements	
vendredi	,semaine	
chipoter	,nourriture	
grandeur	,grandeur	
brasserie	,bière	
bouche d’égout	,égout	
se diriger	,direction	
éprouvé	,épreuve	
bol	,bol	
éplucheur	,fruit	,légume	
se réfugier	,refuge	
interpeler	,suspect	
règlement livraison	,titre	
remplir	,oreilles	
médecin	,patient	,patiente	,patient	,patiente	
concert	,auditeur	,auditrice	;spectateur	,spectatrice	
analyser	,analysant	
embouteillage	,substance	
avocate	,client	,cliente	,cause	
pot	,mise	
charbonnière	,charbon	
produit	,facteur	
nation	,pays	
vicié	,vice	
parler	,langue	,langue	
coûter	;prix	,coût	
réagir	,produit	
musique	,auditeur	,auditrice	
promenade	,lieu	;promenade	,cour	
samedi	,semaine	
charbon	,charbon	
médecine	,patient	,patiente	,malade	,malade	
gribouiller	,gribouillage	,gribouillis	,gribouillage	
investissement	,montant	,investissement	
frapper	,coup	
jambe de force	,véhicule	
guichet	,client	,cliente	
colis	,contenu	
pâtisserie	,pâtisserie	,gâteau	
résultat	,calcul	,opération	
fax	,fax	
prédiction	,prédiction	
se confier	,confident	,confidente	
habillé	,vêtements	;vêtement	
prostituée	,client	
métro	,métro	,station	
tomber	,moment	
clinique	,patient	,patiente	
lisse	,métier à tisser	
église	,fidèle	
mère	;enfant	,congrégation	;couvent	
protecteur	,protégé	
crime	,victime	,victime	
sous l’effet	,cause	
bus	,passagère	,passager	,usager	,usagère	,voyageur	,voyageuse	
fierté	,fierté	;objet	
restaurant	,repas	,plat	;cuisine	
aérodrome	,avion	
grille-pain	,pain	;tartine	,toast	
mardi	,semaine	
pièce	,acteur	,actrice	,comédien	,comédienne	
couleur	,couleur	
avare	,argent	
facteur	,courrier	
toubib	,patient	,patiente	
pharmacie	,pharmacie	
téléspectatrice	,télévision	
travail	,cheval	;bœuf	
jambon	,porc	
soupière	,soupe	;soupière	
fusil	,cible	
rajouter	,rajout	
baguettes	,instrument à percussion	
époux	,époux	,mari	
chèque	,montant	
tisser	,réseau	;lien	
équipé	,équipement	
interview	,interviewé	,interviewée	
appareiller	,bateau	
sécrétion	,sécrétion	
jouer	,sport	,instrument	,musique	,rôle	
aîné	;cadette	,puînée	,puîné	,cadet	
ressentir	,émotion	,sentiment	;sensation	
empoisonné	,poison	
fleuri	,fleur	
aéroport	,avion	
insecticide	,insecte	
>>>	S_1^usual
tabac	,planteur	;cultivateur	,cultivatrice	;producteur	,productrice	,buraliste	,buraliste	;débitant	,débitante	;marchand	,marchande	
élever	,éleveur	,éleveuse	
camping	,campeur	,campeuse	
faire chier	,chieur	,chieuse	
cheval	,éleveur	,éleveuse	,palefrenier	,palefrenière	,cavalier	,cavalière	;écuyer	,écuyère	
imprimerie	,imprimeur	,imprimeuse	,imprimeur	,imprimeuse	
trouille	,trouillard	,trouillarde	
papeterie	,papetier	
s’obstiner	,obstiné	,obstinée	
sauce	,saucier	
design	,designer	
enjôler	,enjôleur	,enjôleuse	
pois	,cultivateur	,cultivatrice	
poème	,poète	,poétesse	
salaire	,salarié	,salariée	
s’entêter	,têtu	,têtue	<entêté	,entêtée	
imprimer	,imprimeur	,imprimeuse	
chiant	,chieur	,chieuse	
grue	,grutier	,grutière	
jugeable	,juge	
mine	,mineur	
grammaire	,grammairien	,grammairienne	
bouffer	,bouffeur	,bouffeuse	,bouffeur	,bouffeuse	,bouffeur	,bouffeuse	
frousse	,froussard	,froussarde	
foie	,bœuf	,veau	
peinture	,peintre	,peintre	
réparer	,réparateur	,réparatrice	
opérer	,chirurgien	,chirurgienne	
piano	,pianiste	,pianiste	
vache	,éleveur	,éleveuse	;vacher	,vachère	
émigrer	,émigré	,émigrée	
moutarde	,cultivateur	,cultivatrice	
critiquer	,critiqueur	,critiqueuse	
portrait	,portraitiste	,portraitiste	
chèvre	,éleveur	,éleveuse	;chevrier	,chevrière	
concombre	,cultivateur	,cultivatrice	
boucher	,bouchon	
préparer	,cuisinier	,cuisinière	
tamponneur	,auto	
conte	,conteur	,conteuse	;conteur	,conteuse	
traiter	,médecin	,médecin	;vétérinaire	,vétérinaire	;dentiste	,dentiste	
magie	,mage	;magicien	,magicienne	
trompette	,trompettiste	,trompettiste	
escalade	,alpiniste	,alpiniste	
balayer	,balayeuse	,balayeur	
museau	,arme à feu	
marionnette	,marionnettiste	,marionnettiste	
malchance	,malchanceux	,malchanceuse	
voiture	,cocher	
cuisine	,cuisinier	,cuisinière	,cuisinier	,cuisinière	,cuisinier	,cuisinière	
licencié	,salarié	,salariée	
plateau	,serveur	,serveuse	
fabriquer	,fabricant	,fabricante	
guichet	,guichetier	,guichetière	
s’engager	,engagé	,engagée	
montrer	,montreur	,montreuse	
malin	,malin	,maligne	
bijouterie	,bijoutier	,bijoutière	
questionner	,questionneur	,questionneuse	
violent	,violent	
rater	,raté	,ratée	
traduction	,traducteur	,traductrice	
spongieux	,éponge	
violon	,violoniste	,violoniste	
sagesse	,sage	
agneau	,éleveur	,éleveuse	
chirurgie	,chirurgien	,chirurgienne	
riz	,riziculteur	,rizicultrice	
sardine	,sardinier	
couper les cheveux	,coiffeur	,coiffeuse	
ring	,boxe	,catch	
collection	,livre	
effiler	,coiffeur	,coiffeuse	
photo	,photographe	,photographe	
autoroute	,usager	,usagère	
imagination	,imaginatif	,imaginative	
balcon	,immeuble	
poser	,installateur	,installatrice	
graver	,graveur	,graveuse	
mouton	,berger	,bergère	;éleveur	,éleveuse	
marchandise	,marchand	,marchande	
casser les couilles	,casse-couilles	,casse-couilles	
ville	,citadin	,citadine	
entêtement	,têtu	,têtue	
filet	,pêcheur	,pêcheuse	
maïs	,maïsiculteur	,maïsicultrice	
violence	,violent	
semoule	,semoulier	
oignon	,cultivateur	,cultivatrice	
mélancolie	,mélancolique	,mélancolique	
anxiété	,anxieux	,anxieuse	
alto	,altiste	,altiste	
vilain	,vilain	,vilaine	
plumes	,oiseau	
raser	,barbier	
enseigner	,enseignant	,enseignante	
drame	,dramaturge	,dramaturge	
péter	,péteur	,péteuse	
toiletter	,toiletteur	,toiletteuse	
planche	,bois	
>>>	Magn
sourire	,à belles dents	
ressemblance	,grand	,évident	,flagrant	,marqué	,notable	<parfait	,exact	,singulier	,évident	<frappant	,fort	,marqué	,profond	<incontestable	,incroyable	,fou	,extraordinaire	<parfait	,portrait	
pluie	,abondant	,dru	,fort	,gros	,intense	<battant	,brutal	,violent	,grain	,rincée	,saucée	,sauce	<torrentiel	,diluvien	,trombe	,cataracte	,tempête	,déluge	,cordes	,abondant	
adaptateur	,universel	
avoir	,bien	,complètement	
dégoût	,profond	
similitude	,grand	<parfait	,complet	,absolu	,identité	;évident	,frappant	,fort	,flagrant	
chiffon	,vrai	
demain	,après-demain	
coup de fouet	,sacré	
haine	,mortel	
père	,vrai	
descente	,drôle	;bon	<sacré	
vent	,fort	,grand	,soutenu	,puissant	<terrible	,violent	,furieux	,impétueux	,à décorner les bœufs	,à décorner les cocus	;ouragan	,tempête	,tourmente	;typhon	;cyclone	,gros	
liaison	,fort	
orage	,important	,beau	<gros	,violent	,furieux	<terrible	,épouvantable	,affreux	,effroyable	
malade	,gravement	<comme un chien	<à crever	,complètement	
alcool	,fort	,à ressusciter les morts	,casse-poitrine	
hier	,avant-hier	
intéressé	,fort	,très	
galérer	,à mort	
se barber	,comme un rat mort	
figure	,emblématique	,éminent	,grand	,illustre	,marquant	
lumineux	,éclatant	,resplendissant	;éblouissant	
bête	,à manger du foin	
savon	,mémorable	;sacré	
mal à propos	,fort	,très	
spécialiste	,grand	;expert	
histoire	,à dormir debout	
réfléchir	,mûrement	
gagner	;haut la main	
bordel	,gros	,joyeux	,sacré	
crime	,grave	<énorme	<abominable	,inqualifiable	;contre nature	;du siècle	,affreux	,brutal	<horrible	,atroce	,abominable	,inqualifiable	,odieux	;sordide	;contre nature	;du siècle	
mélancolie	,sombre	
lien	,intime	,étroit	
con	,connard	
nostalgie	,grand	,profond	<immense	;déchirant	,poignant	,violent	;incurable	,inconsolable	
rapidement	,à la vitesse de [Y]	
dormir	,à poings fermés	,profondément	;comme un loir	,comme une marmotte	,comme une bûche	,comme une masse	,comme une souche	,comme un sonneur	;comme un bébé	
ivre	,complètement	,mort	
près	,bien	,très	;tout	,tout	,bien	,tout	,très	
observation	,strict	
bien	,grand	<immense	<fou	,très	,rudement	<terriblement	<mieux	;très	<parfaitement	,admirablement	,à merveille	,formidablement	,merveilleusement	,formidablement	,remarquablement	,mieux	,meilleur	,très	
cuisine	,sacré	
personnel	,important	,nombreux	
blesser	,grièvement	,gravement	,profondément	,profondément	
fesses	,rebondi	,dodu	<gros	,gras	,d’éléphant	
obéir	,au doigt et à l’œil	
bandit	,de grand chemin	
chaleur	,intense	,fort	,intense	<à crever	,intense	
aboyer	,furieusement	;férocement	
coup de soleil	,fameux	,gros	,méchant	,sacré	,sérieux	,vilain	
éclairant	,aveuglant	,éblouissant	
problème	,gros	,sérieux	<insurmontable	,difficile	,gros	,sérieux	<majeur	
félicitations	,chaleureux	
bilan	,approfondi	,complexe	;précis	;complet	,détaillé	;détaillé	,lourd	
douzaine	,bon	,gros	
laver	,de la tête aux pieds	
coma	,profond	
fossette	,profond	
pâle	,blême	,livide	,blême	,livide	
boire	,beaucoup	,sec	<trop	,à tire-larigot	,comme un trou	,jusqu’à plus soif	,beaucoup	,sec	<trop	
torchon	,vrai	
mordre	,à belles dents	,à pleines dents	
en colère	,très	,furieux	
chiffre	,élevé	
maigre	,comme un clou	,squelettique	
continent	,immense	,vaste	
piano	,pianissimo	
fâché	,hors de ses gonds	
fond	,fin	,fin	,fin	
réagir	,fortement	,violemment	,vivement	
sentiment	,net	,fort	,profond	,vif	
lettre	,long	
soleil	,plein	,éblouissant	
attestation	,sur l’honneur	,sur l’honneur	
conte	,à dormir debout	,à dormir debout	
rire	,à belles dents	;à gorge déployée	
à propos	,fort	,très	
souci	,gros	,sérieux	<majeur	
commémorer	,en grande pompe	
marche	,rapide	
chant	,puissant	
pioncer	,comme un sonneur	,comme un loir	
nager	,complètement	
longueur	,grand	,grand	,grand	
millier	,bon	
aplatir	,comme une crêpe	,comme une crêpe	
bâiller	,aux corneilles	
long	,tout en longueur	;comme un jour sans pain	,comme un jour sans pain	,comme un jour sans pain	
ridule	,ride	
rouge	,ardent	,brillant	,vif	;foncé	,sombre	,ardent	,brillant	,vif	;foncé	,sombre	,tout	;cramoisi	;écarlate	;pourpre	,tout	;comme un coq	,comme un coquelicot	,comme un homard	,comme une écrevisse	,comme une pivoine	,comme une tomate	;cramoisi	;écrevisse	;pourpre	;rougeaud	;rubicond	;écarlate	;sanguin	
enfant	,tout	
à ravir	,bien	
sommeil	,profond	,de plomb	;lourd	;sans rêves	,très	,vraiment	,profond	,de plomb	,lent	,lourd	,profond	
addition	,coup de fusil	
tonnerre	,assourdissant	<épouvantable	,assourdissant	<épouvantable	
ronflements	,bruyant	,sonore	
imagination	,fou	,galopant	
ionisation	,fort	
>>>	A_2
atteindre	,atteint	,atteint	
chiffre	,chiffré	
bague	,bagué	
comprendre	,compris	,compris	,inclus	,compris	
entretenir	,entretenu	
essouflant	,essouflé	
former	,formé	
électronique	,électronique	
exercer	,exercé	
supplément	,supplémentaire	
plaisir	,plaisant	
savoir	,su	,su	
exploiter	,exploité	
exporter	,exporté	
lac	,noyé	
exagérer	,exagéré	,exagéré	
antenne	,à	,sur	,en ondes	
battre	,battu	
vents	,à	
réduire à zéro	,réduit à zéro	
déchirer	,déchiré	
intention	,intentionnel	
attrait	,attrayant	
s’appauvrir	,appauvrissant	
gonfler	,gonflé	
abondant	,abondant	
garnir	,garni	
béton	,bétonné	
considérer	,considéré	
imputer	,imputable	
origine	,originaire	
devoir	,dû	
réfléchir	,réfléchi	
habiter	,habité	
angoisse	,angoissant	
amour	,amoureux	
occuper	,occupé	,occupé	,occupé	,occupé	
éducation	,éducateur	
couleurs	,à	,sous	
éblouir	,ébloui	
inspirer	,inspiré	,inspiré	
passionner	,passionné	
obliger	,obligé	
accusation	,visé	,en butte	
héliporter	,héliporté	
considération	,considéré	
employer	,employé	
vice	,vicié	
schéma	,schématique	
composer	,composé	
aliter	,alité	
faute	,fautif	
essouflé	,essouflant	
désespérer	,désespéré	
désirer	,désirable	
remplir	,rempli	
consentement	,consenti	
exécuter	,exécuté	
miel	,mellifère	,mellifique	
exposer	,exposé	,exposé	
prendre à la gorge	,pris à la gorge	
habitation	,habité	
fracture	,fracturé	
bénévolat	,bénévole	
émouvoir	,ému	
raisonner	,raisonné	
erreur	,erroné	
poison	,empoisonné	
sinistre	,sinistré	
consentir	,consenti	
abattre	,abattu	,abattu	,abattu	
préoccuper	,préoccupé	
menacer	,menacé	
conservation	,conservé	
creuser	,creusé	
adorer	,adoré	
serrer	,serré	
manger	,mangé	
miracle	,miraculé	
franc	,franc	
droite	,droit	
tache	,taché	
connaissance	,connu	
barrer	,barré	
concerner	,concerné	
localisation	,localisé	
illustrer	,illustré	
électricité	,électrique	
occupation	,occupé	
fossette	,creusé	
rassurer	,rassuré	
brûlure	,brûlé	
haleter	,haletant	
proche	,prochain	
épreuve	,éprouvé	
disputer	,disputé	
Enfer	,damné	
observer	,observé	,observé	
pension	,pensionné	
connaître	,connu	
>>>	Contr
vers	,depuis	
intégration verticale	,intégration horizontale	
mobile	,filaire	
distance	,proximité	
majuscule	,minuscule	
torchon	,serviette	
lièvre	,tortue	
orient	,occident	
titre de participation	,titre de placement	
science	,technologie	
tribord	,bâbord	
objet	,sujet	
âme	,corps	
poitrine	,dos	,dos	
à droite	,à gauche	
plage arrière	,plage avant	,plage avant	
ange	,démon	
gaucher	,droitier	,droitier	
entrée	,sortie	,sortie	
gauche	,droit	,droite	,droit	,droite	
vanille	,chocolat	
gaz	,liquide	,solide	
nez	,oreilles	,yeux	
défendre	,attaquer	
vin blanc	,vin rouge	
faim	,soif	
immigrer	,émigrer	
lexique	,grammaire	
brioche	,pain	
partir	,arriver	
caca	,pipi	
nord	,sud	
propre	,brouillon	
dos	,poitrine	,poitrine	
loin	,ici	
tragédie	,comédie	
zapper	,s’obstiner	
république	,monarchie	
réponse	,question	
baguette	,bâton	
magistrature debout	,magistrature assise	
dialogue	,monologue	
deux-roues	,véhicule	
pièce	,meuble	
croûte	,mie	
toi	,moi	
volé	,voleur	
se lever	,s’allonger	,se coucher	,se coucher	,s’allonger	
boulevard	,avenue	
volée	,voleuse	
vieux continent	,Nouveau Monde	
moi	,toi	
devoir	,droit	
actuel	,ancien	,prochain	
démon	,ange	
entre	,autour	
slip	,maillot de corps	
analogique	,numérique	
de jupons	,d’hommes	
terrestre	,aérien	;aquatique	,marin	,aérien	;maritime	
géographie	,histoire	
thorax	;abdomen	;tête	,abdomen	
coût de sortie	,coût d’entrée	
s’allonger	,se lever	,se lever	
Australie	,Nouvelle-Zélande	
décoller	,atterrir	
moteur	,directeur	
cash	,chèque	
chanter	,parler	
appartement	,maison	
fesses	,seins	
visage pâle	,Indien	
marcher	,ramper	;courir	
poivre	,sel	
actif	,passif	
musique classique	,variété	
sur-mesure	,prêt-à-porter	
mer	,terre	
analogie	,homologie	
qualitatif	,quantitatif	
ballon ovale	,ballon rond	
esclave	,maître	
métro	,R.E.R	,R.E.R	
minuscule	,majuscule	
nuit	,jour	
carré	,cercle	,rond	
national	,international	
monarchique	,démocratique	,républicain	
atterrissage	,décollage	
ciel	,terre	,terre	;Enfer	
visage	,corps	
sexe féminin	,sexe masculin	,sexe masculin	
avenue	,boulevard	
genre	,nombre	
se coucher	,se lever	
version	,thème	
homologue	,analogue	,analogue	
régime réel normal	,régime réel simplifié	
nationalement	,internationalement	
sortie	,entrée	
>>>	S_0Pred
inconscient	,inconscience	,inconscience	
pair	,parité	
nostalgique	,nostalgie	,nostalgie	
froid	,froideur	
vacant	,ardeur	
bref	,brièveté	
mou	,mollesse	,mollesse	,mollesse	
saint	,sainteté	,sainteté	,sainteté	
tendre	,tendreté	,tendresse	
originel	,origine	
abonné	,abonnement	
cruel	,cruauté	
dur	,dureté	,dureté	
tolérant	,tolérance	
absent	,absence	
excentré	,excentricité	
imbécile	,imbécillité	
optimiste	,optimisme	
citoyen	,citoyenneté	
conscient	,conscience	,conscience	
analogue	,analogie	
gourmand	,gourmandise	
protecteur	,protection	
racé	,race	
veuf	,veuvage	
énorme	,énormité	
normal	,normalité	
dangereux	,dangerosité	
permanent	,permanence	
supérieur	,supériorité	
réactif	,réactivité	
féroce	,férocité	
discipliné	,discipline	
sexué	,sexe	
salarié	,salariat	
divers	,diversité	
mélancolique	,mélancolie	,mélancolie	
léger	,légèreté	
long	,longueur	,longueur	,longueur	,longueur	,longueur	
glorieux	,gloire	
pertinent	,pertinence	
carré	,carré	,carré	
vraisemblable	,vraisemblance	
fixe	,fixité	,fixité	
exact	,exactitude	
courageux	,courage	
homogène	,homogénéité	,homogénéité	,homogénéité	
acide	,acidité	
trébuchant	,trébuchement	
extravagante	,extravagance	
agressif	,agressivité	
allotropique	,allotropes	
compétent	,compétence	
avancé	,avancement	
autonome	,autonomie	
rigide	,rigidité	,rigidité	
continu	,continuité	
précoce	,précocité	
situé	,situation	
pessimiste	,pessimisme	
moderne	,modernité	
grand	,grandeur	
accessible	,accessibilité	
aigre	,aigreur	,aigreur	
hypocrite	,hypocrisie	
insuffisant	,insuffisance	
rude	,rudesse	
hétérosexuel	,hétérosexualité	,hétérosexualité	
subjectif	,subjectivité	
enceinte	,grossesse	
urgent	,urgence	
compliqué	,complication	
joyeux	,joie	
chic	,chic	
élastique	,élasticité	
solitaire	,solitude	,solitude	
possessif	,possessivité	
prudent	,prudence	
toxique	,toxicité	
difficile	,difficulté	
libre	,liberté	
idiot	,idiotie	
riche	,richesse	
sage	,sagesse	
chaud	,chaleur	,chaleur	
beau	,beauté	,beauté	
bienheureux	,bonheur	
civil	,civilité	
majoritairement	,majorité	
possible	,possibilité	
débutant	,débuts	,début	
singulier	,singularité	
étourdi	,étourderie	
élégant	,élégance	,élégance	
innocent	,innocence	,innocence	
cher	,cherté	
vengeur	,vengeance	
soulagé	,soulagement	
sapide	,sapidité	;goût	
transparent	,transparence	
>>>	S_1^prototyp
spirale	,cahier	
en fleurs	,jardin	;paysage	
canner	,chaisier	,chaisière	
embouteiller	,vin	
seins	,femme	
temps	,neige	,pluie	
vent	,éventail	;soufflet	
capuche	,manteau	,sweat-shirt	
interpréter	,comédien	,comédienne	,acteur	,actrice	
décolleté	,robe	
essaimer	,abeille	
honorer	,Dieu	,dieu	
dru	,neige	,pluie	,neiger	,pleuvoir	
pièce	,appartement	,maison	
appareil	,tarte	,soufflé	
nageoire	,poisson	
trombe	,eau	
propre	,voiture	,transports	,énergie	
siège	,armée	,troupe	
champ gravitationnel	,planète	,Terre	
alcoolisé	,alcool	
haut-parleur	,téléviseur	;radio	
poil	,tapis	,brosse	,pinceau	,pinceau	
hi-han	,âne	
abat-jour	,lampe	,ampoule	,lampadaire	
roue à aubes	,bateau	;moulin	
cigarette	,pantalon	;robe	;jupe	;jean	
pluie	,projectile	
lacet	,chaussures	,souliers	
radiateur	,véhicule	;voiture	
noueux	,arbre	
bâton	,skieur	
choucroute	,charcuterie	;poisson	
ramification	,branche	
serviette	,femme	
fusillade	,tireur	,tireuse	
foi	,croyant	,croyante	
cornes	,cervidés	,escargot	
épluché	,fruit	;légume	
nettoyer	,nettoyeur	
virtuose	,musicien	,musicienne	
lit	,fleuve	,rivière	,ruisseau	,torrent	
tomber	,neige	,pluie	
positif	,organiste	
pâteux	,pâte	,pâte	,bouche	
seuil	,maison	,porte	
remboursable	,dette	
élément de langage	,communicant	
chapitre	,livre	
réseau	,ami	
transporter	,joie	,allégresse	
célébrer	,prêtre	
reproductible	,expérience	
règles	,femme	
de bain	,serviette	;maillot	
autoroute	,automobiliste	,automobiliste	;véhicule	
addition	,barman	,barmaid	,serveur	,serveuse	
coffre	,voiture	
débrancher	,cheminot	
baguettes	,Chinois	,Chinoise	;Japonais	,Japonaise	
galop	,cheval	
coup de feu	,chaudière	,four	,four	
champ magnétique	,aimant	,aimant	
main droite	,singe	,musicien	,musicienne	
déchirer	,éclair	;cri	
glaçon	,boisson	
mépriser	,ver de terre	
parole	,locuteur	
voler	,véhicule volant	
amputé	,membre	
flocon	,laine	
meuh	,vache	
s’articuler	,membre	
sonneur	,cloche	
poulailler	,poule	,coq	
coasser	,crapaud	,grenouille	,rainette	
fenêtre	,enveloppe	
cravate	,drapeau	
main gauche	,singe	,musicien	,musicienne	
éclore	,oisillon	,œuf	,fleur	,fleur	
tonnerre	,applaudissements	
accoudoir	,fauteuil	
découvrir	,chercheur	
paupière	,judas	;œilleton	
main verte	,jardinier	,jardinière	
bulle	,air	
antennes	,insecte	
page	,livre	,carnet	,cahier	
vitaminé	,fruit	,légume	
soie	,couteau	
couvercle	;boîte	,caisse	;casserole	,marmite	
cadavre	,bouteille	,canette	
paragraphe	,texte	
bras	,fauteuil	
vêtement	,couturier	,couturière	
piste	,cycliste	,cycliste	
banc	,poisson	,nuage	
dessous	,femme	
pelouse	,parc	
glaçage	,pâtisserie	
>>>	Redun
sapin	,de Noël	
forme	,linguistique	
somme	,argent	
partie	,génital	
réactif	,chimique	,chimique	
retenue	,eau	
préparation	,alimentaire	,culinaire	
prévision	,météorologique	
punaise	,sale	
procédure	,judiciaire	
bilan	,comptable	
effets	,personnel	
débranchement	,électrique	
triangle	,pubien	,signalisation	
sujet	,syntaxique	;grammatical	
vocation	,religieux	
objet	,céleste	
énergie	,physique	
poitrine	,féminin	
position	,sexuel	
panoplie	,arme	
molécule	,chimique	
droite	,politique	
escompte	,règlement	
ensemble	,musical	
flûte	,pain	
excentricité	,orbital	
pièce	,monnaie	
tampon	,hygiénique	
aimer	,d’amour	,physiquement	,sexuellement	,physiquement	
couleur	,peau	
plateau	,jeu	
formule	,tout fait	
marche	,athlétique	,au pas	,à pied	,électoral	
tabouret	,pieds	
élément	,chimique	,chimique	
compte	,bancaire	
chaussette	,évacuation	
câble	,électrique	
marcher	,au pas	
tapis	,souris	,roulant	
figure	,schématique	,littéraire	;style	
plage	,horaire	
traduire	,justice	
train	,bois	
serviette	,table	,hygiénique	;périodique	;sanitaire	
office	,religieux	
tapette	,mouche	
manteau	,terrestre	
gymnastique	,intellectuel	
temple	,protestant	,religieux	
fond	,sonore	
bout de chou	,petit	
empreinte	,digital	,dentaire	
pot	,fleur	,commun	
drap	,lit	
lait	,maternel	
désirer	,physiquement	,sexuellement	
tableau	,blanc	;noir	
épreuve	,sportif	
bouteille	,alcool	
blague	,tabac	
point	,final	
grappe	,raisin	
pompe	,à huile	,à essence	
fibre	,alimentaire	
balayeuse	,aspirateur	
anniversaire	,de naissance	
désir	,physique	,sexuel	
voie	,ferré	
équation	,chimique	,chimique	
coureuse	,automobile	,d’hommes	
navigateur	,Internet	,Web	
secteur	,économique	
urne	,funéraire	
précipitation	,atmosphérique	
machine	,laver	
poche	,ventral	
manifestation	,sportif	
tirage	,photographique	
dépression	,nerveux	,de terrain	,atmosphérique	,barométrique	,économique	
toison	,pubien	
réaction	,chimique	,nucléaire	
liaison	,chimique	,amoureux	,intime	
carte	,à jouer	
vapeur	,eau	
produit	,chimique	
fête	,religieux	
champ	,visuel	,vision	,tir	
déchirement	,musculaire	
instrument	,de musique	
serveur	,informatique	
coté	,Bourse	
linge	,corps	
air	,de musique	
étreinte	,sexuel	
Pâque	,juif	
circulation	,sanguin	
ticket	,entrée	
aimant	,naturel	
>>>	AntiBon
humeur	,de chien	
sentir	,mauvais	
effet	,méfait	
nappe	,sale	,taché	,contaminé	;pollué	
marcher	,mal	;au ralenti	
tapis	,élimé	,râpé	,pelé	
aller	,mal	
courriel	,frauduleux	,hameçonnage	,spam	,pourriel	
bicyclette	,clou	
nager	,mal	
politicienne	,politicarde	
divorce	,pour faute	;aux torts exclusifs	;par assignation	;aux torts partagés	
navire	,mauvais	,rafiot	
air	;lourd	;pollué	,vicié	
prêcher	,prêcher un converti	
repas	,immangeable	,indigeste	;gras	
théâtre	,de boulevard	
écrit	,gribouillage	
couteau	,mauvais	
chiffre	,mauvais	
finir	,bâcler	
jour	,sans	
chanter	,comme une casserole	
crier	,braire	,braire	
atmosphère	,vicié	
femme politique	,politicarde	
formes	,disgracieux	
recevoir	,comme un chien dans un jeu de quilles	
ostensible	,ostentatoire	
dent	,carié	,pourri	,gâté	,vilain	;déchaussé	;ébréché	<cassé	,chicot	;creux	
vin	,âpre	,gâté	,mauvais	,piqué	,piquette	,vinasse	
nuage	,lourd	,menaçant	,lourd	,menaçant	
médecin	,mauvais	;médicastre	,mauvais	;médicastre	
rapport	,toxique	
pluie	,dévastateur	,dévastateur	
écrivain	,gribouilleur	;pisseur de copie	
serviette	,humide	<mouillé	;sale	
vélo	,clou	
passager	,clandestin	
linge	,froissé	,souillé	
bouche	,pâteux	
réponse	,Normand	
élève	,mauvais	,cancre	,mauvais	,cancre	
gosse	,sale	;chiard	,sale	
odeur	,irrespirable	
boisson alcoolisée	,bibine	;pipi de chat	
sommeil	,agité	,détraqué	,mauvais	,perturbé	,troublé	
gueule	,de _N de long	
relation	,toxique	
attitude	,gauche	
rêve	,mauvais	<horrible	;cauchemar	
bouteille	,mauvais	
pull	,troué	,usé	
langage	,baragouin	
année	,sans	,sans	
lit	,grabat	
mélange	,mariage de la carpe et du lapin	
se lever	,se lever du pied gauche	
rouge	,gros	;qui tache	
avocat	,mauvais	<piètre	;avocaillon	
croûte	,dur	
environnement	,hostile	
restaurant	,gargote	
chaussures	,usé	;éculé	
chaussettes	,troué	;usé	
manteau	,élimé	,râpé	,usé	
colline	,abrupt	
jambes	,faible	,mauvais	,faible	,mauvais	
bateau	,mauvais	,rafiot	
lac	,sombre	,impur	,boueux	,fangeux	;noir	,opaque	;houleux	
dormir	,à la dure	,mal	,insuffisamment	
écrire	,gribouiller	
sens	,contresens	,mauvais	
figure	,de carême	
vêtements	,usé	;fripé	,râpé	;fripes	,guenilles	,loques	
installé	,mal	
moral	,à zéro	,dans les chaussettes	
violon	,crin-crin	
prendre	,mal	
banlieue	,zone	
assis	,mal	
fond	,bas-fond	,vieux	,mauvais	,méchant	
dessin	,gribouillage	
corps	,difforme	
politicien	,politicard	
thèse	,mauvais	<médiocre	
manger	,mal	,gras	
théatre	,de boulevard	
chaussons	,usé	,usé	
film	,navet	
journaliste	,mauvais	,folliculaire	,journaleux	,plumitif	;pisse-copie	,pisseur de copie	,mauvais	,folliculaire	,journaleuse	;pisse-copie	,pisseuse de copie	
vent	,âpre	;mauvais	
parler	,baragouiner	,comme une vache espagnole	,baragouiner	
langue	,jargon	
mouchoir	,sale	
personnel	,incompétent	,incompétent	
forme	,petit	<mauvais	,petit	,mauvais	
négocier	,chipoter	
couple	,malheureux	
sujet	,chiffon rouge	
>>>	Mero
tramway	,tramway	
muscle	,fibre	;tissu	
semaine	,semaine	,week-end	
château de cartes	,carte	
thorax	,sternum	;côte	
soupe au lait	,lait	
trottinette	,roue	;guidon	,roue	;guidon	
concombre	,concombre	
zigzag	,tournant	,virage	
ongles	,kératine	
jambes	,chevilles	;mollets	;genou	;cuisses	;pieds	
autoroute	,chaussée	,voie	,bande de circulation	;bande d’arrêt d’urgence	;péage	;entrée	,sortie	
courriel	,en-tête	,signature	,pièce jointe	,adresse électronique	
tortue de mer	,bec	;carapace	;nageoire	
verglas	,glace	;eau	
novembre	,Toussaint	
gorge	,gosier	,gorge	,pipe	
sms	,sms	
fil de lin	,lin	
mère	,bactérie	
gamme	,do	,sol	
week-end	,samedi	,dimanche	
noyau	,nucléon	,proton	,neutron	
rue	,chaussée	,voie	;trottoir	
train	,locomotive	;voiture	,wagon	,essieu	,roue	,pneu	
Système solaire	,Soleil	;Terre	,Mars	;Lune	
soutien-gorge	,bonnet	
cheval	,crinière	
soutif	,bonnet	
mamelles	,tétons	
brosse	,dos	;poil	,fibre	;manche	,poil	,fibre	;manche	,poil	,fibre	
tomate	,tomate cerise	,cœur de bœuf	
table	,plateau	,pied	;bord	,bout	,centre	,milieu	,coin	
cours d’eau	,eau	
canapé	,accoudoir	,coussin	,dossier	
toilette	,miroir	,table	
omelette	,œuf	
trottoir	,bateau	
R.E.R	,R.E.R	
rame	,voiture	
pieds	,plante	
glaçon	,glace	,glace	
voie ferrée	,rails	
bonhomme de neige	,neige	
vinaigrette	,vinaigre	,huile	
gentiane	,gentiane	
lac	,bord	,rive	
fleuve	,méandres	;amont	,aval	;embouchure	;estuaire	,delta	;bouche	;berge	,bord	,rive	
colline	,bas	,pied	;flanc	,versant	;haut	<sommet	
air	,oxygène	
seins	;naissance	;tétons	,bout	,pointe	;courbe	,galbe	,ligne	,tétons	
route	,chaussée	,voie	;bord	;revêtement	
rosier	,rose	
école	,école	,école	
désert	,sable	,dune	,pierre	,roche	
moto	,guidon	;moteur	;réservoir	;roue	;side-car	
bouchon	,liège	
piano	,clavier	
navire	,coque	,pont	,cale	,hublot	,soute	;proue	,étrave	;poupe	,étambot	
lune	,croissant	
gueule	,museau	
cheminée	,foyer	
avion	,aile	,hélice	,moteur	,réacteur	,train d’atterrissage	;cockpit	;siège	,ceinture	;soute	;queue	;carlingue	,fuselage	
escargot	,coquille	;antennes	,cornes	
gymnastique	,pompe	
chemise	,col	;manche	
pomme de terre	,pomme de terre	
mot	,lettre	
bois	,sous-bois	
crachat	,salive	
tétons	,tétons	
pluie	,eau de pluie	
banc	,dossier	,siège	
éléphant	,trompe	
rivière	,méandres	;amont	,aval	;berge	,bord	,rive	;gué	,fermoir	
lentilles	,foyer	
étang	,bonde	;bord	
récif corallien	,corail	
substance	,particule	
voiture	,moteur	,réservoir	;coffre	;volant	,tableau de bord	,pédale	;siège	,ceinture	;roue	,train	;habitacle	,compartiment	;siège	,couchette	,brancard	,essieu	,roue	,marchepied	
métro	,rame	,métro	;métro	,station	,quai	;voie	
course	,galop	,trot	
fauteuil	,accoudoir	,bras	,coussin	,dossier	,oreilles	,patte	,pied	,siège	
iceberg	,glace	
graine de lupin	,lupin	
plan comptable général	,bilan	
nuage	,vapeur	
tortue marine	,bec	;carapace	;nageoire	
théâtre	,scène	,foyer	,coulisse	
corps	;atome	,élément	,molécule	
tortue	,bec	;carapace	
cube de glace	,glace	
terrier	,entrée	,gueule	,ouverture	,trou	;couloir	;cavité	
aspirateur	,brosse	,suceur	;tuyau	;sac	;fil	
abattant	,couvercle	,lunette	
couronne	,branche	,feuille	
glace	,eau	,sucre	,sucre glace	
viorne	,cheveu-de-la-Vierge	
forêt	,sous-bois	
cou	,gorge	,gorge	
>>>	Fact_0
antenne	,capter	,recevoir	;émettre	
parturiente	,accoucher	
avocate	,exercer	
prévision	,se réaliser	
bicyclette	,rouler	,circuler	
coureur	,courir	
nageur	,nager	
douche	,couler	,fonctionner	
corbeau	,voler	,voler	
muscle	,agir	;se contracter	
balayeuse	,balayer	
pâte	,cuire	
lac	,se déverser	,stagner	;se répandre	,se déverser	,s’étaler	,s’écouler	,se décharger	
collaborateur	,collaborer	
tramway	,circuler	,se déplacer	,rouler	;fonctionner	,marcher	
tombeau	,contenir	,renfermer	,receler	
tricycle	,rouler	,circuler	
campeur	,camper	
boulanger	,boulanger	
père	,officier	
figure	,indiquer	,illustrer	,représenter	
placard	,annoncer	<clamer	
guêpe	,voler	
artiste	,se produire	,se produire	
vélo	,rouler	;circuler	
casserole	,chauffer	
métro	,circuler	,rouler	,fonctionner	,marcher	
montgolfière	,s’élever	;voler	
concert	,retentir	
chien	,percuter	
cercueil	,contenir	,renfermer	,receler	
car	,rouler	
cigarette	,se consumer	
corps	,fonctionner	
alcoolique	,boire	,boire	
cycliste	,pédaler	,pédaler	
numéro	,sortir	,sortir	,paraître	
bateau	,naviguer	
marche	,retentir	,sonner	
réactif	,réagir	
camion	,circuler	,rouler	
rideau	,cacher	,masquer	,occulter	,séparer	,diviser	;cacher	,masquer	
balai	;balayer	
musicien	,jouer	
travailleur	,travailler	
avocat	,exercer	
tombe	,contenir	,renfermer	;receler	
cigare	,se consumer	
cheveux	,pousser	
prédiction	,se réaliser	
travailleuse	,travailler	
couleurs	,flotter	
couple	,embrasser	;enlacer	
hélicoptère	,voler	
mouche	,voler	,voleter	,voltiger	
flocons	,tomber	;voler	;neiger	
collabo	,collaborer	,collaborer	
boulangère	,boulanger	
volcan	,exploser	,exploser	
archéologue	,fouiller	
lunette	,grossir	
fond	,remonter	,remonter	
plage	,se dérouler	,jouer	
dormeur	,dormir	,dormir	
chimie	,opérer	,opérer	
aéronef	,voler	
tortue	,traîner	
sorcier	,envoûter	
escargot	,ramper	,traîner	
avion	,voler	
écureuil	,grimper	,sauter	,conserver	,garder	;économiser	
camionnette	,circuler	,rouler	
rêveur	,rêver	
musicienne	,jouer	
crocodile	,marcher	;nager	;ramper	
bus	,rouler	;circuler	
rêveuse	,rêver	
véhicule	,rouler	,se déplacer	;avancer	,circuler	,se déplacer	
skis	,glisser	
autocar	,rouler	
train	,rouler	,circuler	,avancer	,se déplacer	
moustique	,voler	
transporteur	,transporter	
magie	,opérer	
coureuse	,courir	
fleuve	<couler	
roue	,tourner	,tourner	
coup	,retentir	
voiture	,rouler	;avancer	,circuler	;se déplacer	,rouler	
cheval	,marcher	;trotter	;galoper	
aspirateur	,aspirer	
dormeuse	,dormir	,dormir	
courriel	,fonctionner	,marcher	
pompier	,intervenir	,intervenir	
collaboratrice	,collaborer	
bronzeur	,bronzer	
oiseau	,voler	
oreilles	,entendre	
bouilloire	,chauffer	
chant	,retentir	,retentir	,retentir	
>>>	Gener
pharmacie	,science	
cornichon	,légume	
vêtement	,pièce d’habillement	,secteur	
hortensia	,plante	,fleur	
vin	,boisson	;boisson alcoolisée	,boisson	;boisson alcoolisée	,secteur	
neuf	,nombre	
vilebrequin	,outil	
cresson	,plante	;légume	
addition	,opération	
mamelles	,partie du corps	,partie du corps	
valeur intrinsèque	,valeur	
chaise de bébé	,chaise	
pistolet	,arme à feu	
chandail	,vêtement	
salle à manger	,pièce	
deuxième articulation	,niveau d’articulation	
metteur en scène	,professionnel	;profession	,professionnelle	;profession	
convertible	,meuble	;pièce d’ameublement	
chat-huant	,oiseau	,oiseaux	
sentiment	,état psychique	,sentiment	
bol	,pièce de vaisselle	
clémentine	,fruit	
chat	;chat	;félins	,félinés	;animal	,animal	
chaise haute	,chaise	
arrosoir	,ustensile	
sentier	,voie	
moutarde	,sauce	
main droite	,partie du corps	,partie du corps	
nauséeux	,sensation	
renoncule	,plante	;fleur	
uniforme	,vêtement	;habit	,tenue	
diplôme	,document	
énergie solaire	,énergie	
odorat	,sens	
affect	,état psychique	,état psychique	
zigzag	,forme	,déplacement	,ligne	
pic	,outil	
obstacle	,équipement	
expert-comptable	,professionnel	;métier	,profession	
carafe	,pièce de vaisselle	
chaise longue	,chaise	
rouge-gorge	,oiseau	,oiseaux	;passereaux	
dessus	,quelque part	
fierté	,sentiment	
hi-han	,cri	
orage	,phénomène atmosphérique	
turquoise	,gemme	,pierre précieuse	
pimprenelle	,plante	;fleur	
infusion	,boisson	;boisson chaude	
essence de térébenthine	,produit	;substance	
lit	,meuble	;pièce d’ameublement	
table basse	,meuble	;pièce d’ameublement	
préjugé	,avis	,opinion	
mâtin	,animal	
blatte	,insecte	;insectes	;parasite	
tuba	,tube	
moule	,mollusques	,moule	
conte	,récit	;texte	
calcul	,discipline	
coup	,boisson	;boisson alcoolisée	,son	
grue	,oiseau	,oiseaux	
désirer	,vouloir	
frustration	,sentiment	
super	,carburant	
biche	,animal	
canada	,pomme	;fruit	
âne	,animal	;ongulés	
lièvre	,animal	;gibier	,viande	
mélangeur	,appareil	
feuille de route	,document	
chien de mer	,poisson	,poissons	
bilan écologique	,bilan	
graine de lupin	,aliment	;graine	
moelleux	,gâteau	
abus de biens sociaux	,délit	
rêver	,vouloir	
figuier	,arbre	
camion	,véhicule	
légume	,plante	
bilan de contrôle	,bilan	
repéter	,dire	
raisin	,fruit	
oiseau	,animal	
volcan de boue	,volcan	
sapin	,arbre	,bois	;matière	;matériau	,véhicule	,véhicule roulant	,moyen de transport	
gratitude	,sentiment	
propriété chimique	,propriété	
veilleuse	,meuble	;pièce d’ameublement	
témoin	,dispositif	
cotonnier	,arbre	
condescendance	,attitude	
crêpe	,mets	
rongeur	,animal	
râteau	,outil	
revolver	,arme à feu	
sachet	,contenu	
bijoutier	,artisan	
pain aux raisins	,viennoiserie	
ski	,sport de glisse	;sport d’hiver	
brioche	,viennoiserie	
>>>	S_loc
renard	,terrier	
amande	,amandier	
se laver	,salle de bain	,salle de douche	,salle d’eau	
rue	,rue	
promenade	,prison	
cercueil	,sépulture	,tombe	,tombeau	
déchets	,déchetterie	
lotus	,yoga	
cul-de-sac	,corps	,partie du corps	
récif corallien	,mer	
tasse	,tasse	
chaussures	,boîte	;meuble	
fleuve	<lit	
ananas	,ananas	
laver	,lavoir	,laverie	,buanderie	,buanderie	,lavomatique	,douche	,lavabos	,salle de bain	,salle d’eau	,salle de douche	
fessier	,fesses	
père	,couvent	
garagiste	,garage	,garage	
traboule	,Lyon	
chair de poule	,peau	
Kiwi	,Nouvelle-Zélande	
citron	,citronnier	
imprimer	,imprimerie	
serpent de mer	,mer	,mer	,journal	;presse	
noisette	,noisetier	
corps	,caserne	
crocodile	,rails	
lapin	,terrier	
poire	,poirier	
villageoise	,village	
orpheline	,orphelinat	
aboutir	,aboutissement	
coiffeur	,salon	
eau douce	,cours d’eau	;étang	,lac	
poches	,yeux	;visage	
judo	,tapis	,tatami	;dojo	,salle	
Occidental	,ouest	
doucher	,douche	;salle de bain	,salle de douche	
abeille	,nid	,ruche	
tomate	,tomate	
figue	,figuier	
main gauche	,gauche	,gauche	
tombe	,cimetière	
blaireau	,terrier	
boulangère	,fournil	
boulanger	,fournil	
grappe	,vigne	
crime	,lieu	,scène	
Système solaire	,Voie lactée	
diable	,Enfer	
melon	,melon	
pomme	,pommier	
sous-bois	,bois	,forêt	
mère	,couvent	
curé	,cure	;paroisse	
se doucher	,douche	,salle de douche	;salle de bain	
cheval	,écurie	;box	,stalle	;haras	
raisin	,vigne	
papilles	,langue	
valoches	,yeux	;visage	
voie	,gare	
papetier	,papeterie	,papeterie	
Soleil	,Système solaire	
sortir	,sortie	
voter	,bureau de vote	
avocat	,avocatier	
vélo	,vélodrome	
cinéma	,studio	
cigare	,bureau de tabac	,tabac	,débit de tabac	;cave à cigares	
football	,terrain	;stade	
presse	,presses	;imprimerie	
figure	,dans	,en plein	
lait	,seins	
emprisonné	,prison	
coton	,cotonnier	
faire de l’essence	,station-service	
rouge	,rougeur	
camper	,camping	
valises	,yeux	;visage	
orchestre	,fosse d’orchestre	
encre	,encrier	
environnement	,Terre	
articuler	,articulation	
tennis	,court	,terrain	,tennis	
plein	,station-service	
lombric	,terre	
pompe	,station-service	;garage	
Terre	,Système solaire	
guêpe	,nid	,guêpier	
terrier	,sol	;terre	
soucoupe	,soucoupe	
banane	,bananier	
pneumonie	,poumons	
ski	,piste	;station	
lessive	,blanchisserie	,pressing	;laverie	;lavoir	;buanderie	
datte	,dattier	,palmier dattier	
vitrine	,vitrine	
foire	,champ de foire	
vote	,urne	
douche	;douche	,salle de douche	,salle de bain	,salle de douche	,salle de bain	,salle d’eau	,cabinet de toilette	
>>>	Oper_1
coup	,donner	,faire	,jouer	,faire	
bœuf	,faire	
coup de reins	,donner	
bâtons dans les roues	,mettre	,jeter	,foutre	
VTC	,faire	
apitoiement	,avoir	,éprouver	,ressentir	,avoir	,éprouver	,ressentir	
sommeil	,avoir	,éprouver	,ressentir	
lessive	,faire	,faire	
coquille	,avoir	,posséder	
nostalgie	,avoir	,éprouver	,ressentir	;souffrir	
contentement	,éprouver	,ressentir	
frite	,avoir	
les pieds sous la table	,mettre	
désir	,avoir	,éprouver	,ressentir	
journal intime	,tenir	
don	,faire	
maladie de la vache folle	,avoir	,souffrir	
ciné	,se faire	
fierté	,avoir	,éprouver	,ressentir	
sermon	,prononcer	,faire	
sensation	,avoir	,éprouver	,ressentir	
sacrement	,administrer	
rouge	,passer	,virer	
cornes	,avoir	,posséder	
vent	,avoir	,faire	,lâcher	,mettre	
gymnastique	,faire	,faire	,faire	,se faire	
coup par coup	,faire	
accident vasculaire cérébral	,avoir	
veste	,prendre	,se prendre	,ramasser	,se ramasser	;essuyer	,subir	,prendre	,se prendre	,ramasser	;se ramasser	,se manger	
compte	,faire	
les jambes molles	,avoir	
coup double	,faire	
Résistance	,appartenir	,faire partie	
fond	,avoir	
discours	,prononcer	,faire	
compliment	,présenter	
pluie	,tomber	,retomber	
tête près du bonnet	,avoir	
a priori	,avoir	;nourrir	
mélancolie	,souffrir	,avoir	,éprouver	,ressentir	,causer	,inspirer	,susciter	
bon pied bon œil	,avoir	
frustration	,avoir	,éprouver	,ressentir	
angine de poitrine	,avoir	,souffrir	
poisson d’avril	,faire	
compassion	,avoir	,éprouver	,ressentir	;faire preuve	,manifester	,montrer	
exclamation	,pousser	
carcinome mammaire	,avoir	,souffrir	
coup de pied	,donner	
règles	,avoir	
prévision	,faire	
service	,rendre	
marche nordique	,faire	
couleurs	,avoir	
attitude	,manifester	,observer	,manifester	,observer	
dent	,avoir	
bol	,prendre	
dentition	,faire	
visage	;arborer	,avoir	,montrer	,offrir	,présenter	,montrer	,présenter	,arborer	,exhiber	,afficher	
carapace	,avoir	,posséder	
bouteille à la mer	,jeter	,lancer	,mettre	
les jambes mortes	,avoir	
ressemblance	,avoir	,offrir	,présenter	;rappeler	,avoir	,offrir	,présenter	,rappeler	
antennes	,avoir	,posséder	
le pied au plancher	,avoir	
bicross	,faire	
rage	,avoir	,souffrir	
satisfaction	,avoir	,éprouver	,ressentir	;goûter	
spectacle	,donner	
brosse	,avoir	
sieste	,faire	
musique	,faire	,jouer	
bagarreur	,se bagarrer	
maladie honteuse	,avoir	,souffrir	
mécontentement	,avoir	,éprouver	,ressentir	
tristesse	,avoir	,éprouver	,ressentir	
marche arrière	,faire	
vélo elliptique	,faire	
ski	,faire	
train	,former	,mener	
poissons	,être	
préjugé	,avoir	;nourrir	
pouvoir	,avoir	,exercer	,posséder	,tenir	
allergie	,souffrir	
coup de pied aux fesses	,donner	
vacherie	,faire	,dire	,sortir	
pipe	,faire	,tailler	
répugnance	,avoir	,éprouver	,ressentir	
jugement	,porter	
fourmis dans les jambes	,avoir	
acte de présence	,faire	
chantage	,faire	,exercer	,se livrer	,recourir	,user	,pratiquer	,faire	,exercer	,se livrer	,recourir	,user	,pratiquer	
roupillon	,faire	
ventre	,avoir	
cri	,faire	,pousser	,lancer	,jeter	,émettre	,lâcher	
produit	,calculer	,effectuer	,faire	
coup de maître	,faire	
environnement	,appartenir	,faire partie	;constituer	
visite	,faire	,rendre	,effectuer	
amour	,avoir	,éprouver	,porter	,ressentir	,avoir	,éprouver	,porter	,ressentir	
chat dans la gorge	,avoir	
>>>	Cf
ketchup	,mayonnaise	;moutarde	
parole	,élocution	
kilo	,gramme	,tonne	
foudre	,orage	;tonnerre	
chipoteuse	,avare	
sec	,déshydraté	
parquet	,plancher	
sévérité	,méchanceté	
assiette	,plat	
ochlophobie	,agoraphobie	
L’abus d’alcool est dangereux pour la santé.	,À consommer avec modération	
manger	,boire	
bar	,pression	
lune	,mois	
pâquerette	,marguerite	
batterie	,pile	
iceberg	,glaçon	
victime	,coupable	,coupable	
imam	,prêtre	,pasteur	,pope	
lever	,réveiller	
barbouze	,barbe	
duodecies	,quinquies	;sexies	
harnais	,selle	
paraphe	,signature	
en excès	,limitant	
figue	,datte	
urine	,excréments	
explosif	,bombe	
livre	,kilogramme	
analogie	,métaphore	
miel	,gelée royale	
bouclier	,épée	,glaive	
moyen métrage	,court métrage	,long métrage	
atomes crochus	,amitié	
noyade	,tasse	
viennoiserie	,pâtisserie	
crustacés	,coquillage	
susceptibilité	,colère	
yeux dans les yeux	,main dans la main	
anneau	,boucle	
Pâque	,Pâques	
peigne	,barrette	
tonne	,gramme	;kilo	,kilogramme	
tonnerre	,foudre	;orage	
allumette	,briquet	
doigts	,aube	
sol	,do	,ré	,mi	,fa	,la	,si	
assise	,dossier	,accoudoir	
avoir	,être	;aller	
écologique	,naturel	
venir	,aller	;avoir	,être	
crapaud	,grenouille	
soi	,moi	
nénuphar	,lotus	
nez	,bouche	;gorge	
are	,hectare	
âne	,mule	
abcès	,ampoule	
légende	,conte	
métro	,chemin de fer	,tramway	
chevilles	,pieds	;mollets	
minute	,seconde	
guidon	,volant	
anémone de mer	,corail	
recoucher	,coucher	
changement chimique	,changement physique	
fromage blanc	,yaourt	
futur	,passé	
corps pur	,mélange	
nostalgie	,mélancolie	,tristesse	
pope	,prêtre	,pasteur	,imam	
cervelle	,cerveau	
aube	,hélice	
casserole	,poêle	
cœur de bœuf	,tomate cerise	
planche à pain	,poitrine	
frelon	,guêpe	
source	,eau	
houle	,vague	
chaîne	,collier	
doigt	,sabot	
plus vieux métier du monde	,prostitution	
passé	,futur	
avertissement	,sanction	
unanimité	,majorité	
direction	,destination	
short	,pantalon	
tigresse	,furie	
jour des Morts	,Toussaint	
carapace	,coquille	
centimètre	,mètre	
paille	,tige	
ingambe	,jambes	
moutarde	,ketchup	;mayonnaise	
marcher	,nager	,ramper	,voler	
amour	,Vénus	
cravate	,nœud papillon	,écharpe	
exercice	,devoirs	
perspective	,relief	
ordinaire	,habitude	
>>>	Sing
crinière	,crin	,cheveu	
ping-pong	,match	,partie	,ping-pong	;rencontre	<compétition	,tournoi	
graine de lin	,graine	
sel	,grain	
poivre	,grain	
saucisse sèche	,rondelle	
appareillage	,appareil	
pharmacopée	,médicament	
alphabet	,lettre	
tennis	,match	,partie	,tennis	;rencontre	<compétition	,open	,tournoi	
crème	,pot	,tube	
gâteau	,part	,tranche	
tarte	,part	
pain d’épices	,tranche	,morceau	
crime	,crime	;crime	
karaté	,combat	<compétition	,tournoi	<championnat	
jogging	,jogging	
cornichon	,rondelle	,tranche	
cheval	,compétition	
mobiler	,meuble	
écurie	,box	
soupe	,assiette	,assiettée	;bol	
gymnastique	,séance	;gymnastique	,épreuve	<compétition	<championnat	
laser	,rayon	
métro	,ligne	
flottille	,bateau	
colère	,bouffée	
volley-ball	,match	,partie	,volley-ball	;rencontre	<compétition	,tournoi	<championnat	
industrie	,industrie	
couvée	,œuf	
batterie	,arme	
législation	,loi	
glace	,cristal	;glaçon	;bloc	,boule	,pain	;glaçon	;cube de glace	
marches	,marche	
sable	,grain	
végétation	,végétal	
tramway	,ligne	
guerre	,bataille	
randonnée	,randonnée	
terre	,motte	
dentition	,dent	
valetaille	,valet	
rayonnage	,rayon	
ail	<gousse	<tête	<botte	;filet	
miel	,pot	
musique	,morceau	,pièce	
magistrature	,magistrat	,magistrate	
lentilles	,boîte	,paquet	
averse	,goutte	
basket	,match	,partie	,basket	;rencontre	<compétition	,tournoi	<championnat	
laitue	,feuille	
nouilles	,paquet	
pâtes	,paquet	
pluie	,gouttelette	<goutte	
rock	,rock	
sueur	,goutte	
corolle	,pétales	
matraquage	,coup de matraque	
voirie	,voie	
toison	,cheveu	
titulature	,titre	
muguet	,brin	
air	,souffle	
farine	,paquet	;sac	
dentifrice	,flacon	,tube	,dentifrice	
parc	,arbre	;pelouse	;allée	
cheveux	,cheveu	
cheveu	,cheveu	
beurre	,noisette	,noix	;motte	
armement	,arme	
rugby	,match	,partie	,rugby	;rencontre	<compétition	,tournoi	<championnat	
tissu	,cellule	;fibre	
ligne de titres	,titre	
vent	,brin	<souffle	,bouffée	;courant d’air	
années	,année	
mayo	,flacon	,pot	,tube	
terminologie	,terme	
aviation	,avion	
neige	,flocons	;cristal	;boule	,boule de neige	
marche	,marche	
escalier	,marche	
chéquier	,chèque	
pelage	,poil	
mayonnaise	,flacon	,pot	,tube	
moutarde	;flacon	,pot	,tube	,verre	
riz	,grain	<paquet	
tabac	,pied	,paquet	,pot	
mâture	,mât	
feu	,coup de feu	
cartouche	,paquet	,cigarette	
membrure	,membre	
pain	,miette	<bout	,morceau	,tranche	
yaourt	,pot	,yaourt	<boîte	,pack	,paquet	
racaille	,racaille	
boxe	<combat	,match	<compétition	,tournoi	<championnat	
ponctuation	,signe de ponctuation	
rabbinat	,rabbin	
courrier	,courrier	
bouteille	,verre	
rôti	,tranche	
>>>	Mult
avion	;flotte	
bœuf	,cheptel	;troupeau	;bétail	
carte	,jeu	,paquet	
moustique	,essaim	;horde	,nuage	,nuée	
skis	,paire	
fibre	,tissu	
chaise	,rangée	
banc	,rangée	
bouton	,plaque	
vents	,orchestre	,ensemble	
employée	,personnel	
pompier	,caserne	,caserne	
comprimé	,boîte	,flacon	;tube	;plaquette	
Chleuh	,peuple	
trésor	,trésor	
appareil	,appareillage	
bruyère	,tapis	
racaille	,racaille	
touche	,clavier	
jour	,semaine	,semaine	<mois	,mois	
mât	,mâture	
ennemi	,ennemi	
ministre	,gouvernement	,ministère	,cabinet	
bandit	,bande	,gang	,horde	
cigarette	,paquet	<cartouche	
oiseau	,volée	
punaise	,colonie	
blues	,blues	
dizaine	,chapelet	,chapelet	
poil	,pelage	
parent	,famille	
fauteuil	,rangée	
courrier	,courrier	
personnel	,personnel	
bête à bon Dieu	,nuage	
injure	,chapelet	
marche	,escalier	,marches	
lecteur	,lectorat	
diamant	,rivière	
année	,années	
rock	,rock	
musique	,musique	,musique	
jumeau	,jumeaux	
coup de matraque	,matraquage	
chiffon	,tas	
chien	,horde	,meute	
client	,clientèle	
siège	,rangée	
dessous	,dessous	
navire	,flotte	,flottille	
végétal	,flore	,végétation	
poireau	,botte	
fruit	,grappe	
paysan	,paysannat	,paysannerie	
lettre	,alphabet	,correspondance	
meuble	,mobiler	
journaliste	,équipe	,groupe	;horde	,meute	;presse	;équipe	,groupe	;horde	,meute	;presse	
crin	,crinière	
chèvre	,troupeau	
lion	,bande	
tabouret	,rangée	
enfant	,enfance	
bataille	,guerre	,conflit	
vache	,troupeau	;cheptel	
cours	,cours	
employé	,personnel	
herbe	,touffe	
poussin	,couvée	
chaussettes	,paire	
musicienne	,ensemble	,groupe	,troupe	,orchestre	
pétales	,corolle	
gendarme	,gendarmerie	
chaussons	,paire	,paire	
pièce de vaisselle	,vaisselle	
paysanne	,paysannat	,paysannerie	
grappe	,raisin	
médicament	,pharmacopée	
datte	,grappe	,régime	
élément	,ensemble	
feuille	,feuillage	,papier	
cigare	,boîte	
part	,capital	
faux ami	,lexique	,vocabulaire	
jambes	,paire	
voyou	,bande	,gang	,horde	
coup de feu	,feu	
enveloppe	,paquet	
assiette	,pile	
rabbin	,rabbinat	
poisson	,banc	
muguet	,tapis	
jumelle	,jumelles	
pin	,pinède	,pineraie	,pinière	
abeille	,colonie	,essaim	;horde	,nuage	,nuée	
lectrice	,lectorat	
oignon	,botte	;filet	
homme	,humanité	
banane	,régime	
seins	,poitrine	;paire	
fleur	,grappe	;inflorescence	;massif	,tapis	;bouquet	
>>>	Hypo
siège	;banc	;canapé	;chaise	;fauteuil	;tabouret	
logiciel	,utilitaire	;aspirateur	,gestionnaire	
signe	,poissons	,taureau	
évènement	,évènement sportif	
examen	,bac	
nage	,brasse	,brasse-papillon	,crawl	,dos	,dos brassé	,dos crawlé	,nage indienne	
piano	,piano droit	,piano à queue	,piano crapaud	
drogue	,herbe	
compte	,compte	
marsupial	,kangourou	
véhicule roulant	;autobus	,motocyclette	,deux-roues	,moto	,bicyclette	,voiture	,automobile	;auto	,véhicule	,vélo	,bus	,autocar	;car	,train	,tramway	;voiture	,wagon	
discipline	,sport	,sprint	
pompe	,pompe	,pompe	
lampe	,lampe-tempête	
guitare	,guitare sèche	;guitare électrique	
pierre précieuse	,diamant	,émeraude	,rubis	,saphir	,diamant	
sacrement	,baptême	
argot	,loucherbem	
jour	,lundi	,mardi	,mercredi	,jeudi	,vendredi	,samedi	,dimanche	
handicap	,patte folle	
cycle	,vélo	,bicyclette	,tricycle	,tandem	
cétacé	,baleine	
respiration	,petit chien	
saison	,printemps	,été	,automne	,hiver	
orifice	,narines	
connecteur	,implication	
orchestre	,fanfare	,harmonie	
boucle	,boucle articulatoire	
articulation	,articulation temporo-mandibulaire	;articulation crico-aryténoïdienne	,première articulation	,deuxième articulation	,troisième articulation	
date	,treize	;trente	
félins	,chat	
volume	,cube	,sphère	
doigt	,auriculaire	,pouce	
nucléon	,proton	,neutron	
outil	,aiguisoir	,cisaille	,clé	,enclume	,fraise	,marteau	,pelle	,pic	,pince	,pioche	,poinçon	,rabot	,râteau	,scie	,tenailles	,tournevis	,truelle	,vilebrequin	
crotte	,fiente	,crottin	
femme de loi	,avocate	,magistrate	
phénomène atmosphérique	,nuage	,orage	,pluie	,tempête	,tempête	,tornade	,vent	
fonds commun de placement	,fonds commun de placement à risque	
particule	,particule subatomique	
porte	,porte à tambour	
pâtisserie	,éclair	,fondant	,opéra	,pièce montée	
pain	,pain polaire	
épreuve	,bac	
musique	,musique classique	,musique classique	
briquet	,briquet-tempête	
émonctoire	,narines	
fourrure	,vair	
désert	,erg	,reg	
wagon	,wagon-lits	,wagon-restaurant	
véhicule flottant	,bateau	,navire	,bâtiment	
son	,coup	
coordonnées	,mail	
dispositif	,additionneur	
volcan	,volcan gris	,volcan rouge	;guyot	
régime réel	,régime réel normal	,régime réel simplifié	
champ	,objet	
transports	,transport ferroviaire	
cartilage	,cricoïde	,aryténoïde	
mot	,gros mot	,mot magique	
homme de loi	,avocat	,magistrat	
sens	,ouïe	,vue	,odorat	,goût	,toucher	
escargot	,escargot de Bourgogne	,petit-gris	
arme blanche	,épée	
champ scalaire	,fonction	
véhicule	,automobile	,auto	,voiture	;autocar	,car	,autobus	,bus	;camion	,poids lourd	;camionnette	,fourgonnette	
instrument de mesure	,mètre	
nombre	,entier	,singulier	,pluriel	,duel	
crime	,crime	;cambriolage	,vol	;délit	,forfait	;kidnapping	,enlèvement	,rapt	;viol	;fraude	
douche	,cabine	
mois	,janvier	,février	,mars	,avril	,mai	,juin	,juillet	,août	,septembre	,octobre	,novembre	,décembre	
dimension	,longueur	,largeur	,hauteur	,profondeur	
dent	,canine	;incisive	;molaire	;prémolaire	,canine	;incisive	;molaire	;prémolaire	
voiture	,voiture-bar	,voiture-restaurant	,wagon-restaurant	;voiture-couchettes	,wagon-couchettes	;voiture-lits	,wagon-lits	
exclamation	,misère	
bilan	;bilan instrumental	,bilan standardisé	;bilan écologique	;bilan de renouvellement	;bilan d’investigation	,bilan de contrôle	;bilan pré-opératoire	,bilan post-opératoire	;bilan pré-implantation	
cuir	,agneau	,veau	
matière	,matière ordinaire	,matière noire	,antimatière	
saint	,saint patron	
film	,documentaire	;court métrage	,moyen métrage	,long métrage	
coiffure	,chignon	
mésange	,mésange bleue	,mésange boréale	,mésange charbonnière	,mésange huppée	,mésange nonnette	
braguette	,fermeture éclair	
jeu	,larigot	
document	,enregistrement	
pierre fine	,grenat	
canapé	,canapé-lit	,clic-clac	,convertible	
équidés	,âne	;cheval	;zèbre	
appartement	,meublé	;penthouse	;garçonnière	;studio	;loft	;duplex	;triplex	;quadruplex	,une-pièce	;F1	,T1	;deux-pièces	,F2	,T2	;trois-pièces	,F3	,T3	;quatre-pièces	,F4	,T4	;cinq-pièces	,F5	,T5	;six-pièces	,F6	,T6	;sept-pièces	,F7	,T7	;huit-pièces	,F8	,T8	;neuf-pièces	,F9	,T9	;dix-pièces	,F10	,T10	
cimetière	,tombe	
message	,courriel	,sms	
voilier	,jonque	
diplôme	,doctorat	
maquillage	,rouge à lèvres	
champ vectoriel	,fonction	
sport	,sport aérien	;sport d’hiver	;sport de combat	;sport de glisse	;sport mécanique	;sport nautique	
pantalon	,jean	;patte d’éléphant	
vitesse	,première	,deuxième	,troisième	
cinéma	;parlant	,sonore	,muet	;en 2 dimensions	,en 2D	,en 3 dimensions	,en 3D	,relief	;noir et blanc	,couleur	
sandwich	,cheeseburger	,croque-monsieur	;hamburger	,hot-dog	,kebab	,pan bagnat	,panini	
>>>	Fact_2
accusatrice	,accuser	
four	,cuire	,brûler	
camion	,acheminer	,transporter	
trieur	,trier	
autocar	,transporter	
orchestre	,jouer	,interpréter	;repéter	
vétérinaire	,examiner	;s’occuper	;soigner	,traiter	,examiner	;s’occuper	;soigner	,traiter	
journaliste	,couvrir	;enquêter	,couvrir	;enquêter	
ami	,aider	;protéger	,aider	;encourager	;protéger	
bocal	,contenir	
mécanicienne	,conduire	
véhicule	,véhiculer	,transmettre	
navire	,transporter	
composant	,composer	
chasseur	,chasser	
guirlande	,agrémenter	,embellir	
accompagnateur	,accompagner	,accompagner	
étagère	,supporter	
collectionneur	,collectionner	
bastion	,protéger	
commentatrice	,commenter	
factrice	,fabriquer	
porteur	,porter	
avocat	;conseiller	;représenter	;défendre	,défendre	;lutter	,militer	
arracheur	,arracher	
concepteur	,concevoir	
voyou	,agresser	,tabasser	;racketter	,voler	
bus	,transporter	
bol	,contenir	
avion	,transporter	
garant	,garantir	
dent	,mordre	;croquer	;broyer	,s’emboîter	,broyer	,déchirer	
conceptrice	,concevoir	
administrateur	,administrer	
médecin	,examiner	;s’occuper	;soigner	,traiter	,examiner	;s’occuper	;soigner	,traiter	
facteur	,fabriquer	
couleur	,colorer	
accompagnatrice	,accompagner	,accompagner	
chasseuse	,chasser	
parasite	,profiter	,profiter	
commentateur	,commenter	
criminel	,commettre	,se livrer	
trieuse	,trier	
avocate	,conseiller	;représenter	;défendre	,défendre	;lutter	,militer	
vague	,frapper	,heurter	;submerger	
caractéristique	,caractériser	
chercheur	,chercher	
semeur	,semer	
aspirateur	,aspirer	;avaler	,absorber	,aspirer	,absorber	,avaler	
pluie	,mouiller	,arroser	<laver	<tremper	,détremper	,lessiver	,doucher	<noyer	;transpercer	,traverser	,pénétrer	;alimenter	
peloton de tête	,mener	
boucher	,couper	,découper	;débiter	;dépecer	
combattante	,combattre	,se battre	
garante	,garantir	
boulanger	,faire	;préparer	
hélicoptère	,transporter	
lessive	,laver	,nettoyer	
accompagnement	,accompagner	
semeuse	,semer	
casserole	,contenir	
dentifrice	,laver	,nettoyer	
tempête	,s’abattre	;balayer	;frapper	
acheteuse	,acheter	
ennemi	,détester	;nuire	,combattre	,lutter	;s’opposer	;nuire	
mécanicien	,créer	,inventer	
agresseuse	,agresser	
boulangère	,faire	;préparer	
car	,transporter	
représentation	,représenter	
acheteur	,acheter	
opéra	,donner	
bouchère	,couper	,découper	;débiter	;dépecer	
père	,élever	,s’occuper	,prendre soin	,s’occuper	,prendre soin	
arbitre	,arbitrer	
bateau	,transporter	
soleil	,illuminer	
bouchon	,boucher	,obstruer	
coiffeur	,coiffer	;couper les cheveux	
agresseur	,agresser	
mère	,élever	,s’occuper	,prendre soin	;allaiter	,donner le sein	,nourrir	,s’occuper	,prendre soin	
voiture	,transporter	
camionnette	,transporter	
administratrice	,administrer	
triangle	,signaler	
nappe	,recouvrir	
présure	,cailler	
barbier	,raser	
chanteuse	,chanter	
chat	,attraper	;toucher	
tornade	,bousculer	,secouer	<dévaster	,secouer	
accusateur	,accuser	
tyran	,tyranniser	
bandit	,commettre	,se livrer	
savon	,laver	,nettoyer	,laver	,nettoyer	
combattant	,combattre	,se battre	
dents	,couper	,scier	;broyer	
tramway	,desservir	
chanteur	,chanter	
aide	,aider	,aider	
muscle	,mouvoir	
>>>	SingS_1
table	,convive	,convive	,serveur	,serveuse	;cuisinier	,cuisinière	;chef	
émigration	,émigré	,émigrée	
patronat	,patron	,patronne	
nippon	,Nippon	,Nippone	
russe	,Russe	,Russe	;russophone	,russophone	
noms	,noms	
Bretagne	,Breton	
putsch	,putschiste	
Corée	,Coréen	,Coréenne	
germanique	,Germanique	,Germanique	
ballet	,danseur	,danseuse	
orchestre	,musicien	,musicienne	
cru	,vin	
boche	,Boche	,Boche	
poissons	,poisson	
pinière	,pin	
centre aéré	,enfant	
salariat	,salarié	,salariée	
portée	,petit	
fichier	,fiche	
Moyen-Âge	,médiéval	
coréen	,Coréen	,Coréenne	
collection	,vêtement	
bureau	,secrétaire	,trésorier	,trésorière	,employé	,employée	,collègue	;collègue	
faune	,animal	
Irlande	,Irlandais	,Irlandaise	
exemplier	,exemple	
personnel	,employé	,employée	,membre	,personnel	
grec	,Grec	,Grecque	
Italie	,Italien	,Italienne	
breton	,Breton	,Bretonne	
trésor	,trésor	
aire de jeux	,enfant	,enfant	
reptiles	,reptile	
pineraie	,pin	
Nouvelle-Zélande	,Kiwi	
espagnol	,Espagnol	,Espagnole	;hispanophone	,hispanophone	
suédois	,Suédois	,Suédoise	
gouvernement	,ministre	
visite	,visiteur	,visiteuse	;participant	,participante	
gens	,personne	,individu	
chleuh	,Chleuh	,Chleuh	,Chleuh	
Allemagne	,Allemand	,Allemande	
occupant	,occupant	
œuvre	,œuvre	
Turquie	,Turc	,Turque	
bordel	,prostituée	
lexique	;mot	;lexème	
paysannerie	,paysan	,paysanne	
brosserie	,brosse	
gallois	,Gallois	,Galloise	
marine	,marin	
Hollande	,Hollandais	,Hollandaise	
maison close	,prostituée	
restaurant	,serveur	,serveuse	
Australie	,Australien	,Australienne	
Japon	,Japonais	,Japonaise	,Nippon	,Nippone	
famille	,membre	;parent	,membre	,membre	,membre	,membre	,mafioso	
fratrie	,frère	,sœur	
Corée du Sud	,Sud-Coréen	,Sud-Coréenne	
direction	,directeur	,directrice	
Corée du Nord	,Nord-Coréen	,Nord-Coréenne	
théâtre	,comédien	,comédienne	,acteur	,actrice	
Grande-Bretagne	,Britannique	,Britannique	
États-Unis	,Américain	,Américaine	;États-unien	,États-unienne	
forêt	,arbre	
flore	,végétal	
oiseaux	,oiseaux	,oiseau	
allemand	,Allemand	,Allemande	;germanophone	,germanophone	
Espagne	,Espagnol	,Espagnole	
anglais	,Anglais	,Anglaise	;anglophone	,anglophone	
vers	,ver	
réserve	,réserviste	,réserviste	
paysannat	,paysan	,paysanne	
conseil municipal	,conseiller municipal	,conseillère municipale	,conseiller municipal	,conseillère municipale	
chinois	,Chinois	,Chinoise	;sinophone	,sinophone	
active	,actif	
clavier	,touche	
enfance	,enfant	,enfant	
angliche	,Angliche	
mairie	,conseiller municipal	,conseillère municipale	
équipage	,membre	
pays	,habitant	,habitante	;citoyen	,citoyenne	,pays	
Chine	,Chinois	,Chinoise	
gorge chaude	,rapace	
turc	,Turc	,Turque	
carré	,fantassin	,soldat	,femme soldat	,militaire	,militaire	
synagogue	,rabbin	
pinède	,pin	
Belgique	,Belge	,Belge	
Portugal	,Portugais	,Portugaise	
équipe	,membre	
Triangle	,étoile	
français	,Français	,Française	;francophone	,francophone	
électorat	,électeur	,électrice	
lectorat	,lecteur	,lectrice	
Amérique	,Américain	,Américaine	,Américain	
japonais	,Japonais	,Japonaise	
portugais	,Portugais	,Portugaise	;lusophone	,lusophone	
Canada	,Canadien	,Canadienne	
>>>	Syn_⊂^sex
ambitieuse	,ambitieux	
savante	,savant	
agitée	,agité	
mal-aimée	,mal-aimé	
bouffeuse	,bouffeur	,bouffeur	,bouffeur	
météorologue	,météorologue	
gaspilleuse	,gaspilleur	
suicidaire	,suicidaire	
protestante	,protestant	
rousse	,roux	
motarde	,motard	
vieillarde	,vieillard	
paralysée	,paralysé	
hétéro	,hétéro	
découpeuse	,découpeur	
faux-cul	,faux-cul	
sapeuse-pompière	,sapeur-pompier	
SDF	,SDF	
Allemande	,Allemand	
ourse	,ours	
fabuliste	,fabuliste	
institutrice	,instituteur	,instit	
compositrice	,compositeur	
dirigeante	,dirigeant	
monitrice	,moniteur	
instructrice	,instructeur	
vendeuse	,vendeur	
accusatrice	,accusateur	
élue	,élu	
locutrice	,locuteur	
correspondante	,correspondant	,correspondant	
séductrice	,séducteur	
prêtresse	,prêtre	
demandeuse	,demandeur	
lexicographe	,lexicographe	
communiste	,communiste	
appelante	,appelant	
tricheuse	,tricheur	
goûteuse	,goûteur	
raconteuse	,raconteur	
fautive	,fautif	
créatrice	,créateur	
cancre	,cancre	
compagne	,compagnon	,compagnon	
auto-stoppeuse	,auto-stoppeur	
estivante	,estivant	
expérimentatrice	,expérimentateur	
rameuse	,rameur	
citatrice	,citateur	
mineure	,mineur	
mime	,mime	
péteuse	,péteur	
assurée	,assuré	
parachutiste	,parachutiste	
demanderesse	,demandeur	
instrumentiste	,instrumentiste	
maçonne	,maçon	
gendarme	,gendarme	
tragédienne	,tragédien	
marchande	,marchand	
lectrice	,lecteur	
ébéniste	,ébéniste	
sénatrice	,sénateur	
résidente	,résident	
machiniste	,machiniste	,machiniste	
destinatrice	,destinateur	
cordonnière	,cordonnier	
incendiaire	,incendiaire	
chirurgienne-dentiste	,chirurgien-dentiste	
louve	,loup	
procréatrice	,procréateur	
motocycliste	,motocycliste	
serveuse	,serveur	
déesse	,dieu	
chercheuse	,chercheur	,chercheur	
grippée	,grippé	
familière	,familier	
collégienne	,collégien	
détentrice	,détenteur	
volontaire	,volontaire	
tenniswoman	,tennisman	
malchanceuse	,malchanceux	
hase	,lièvre	
lice	,chien de chasse	
cane	,canard	
anarchiste	,anarchiste	
parasite	,parasite	
misérable	,misérable	,misérable	
sourde	,sourd	
coursière	,coursier	
libraire	,libraire	
ingénieure	,ingénieur	
palefrenière	,palefrenier	
Nord-Américaine	,Nord-Américain	
aide	,aide	
débutante	,débutant	
originale	,original	
campagnarde	,campagnard	
inspiratrice	,inspirateur	
fondeuse	,fondeur	
