>>>	S_0
unir	,union	
ethnique	,ethnie	
exporter	,exportation	,export	
fermer	,fermeture	
balayer	,balayage	
discuter	,discussion	
se désertifier	,désertification	
élaboré	,élaboration	
diffuser	,diffusion	,diffusion	,diffusion	
s’étouffer	,étouffement	
se situer	,situation	
pleurer	,pleurs	
tactique	,tactique	,tactique	
grippal	,grippe	
se déshabiller	,déshabillage	
flotter	,flotte	,flottement	
payer	,paiement	
secourir	,secours	
sortir	,sortie	
raï	,raï	
manifester	,manifestation	
voter	,vote	,suffrage	
naufrager	,naufrage	
danser	,danse	
rappeler	,rappel	
se reproduire	,reproduction	
expérimental	,expérience	
divin	,dieu	
abdiquer	,abdication	,abdication	
s’effondrer	,effondrement	
s’enrichir	,enrichissement	
s’abaisser	,abaissement	
chinois	,Chine	
tousser	,toux	
opposer	,opposition	
administrer	,administration	,administration	
capillaire	,cheveu	
réflexe	,réflexe	
se disputer	,dispute	
échanger	,échange	
décaler	,décalage	
se venger	,vengeance	
gris	,gris	
exceptionnel	,exception	
rugbystique	,rugby	
se balader	,balade	
prier	,prière	
témoigner	,témoignage	
qualitatif	,qualité	
rejeter	,rejet	
synonymique	,synonyme	
pardonner	,pardon	
doubler	,doublement	,doublement	,doublage	,doublage	
documentaire	,document	
critiquer	,critique	
rabbinique	,rabbin	
se diffuser	,diffusion	
raisonner	,raisonnement	
éclairer	,éclairage	
domanial	,domaine	
parier	,pari	
racinaire	,racine	
grouper	,groupement	
admirer	,admiration	
dépenser	,dépense	
populaire	,peuple	
vertical	,verticale	
accoucher	,accouchement	
masser	,massage	
moucher	,mouchage	
>>>	A_2Perf
accepter	,accepté	
inscrire	,inscrit	
goudron	,goudronné	
entamer	,entamé	
décider	,décidé	
épuiser	,épuisé	
asseoir	,assis	
contraindre	,contraint	
amuser	,amusé	
nationaliser	,nationalisé	
soulager	,soulagé	
lacer	,lacé	
déplacer	,déplacé	
griller	,grillé	
promettre	,promis	
détacher	,détaché	
rabattre	,rabattu	
abandonner	,abandonné	
hacher	,haché	
munir	,muni	
éplucher	,épluché	
interdire	,interdit	
attacher	,attaché	
user	,usé	
décorer	,décoré	,décoré	
éteindre	,éteint	
affaiblir	,affaibli	
détruire	,détruit	,détruit	
envahir	,envahi	,envahi	
épouvanter	,épouvanté	
convaincre	,convaincu	
barrer	,barré	
vaincre	,vaincu	
habiller	,habillé	
décaler	,décalé	,décalé	
étirer	,étiré	
afficher	,affiché	
bourrer	,bourré	
enregistrer	,enregistré	
domestiquer	,domestique	
imposer	,imposé	
réveiller	,réveillé	
amputer	,amputé	
exposer	,exposé	
empoisonner	,empoisonné	
approvisionner	,approvisionné	
diplômer	,diplômé	
adopter	,adoptif	
accentuer	,accentué	,accentué	,accentué	
fendre	,fendu	
accuser	,accusé	
installer	,installé	
diminuer	,diminué	
aider	,aidé	
animer	,animé	
meubler	,meublé	
fâcher	,fâché	
ruiner	,ruiné	
disposer	,disposé	
allumer	,allumé	,allumé	,allumé	
garnir	,garni	
encadrer	,encadré	
entendre	,entendu	
lisser	,lissé	
décoller	,décollé	
voir	,vu	
ouvrir	,ouvert	
dégoûter	,dégoûté	
orienter	,orienté	
consommer	,consommé	
>>>	Syn_∩
se distinguer	,s’illustrer	
réprimande	,savon	
alter ego	,jumeau	
venger	,laver	,laver	
garçon	,célibataire	
identique	,même	;pareil	
embouchure	,estuaire	;bouche	
étambot	,poupe	
déchiré	,saoul	,ivre	,blindé	,cuité	<bourré	,pinté	<beurré	,rond	,plein	,pété	,torché	,raide	,arraché	
s’appuyer	,appuyer	,s’adosser	,s’adosser	;compter	
vaincre	,battre	
entraîné	,exercé	
furibard	,furax	,furieux	
repentir	,regret	
képi	,casquette	
semblable	,analogue	,similaire	;comme	
choisir	,adopter	
nuage	,brouillard	,brume	,volée	,goutte	,larme	,pointe	,rien	,soupçon	,trait	
diable	,démon	
blindé	,ivre	,saoul	,cuité	<bourré	,pinté	<beurré	,rond	,plein	,pété	,torché	,déchiré	,raide	,arraché	,cuirassé	,endurci	
sucre	,morceau	
même	,ou	,identique	
donner le sein	,allaiter	
giclement	,émission	
nettoyé	,entretenu	
déplacement	,voyage	,mouvement	,voyage	
hellénique	,grec	
circuit	,route	
âge	,époque	
taille	,dimension	
s’achever	,finir	,se terminer	
adulte	,grand	
sans-emploi	,chômeur	,chômeuse	
victorieusement	,glorieusement	
se poser	,atterrir	
marine	,navigation	
partie	,élément	,domaine	,jeu	;match	
tête	,cerveau	,cervelle	,crâne	,caboche	,cafetière	,ciboulot	,cigare	,face	,figure	,gueule	,visage	;tronche	,chef	,visage	,cheveux	,cheveu	,individu	,personne	
nourriture	,manger	
têtu	,obstiné	,buté	;entêté	,intraitable	,intransigeant	,inflexible	
galop	,course	
opinion	,avis	
privatiser	,dénationaliser	
détérioré	,délabré	;endommagé	
grec	,hellénique	
soulager	,apaiser	
plein	,rempli	,ivre	,saoul	<blindé	,cuité	<bourré	,pinté	<beurré	,rond	,pété	,torché	,déchiré	,raide	,arraché	
graine	,semence	
rade	,port	
ressemblance	,similarité	,similitude	,analogie	;affinité	;comparaison	,parallélisme	;analogie	,parenté	,air de famille	;similitude	
flot	,torrent	,pluie	
se glisser	;se blottir	,se fourrer	
acheminer	,véhiculer	,envoyer	,expédier	
fatigue	,faiblesse	;coup de mou	
bouilloire	,samovar	
pollueur	,polluant	
case	,carré	,cabane	
importance	,priorité	
miraculeusement	,par l’opération du Saint-Esprit	
vexation	,affront	
avec	,en compagnie	,en présence	,de	,en	;à coups	,à l’aide	,au moyen	;à cause	
contre	,près	;côte à côte	,avec	
se fleurir	,fleurir	
demeure	,maison	;domicile	
formes	,silhouette	
quelque part	,ailleurs	,partout	;ici	;là	;y	
remède	;médicament	,solution	
plantation	,champ	
coup pour coup	,Œil pour œil, dent pour dent	
scintiller	,étinceler	
>>>	Anti
sommeil	,éveil	,veille	
impoli	,poli	
matériel	,spirituel	
polluant	,propre	
insincérité	,sincérité	
éteint	,allumé	
heureux	,malheureux	
minuscule	,majuscule	
avoir froid	,avoir chaud	
installer	,désinstaller	
disgrâce	,grâce	
pudeur	,impudeur	
sain	,malsain	
immobile	,mobile	
irréconciliable	,réconciliable	
par-dessus	,par-dessous	
défaveur	,faveur	
impertinent	,pertinent	
maximum	,minimum	
agité	,calme	
se décontracter	,se contracter	
sécurité	,insécurité	
juste	,injuste	,faux	
accrocher	,décrocher	
aspirer	,expirer	
séparable	,inséparable	
acteur	,spectateur	
fermé	,ouvert	,ouvert	
ranger	,déranger	
non-usage	,usage	
sombre	,clair	
orienter	,désorienter	
prendre l’habit	,quitter l’habit	
gouvernable	,ingouvernable	
incapable	,capable	
importateur	,exportateur	
modestie	,immodestie	
cradingue	,impeccable	
modéré	,immodéré	
dessus	,dessous	,dessous	
détromper	,tromper	
inférieur	,supérieur	,supérieur	
dedans	,dehors	,dehors	
baisser	,augmenter	
sortir	,entrer	,entrer	,rentrer	
perdre	,gagner	
tolérance	,intolérance	
croiser	,décroiser	
inconsciemment	,consciemment	
lever l’ancre	,jeter l’ancre	
décharger	,charger	
vrai	,faux	,faux	
mécontent	,content	
meuble	,immeuble	
compréhension	,incompréhension	
dérouler	,enrouler	
déplanter	,planter	
élargir	,rétrécir	
fermer	,ouvrir	,ouvrir	,ouvrir	,ouvrir	
sec	,humide	
inéligibilité	,éligibilité	
public	,privé	
minimum	,maximum	
accepter	,refuser	
insuffisamment	,suffisamment	,suffisamment	
après	,avant	,avant	,avant	,avant	
augmenter	,baisser	
décroiser	,croiser	
efficacité	,inefficacité	
fort	,faible	,léger	
>>>	Syn_⊃
peuple	,petit peuple	
continent	,Asie	,Europe	
décoration	,cravate	
cap	,nez	
chat	,matou	
se fourrer	,se blottir	
déception	,déconvenue	,désappointement	
avaler	;boire	;manger	
contenu	,corps	
coureur	,fondeur	,sprinter	,coureuse	
cyclisme	,petite reine	
promeneuse	,flâneuse	
crado	,dégueu	,dégueulasse	
punition	,savon	
odorant	,parfumé	
enivrer	,griser	
teub	,cigare	,phallus	
maigre	,squelettique	
électeur	,votant	
situé	,disposé	
précipitation	,averse	
adresse	,table	
coupé	,haché	
Japon	,Pays du Soleil Levant	,Pays des Cerisiers en fleurs	
plume	,écrivain	,écrivaine	
voyage	,vol	;lune de miel	
dans	,à l’intérieur	
perdre la vie	,succomber	,passer l’arme à gauche	,s’éteindre	
couple	,ménage	;mariage	
superfamille	,famille	
restaurant	,cantine	
manche	,set	,cigare	,phallus	
bête	,animal	
poursuivre	,pourchasser	
requin	,squale	;chien de mer	
cri	,rugissement	
maison	,pavillon	
tâche	,sale boulot	
analogue	;analogue	
pluie	,bruine	,crachin	;ondée	;giboulée	;drache	
religieuse	,mère	
se griller	,cloper	
pression	,chantage	
bouche	,bec	,bec	
tête	,crâne	
intérieur	,dedans	
discours	,toast	
avoir froid	,se geler les fesses	
tissu	,étoffe	,drap	,toile	
rire	,se fendre la pipe	
craquelure	,cheveu	
grands-parents	,grand-mère	,grand-père	
cellule familiale	,famille	
hamburger	,cheeseburger	
boire	,s’enfiler	,siffler	,caresser la bouteille	
promeneur	,flâneur	
pédale	,tante	
cantine	,mess	
revêtement	,enveloppe	
cigarette	,roulée	;blonde	,brune	
vélo	,tandem	
femme	,mère	
quarante	,quarantaine	
jumeau	,clone	,sosie	
collation	,goûter	
enlèvement	,kidnapping	
visage	,minois	
chant	,hymne	
danser	,dansoter	
cinquante	,cinquantaine	
>>>	S_1
bouche	,arme à feu	,vin	
Alcooliques Anonymes	,alcoolique	
médicament	,malade	,malade	
mouche	,pêcheur	,pêcheuse	;moucheur	,fleuret	
éclair de magnésium	,appareil photo	
appartenir	,propriété	
hypnotiser	,hypnotiseur	,hypnotiseuse	
gentillesse	,gentil	,gentille	
bénévolat	,bénévole	
conduire	,conductrice	,conducteur	
corps	,texte	;récit	,caractère	;police	
Hollande	,Hollande	
boire	,buveur	,buveuse	,buveur	,buveuse	
sourcils	,animal	
peigne	,animal	
bicyclette	,cycliste	,cycliste	,cycliste	,cycliste	
chômage	,chômeuse	,chômeur	
gâcher	,gâcheur	,gâcheuse	
lisse	,bateau	,navire	
amateur	,amateur	,amatrice	
solide	,matière	,substance	
Belgique	,Belgique	
proche	,proche	
métro	,passager	,passagère	;voyageur	,voyageuse	,usager	,usagère	,métro	
fleuve des Enfers	,mort	
théier	,thé	
adorer	,adoratrice	,adorateur	
occuper	,occupant	
épluchure	,légume	
rame	,papier	
gymnastique	,gymnaste	,gymnaste	
corbeau	,cheveux	
mère	,femme	
causer	,cause	
aboyer	,chien	,chienne	
tirage	,imprimeur	
xénophobie	,xénophobe	,xénophobe	
priorité	,priorité	
information	,informateur	,informatrice	
nullité	,nul	,nulle	
pot	,plante	,véhicule	
ramadan	,musulman	
église	,ecclésiastique	
dictature	,dictateur	,dictatrice	
profession	,professionnel	,professionnelle	
exécuter	,exécuteur	
Japon	,Japon	
composer	,composant	,compositeur	,compositrice	
couleur	,carte	
prunier	,prune	
adoptif	,adoptant	,adoptante	,adopté	,adoptée	
enveloppe	,expéditeur	,expéditrice	,montant	,valeur	
miaulement	,chat	,chatte	
adoptant	,adoptant	,adoptante	
alternatif	,alternative	
brute	,brutalité	
ministère	,ministre	,ministre	
retardataire	,retardataire	,retardataire	
compenser	,compensation	
débrouillardise	,débrouillard	,débrouillarde	
Enfer	,diable	,diablesse	
armée	,militaire	,militaire	
raconter	,conteuse	,conteur	
peau	,animal	
coiffure	,coiffeur	,coiffeuse	
train	,véhicule	
timbre	,voix	
donner le sein	,mère	;nourrice	
peuple	,habitant	,habitante	
sommeil	,dormeur	,dormeuse	
>>>	A_0
logique	,logique	
ouïe	,auditif	
énergétiquement	,énergétique	
collégien	,collégien	
volcan	,volcanique	
train	,ferroviaire	
profession	,professionnel	
nation	,national	
vert	,vert	
obligatoirement	,obligatoire	
diaboliquement	,diabolique	
gendarmette	,gendarmesque	
bien	,bon	,bien	
coopérer	,coopératif	
batellerie	,batelier	
cauchemar	,cauchemardesque	
récemment	,récent	
vaccin	,vaccinal	
courbe	,courbe	
géométrie	,géométrique	
vase	,vaseux	
délit	,délictueux	
ridiculement	,ridicule	
généralement	,général	
relation	,relationnel	
agréablement	,agréable	
angle	,angulaire	
similairement	,similaire	
froid	,froid	
institution	,institutionnel	
bassement	,bas	
Soleil	,solaire	
gratuitement	,gratuit	
doigt	,digital	
félins	,félin	
pluriel	,pluriel	
bactérie	,bactérien	
maison	,domestique	
fièrement	,fier	
grippe	,grippal	
incroyablement	,incroyable	
chèrement	,cher	
tarif	,tarifaire	
banane	,bananier	
intimement	,intime	
pape	,papal	
danser	,dansant	
parallèlement	,parallèle	
menton	,mentonnier	
cercle	,circulaire	
vent	,éolien	
ventre	,ventral	,ventral	
désespérer	,désespéré	
chat	,félin	
aile	,alaire	
dimanche	,dominical	
nager	,natatoire	
face	,facial	
terre	,terreux	
véritablement	,véritable	
supplémentairement	,supplémentaire	
élire	,électoral	
gorge	,jugulaire	,guttural	
exceptionnellement	,exceptionnel	,exceptionnel	
louer	,locatif	
forme	,formel	,formel	
ethnie	,ethnique	
blanc	,blanc	
semoule	,semoulier	
lune	,lunaire	
>>>	Able_2
recommander	,recommandable	
vacciner	,vaccinable	
importer	,importable	
consommer	,consommable	
mesurer	,mesurable	
effacer	,effaçable	
cultiver	,cultivable	
attaquer	,attaquable	
angoisse	,angoissant	
arracher	,arrachable	
qualifier	,qualifiable	
compensation	,compensable	,compensable	
décoller	,décollable	
atteindre	,atteignable	
décrire	,descriptible	
rabattre	,rabattable	
adaptable	,adapter	
toucher	,touchable	
loger	,logeable	
exécuter	,exécutable	
connaissance	,connaissable	
multiplier	,multipliable	
habiter	,habitable	
adapter	,adaptable	
prévoir	,prévisible	
imagination	,imaginable	
deviner	,devinable	
détruire	,destructible	,destructible	
inonder	,inondable	
voir	,visible	
nettoyer	,nettoyable	,nettoyable	,nettoyable	,nettoyable	
analyser	,analysable	
reproduire	,reproductible	
glisser	,glissant	
expliquer	,explicable	
croire	,crédible	,crédible	
sympathie	,sympathique	,sympa	
manger	,mangeable	,comestible	
opposer	,opposable	
anxiété	,anxiogène	
tourner	,tournant	
débit	,débitable	
améliorer	,améliorable	
dater	,datable	
vérifier	,vérifiable	
mourir	,mortel	
composition	,composable	
critiquer	,critiquable	
calcul	,calculable	
compréhension	,compréhensible	
déplacer	,déplaçable	
citer	,citable	
somme	,sommable	
organiser	,organisable	
communication	,communicable	
scier	,sciable	
connaître	,connaissable	
douter	,douteux	
solution	,soluble	
remplacer	,remplaçable	
accepter	,acceptable	
trier	,triable	
exporter	,exportable	
rembourser	,remboursable	
acheter	,achetable	
labourer	,labourable	,arable	
réparer	,réparable	
achetable	,acheter	
avouer	,avouable	
tempête	,exposé	
>>>	Anti_∩
connaître	,ignorer	
concentrer	,déconcentrer	
embellie	,tempête	,tempête	
demeurer	,quitter	
se marier	,divorcer	
minuscule	,immense	,énorme	,géant	,spacieux	
net	,sale	
prolixe	,bref	,concis	
rapprocher	,éloigner	
similarité	,différence	;contraste	;dissemblance	
bande de circulation	,bande d’arrêt d’urgence	
noyer	,assécher	
lâcheté	,courage	
ennemi	,ami	;ami	,allié	,défenseur	,partisan	,protecteur	,supporter	,bénédiction	
s’empêcher	,autoriser	
femme	,célibataire	
civil	,militaire	,religieux	
ressembler	,différer	,correspondre	,différer	
aigu	,grave	
mourir	,naître	
empêcher	,permettre	
ressemblance	,différence	,dissimilitude	,dissemblance	,dissimilarité	,dissemblance	
exigu	,spacieux	
tracassier	,arrangeant	
rudesse	,douceur	
un peu	,beaucoup	
ne pas voir la couleur	,obtenir	,trouver	
sobre	,alcoolique	
ignorance	,connaissance	
proche	,lointain	
titulaire	,remplaçant	,coiffeur	
levé	,couché	
tarir	,jaillir	
brûlant	,glacé	
distinct	,similaire	,analogue	
crime	,merveille	
retrouver ses jambes de vingt ans	,ne plus avoir de jambes	
couleur	,noir et blanc	
confirmer	,nier	
coiffeur	,titulaire	
recette	,dépense	
nouveau	;vieux	
capteur	,émetteur	
tarder	,se dépêcher	
naître	,mourir	
étranger	,autochtone	
grave	,aigu	
verticalement	,couché	,horizontalement	
opposition	,analogie	
réalité	,idéalité	
fleuve	;bref	;concis	;éclair	
optimisme	,pessimisme	
lentement	,vite	
différence	,ressemblance	,analogie	,similarité	,similitude	,analogie	;point commun	
religieux	,civil	
rarement	,souvent	,jamais	,toujours	
similaire	,différent	,dissemblable	,distinct	
élogieux	,critique	
arrangeant	,têtu	
déplier	,replier	
sale	,net	
frêle	,solide	
marcher à l’eau claire	,boire	
manger	,jeûner	,articuler	
ami	,ennemi	;époux	,mari	,adversaire	,opposant	,comme chien et chat	
allonger	,raccourcir	
hypocritement	,franchement	
couple	,célibat	
chaud	,froid	
droit	,courbe	
>>>	V_0
démolissage	,démolir	
espoir	,espérer	,espérer	
entretien	,s’entretenir	,entretenir	
création	,créer	
encouragement	,encourager	,encourager	
réussite	,réussir	
commerce	,commercer	
agression	,agresser	
ordre	,ordonner	
tentation	,tenter	
appauvrissement	,s’appauvrir	
entrée	,entrer	
cognement	,cogner	
ignorance	,ignorer	
amusement	,amuser	
dégagement	,dégager	
chasse	,chasser	
attente	,attendre	
différence	,différer	
raccourcissement	,raccourcir	
armement	,armer	
ski	,skier	
renvoi	,renvoyer	
massage	,masser	
lecture	,lire	
sacrifice	,sacrifier	
évanouissement	,s’évanouir	
embarquement	,embarquer	
désignation	,désigner	,désigner	
transport	,transporter	,transporter	
enroulement	,s’enrouler	
désertification	,se désertifier	
cuisson	,cuire	
écroulement	,s’écrouler	
nationalisation	,nationaliser	
toux	,tousser	
espionnage	,espionner	
apaisement	,apaiser	,s’apaiser	
simplification	,simplifier	
contrainte	,contraindre	
toilettage	,toiletter	
intégration	,s’intégrer	
emprunt	,emprunter	
fondations	,fonder	
éclaboussement	,éclabousser	
bavardage	,bavarder	
déroulement	,dérouler	,se dérouler	
envolée	,s’envoler	
collaboration	,collaborer	
naufrage	,naufrager	
sucrage	,sucrer	
applaudissements	,applaudir	
habitation	,habiter	
acquisition	,acquérir	,acquérir	
rafraîchissement	,rafraîchir	
accueil	,accueillir	
inondation	,inonder	
natatoire	,nager	
absorption	,absorber	,absorber	,absorber	
perçage	,percer	
boutonnage	,se boutonner	,boutonner	
somme	,dormir	
écriture	,écrire	
kidnapping	,kidnapper	
semailles	,semer	
exercice	,exercer	,s’exercer	
angoisse	,angoisser	,s’angoisser	
animation	,animer	
vomissement	,vomir	
fin	,finir	
>>>	S_3
médecine	,maladie	
conclure	,conclusion	
facture	,client	,cliente	
coiffage	,peigne	,brosse	
couleur	,poker	
boîte aux lettres	;courrier	
théâtre	,public	
pansement	,pansement	
inspecteur	,inspection	
plateau	,tir	;ball-trap	
débitrice	,dette	
apprendre	,élève	,élève	,étudiante	,étudiant	
collège	,collégien	,collégienne	
tirage	,tirage	
teindre	,teinture	,coloration	
fusil	,projectile	,balle	,plomb	
clinique	,soins	
bus	,arrêt	
roi	,sujette	
similitude	,similitude	,point commun	
papeterie	,papier	
accès	,accès	
tailler	,vêtement	
gommer	,gomme	
supérette	,client	,cliente	,clientèle	
plein	,véhicule	
accentuer	,accent	,accent	
course	,taxi	;fiacre	
maire	,administré	,administrée	
coiffer	,coiffure	
travailler	,employeur	,employeuse	,patron	,patronne	;employeur	
film	,acteur	,actrice	,comédien	,comédienne	
parier	,mise	
imposer	,impôt	
restaurant	,clientèle	;client	,cliente	
trahir	,trahison	
attaché	,attache	
qualifier	,qualificatif	
différence	,différence	
piocher	,pioche	
similarité	,similarité	,point commun	
habiller	,habits	,vêtements	
voter	,élection	
empoisonner	,poison	
hôpital	,patient	,patiente	
juge	,tribunal	
récompense	,récompense	
ministre	,gouvernement	,état	
marche	,auditeur	,auditrice	
diriger	,direction	
bijouterie	,client	,cliente	
conversation	,sujet	,thème	
administrable	,administrateur	
bombarder	,bombe	,bombardier	
remplaçant	,compétition	
décharger	,chargement	
procès	,affaire	
multiplier	,multiplicateur	
chèque	,bénéficiaire	;porteur	
vocabulaire	,langue	
dieu	,culte	
alimenter	,aliment	
hypermarché	,client	,cliente	,clientèle	
drame	,comédien	,comédienne	
défendre	,agression	;agresseur	,agresseuse	
numéroter	,numéro	
pâtisserie	,cliente	,client	
comprimé	,substance active	
opéra	,auditeur	,auditrice	,spectateur	,spectatrice	
compensation	,compensation	
>>>	A_1
parole	,parlant	
griffes	,griffu	
construction	,constructeur	
s’enfuir	,fuyard	
voyage	,en	
admiration	,transporté	<soulevé	,rempli	,admiratif	<plein	,en	
négliger	,négligent	
angle	,anguleux	
grimace	,grimaçant	
trébucher	,trébuchant	
gaucher	,gaucher	
voyou	,voyou	
fuir	,fugitif	
manquer	,manquant	
rhume	,enrhumé	
appauvrir	,appauvrissant	
Espagnole	,espagnol	
imparité	,impair	
appartement	,en	
siège éjectable	,sur	
rafraîchir	,rafraîchissant	
tête dure	,têtu	,à	
mécontentement	,mécontent	
banalité	,banal	
paralysie	,paralysé	;paralytique	
Chine	,chinois	
conversation	,en	<plongé	
éligibilité	,éligible	
récolter	,récoltant	
affection	,affectueux	
révolter	,révoltant	
flâner	,flâneur	
bonheur	,heureux	
meuble	,meuble	
triangle	,en	
égarement	,égaré	
entêtement	,têtu	<entêté	
solide	,solide	
salaire	,salarié	
violence	,violent	
pudeur	,pudique	
guillemets	,entre	
enthousiasme	,enthousiaste	
décevoir	,décevant	
apparaître	,apparent	;visible	
éliminer	,éliminatoire	
modifier	,modificateur	,modificatif	,modifiant	
importance	,important	
femme	,féminin	
dévaster	,dévastateur	
majorité	,majeur	
moyenne	,dans	,moyen	,dans	
préoccuper	,préoccupant	
puer	,puant	
déclarer	,déclarant	
couleur	,de	,coloré	,coloré	
s’orienter	,orienté	
déformer	,déformateur	,déformant	
avec	,accompagné	
transpirer	,transpirant	
songer	,songeur	
distinction	,distingué	
fortune	,fortuné	
envelopper	,enveloppant	
paralysé	,paralytique	
se divertir	,divertissant	
se désoler	,désolé	
résider	,résidant	
se disposer	,disposé	
barbe	,barbu	
>>>	S_2^prototyp
dresser	,table	,table	
allonger	,café	,gueule	,mine	,tête	,tronche	,visage	
placarder	,avis	,affiche	
table	,restaurant	,auberge	
symptôme	,maladie	
jambe	,porc	;bœuf	
dans	,habit	,vêtement	
amputer	,membre	
ceinture	,pantalon	,jupe	,robe	,manteau	,véhicule	,agglomération	
miellerie	,miel	
boulangère	,pain	;viennoiserie	
poteaux	,rugby	
plan	,film	
tarte	,citron	,fraise	,pomme	,prune	,fromage blanc	,crème	,sucre	,chocolat	
transmettre	,maladie	;microbe	
brosser	,ballon	,balle	
guidon	,arme à feu	
siège	,ville	
main	,jeu	
paroles	,chanson	
champ	,blé	
respirer	,air	
visiter	,musée	
traite	,vache	
casque	,ordinateur	,télévision	,baladeur	
bénéficiaire	,chèque	,enveloppe	
dire	,injure	
accident	,véhicule	
cercueil	,cadavre	,corps	,mort	,morte	
border	,lit	;drap	,couverture	
conducteur	,voiture	,véhicule	,automobile	,moto	,auto	,autobus	,autocar	,bus	,camion	,car	,métro	,train	,tramway	
hold-up	,banque	;bijouterie	;magasin	
tabac	,tabac	
machine à coudre	,tissu	
bétonné	,béton	
voie	,véhicule roulant	,véhicule	
définir	,politique	
s’éponger	,front	
se coucher	,lit	
éclairé	,lampe	
moudre	,café	,blé	
verrou	,porte	
envoi	,colis	,lettre	
encadrer	;porte	,fenêtre	;tableau	,photographie	,miroir	
petit chien	,accouchement	
peigner	,cheveux	
ébloui	,lumière	
aéroporté	,avion	,hélicoptère	
hisser	,voile	;drapeau	
porter	,vêtement	;pièce d’habillement	
fumeur	,cigare	,cigarette	,pipe	;tabac	
tube	,pâte	
passement	,bras	;jambes	
averse	,neige	;grêle	;pluie	;cendre	
arrêt	,bus	
facteur	,courrier	,lettre	;colis	,paquet	,clavecin	;flûte	;orgue	;piano	
depuis	,date	;moment	
pâte	,pain	,pizza	,gâteau	,tarte	,biscuit	,beignet	
détourner	,regard	
recouvert	,tissu	
culture	,plante	
écran	,film	
métro	,terminus	
fondant	,chocolat	
débrancher	,wagon	
amputation	,membre	
pâté	,lapin	,volaille	
vestiaire	,cliente	,client	
transférer	,prisonnier	,prisonnière	
chaussette	,café	;thé	,hydrocarbure	
>>>	Syn_⊃^sex
parlementaire	,parlementaire	
musicien	,musicienne	
optimiste	,optimiste	
skieur	,skieuse	
promeneur	,promeneuse	
célibataire	,célibataire	
compositeur	,compositrice	
veuf	,veuve	
Québécois	,Québécoise	
migraineux	,migraineuse	
étourdi	,étourdie	
xénophobe	,xénophobe	
émigrant	,émigrante	
client	,cliente	
dirigeant	,dirigeante	
mécano	,mécano	,mécano	
emprunteur	,emprunteuse	
avocat général	,avocate générale	
débrouillard	,débrouillarde	
artisan	,artisane	
concepteur	,conceptrice	
colérique	,colérique	
stomatologue	,stomatologue	
résigné	,résignée	
unijambiste	,unijambiste	
chiffreuse	,chiffreur	
gaspilleur	,gaspilleuse	
sprinter	,sprinteuse	
tennisman	,tenniswoman	,tennisman	
inconnu	,inconnue	
avocat du diable	,avocate du diable	
éplucheur	,éplucheuse	
héritier	,héritière	
résidant	,résidante	
salarié	,salariée	
analyste	,analyste	
festivalier	,festivalière	
heureux	,heureuse	
maître-chanteur	,maître-chanteuse	
abbé	,abbesse	
briseur	,briseuse	
professionnel	,professionnelle	
époux	,épouse	
gorille	,gorille	
clodo	,clodo	
clochard	,clocharde	
adopté	,adoptée	
cambrioleur	,cambrioleuse	
chiqueur	,chiqueuse	
acheteur	,acheteuse	
rugbyman	,rugbyman	,rugbywoman	
dresseur	,dresseuse	
assistant	,assistante	
destinataire	,destinataire	
condamné	,condamnée	
marchand	,marchande	
ostréiculteur	,ostréicultrice	
volontaire	,volontaire	
paysan	,paysanne	
filleul	,filleule	
égoïste	,égoïste	
témoin	,témoin	
médecin-major	,médecin-major	
laveur	,laveuse	
pas grand-chose	,pas grand-chose	
vacancier	,vacancière	
météorologiste	,météorologiste	
dramaturge	,dramaturge	
votant	,votante	
papetier	,papetière	
>>>	Adv_0
comparer	,comparativement	
comparaison	,comparativement	
informatique	,informatiquement	
malhonnête	,malhonnêtement	
commencer	,depuis	
torrentiel	,torrentiellement	
étrange	,étrangement	
conceptuel	,conceptuellement	
généreux	,généreusement	
réel	,réellement	
intelligent	,intelligemment	
histoire	,historiquement	
mental	,mentalement	
intérieur	,intérieurement	
merveilleux	,merveilleusement	
frère	,fraternellement	
médiocre	,médiocrement	
geste	,gestuellement	
lenteur	,lentement	
hygiène	,hygiéniquement	
précis	,précisément	
bref	,brièvement	
urgent	,urgemment	
modéré	,modérément	
pertinent	,pertinemment	
humain	,humainement	
électricité	,électriquement	
supérieur	,supérieurement	
facultatif	,facultativement	
automatique	,automatiquement	
incomplet	,incomplètement	
art	,artistiquement	
politique	,politiquement	,politiquement	,politiquement	
international	,internationalement	
inverse	,inversement	
souple	,souplement	
tourisme	,touristiquement	
grave	,gravement	
bas	,bassement	
contredire	,contradictoirement	
pratique	,pratiquement	
commercial	,commercialement	
extrême	,extrêmement	
confidentiel	,confidentiellement	
nécessaire	,nécessairement	
direct	,directement	
particulier	,particulièrement	
délicat	,délicatement	
sévère	,sévèrement	
lâche	,lâchement	
nuage	,en	,sous forme	
partie	,partiellement	
mère	,maternellement	,maternellement	
impatient	,impatiemment	
obligatoire	,obligatoirement	
nombre	,numériquement	,numériquement	
intense	,intensément	
muscle	,musculairement	
formel	,formellement	
dynamique	,dynamiquement	
profitable	,profitablement	
partiel	,partiellement	
intime	,intimement	
assurer	,assurément	
faible	,faiblement	
propre	,proprement	,proprement	,proprement	,proprement	,proprement	,proprement	
énergie	,énergiquement	
adorable	,adorablement	
ingrat	,ingratement	
apparent	,en apparence	,apparemment	
>>>	Syn_⊂
TER	,train	
survoler	,voler	,voler	
slip	,sous-vêtement	
voter	,élire	,adopter	
passage	,espace	
déchiré	,drogué	
finir	,consommer	
émonctoire	,organe	
meurtre	,crime	
se dessiner	,se former	
ennemi public numéro un	,ennemi public	
cracra	,sale	
fiacre	,voiture	
violon	,violoniste	,violoniste	
bosse	,enflure	
largeur	,dimension	
palper	,tâter	
lave-phare	,appareil	
colombin	,caca	,merde	,crotte	,étron	,bol fécal	,excréments	,matière fécale	,selle	
allumer	,provoquer	
naître	,commencer	
chaud	,température	
sac	,sac	
se vautrer	,se coucher	
shampooing	,lavage	
proximité	,distance	
chaussons	,chaussures	
boulotter	,manger	
bonnet d’évêque	,croupion	
se creuser	,se former	
douche	,pluie	
river	,fixer	
havane	,cigare	
socquettes	,chaussettes	
raccommodable	,réparable	
nettoyer	,vider	
se décaler	,se déplacer	
soutane	,robe	
propre	,caractéristique	
se taper	,boire	;manger	
impitoyable	,sévère	
démocratie	,état	
recoudre	,coudre	
fort	,très	
rabattre	,déplacer	
fureur	,colère	
coffre	,poitrine	
véhicule flottant	,véhicule	
se dire	,dire	
pilier	,jambes	
griser	,enivrer	
shampouiner	,nettoyer	
du même tabac	,pareil	
paupière	,languette	
chéneau	,gouttière	
père peinard	,vieux	
soixante-dizaine	,soixante-dix	
fanfare	,bruit	
batterie	,tas	
ventre à terre	,vite	
doucher	,laver	
coupé	,voiture	,voiture	
drakkar	,vaisseau	
s’inviter	,venir	
course	,course	,déplacement	
constituer	,être	
cage thoracique	,poitrine	
glisser	,se déplacer	
monarchie	,état	
moelleux	,confortable	
>>>	Syn
sommaire	,succinct	
promis	,fiancé	
rot	,éructation	
se nommer	,s’appeler	
coléreux	,colérique	
riflard	,pébroque	,pépin	,parapluie	
gambettes	,jambes	,guibolles	,cannes	,pattes	
fromage	,frometon	
instrument	,instrument de musique	
tata	,tantine	,tatie	,tante	,folle	,tante	,tantouze	,tapette	
veille	,éveil	
frère	,frangin	,frérot	
lune	,cul	,derrière	,panier	,arrière-train	,postérieur	,séant	,miches	,pétard	,croupe	,croupion	,fessier	,popotin	,derche	
grand-père	,aïeul	,grand-papa	,papi	,pépé	,pépère	,bon-papa	,papi	,pépé	,pépère	
tatie	,tantine	,tata	,tante	
petit endroit	,petit coin	
travailler	,bosser	
bagnole	,caisse	,auto	,automobile	,voiture	
casquette	,ivre	
odorat	,olfaction	,nez	
dent	,ratiche	,quenotte	
philosophie	,philo	
hâtif	,rapide	
microphone	,micro	
gastrique	,stomacal	
se rappeler	,se souvenir	
pasteure	,femme pasteur	
à fond de train	,à fond	
se marier	,marier	,épouser	
fiancé	,promis	
chuchotis	,chuchotement	
linge	,petit linge	
explosif	,explosible	
loco	,locomotive	
occident	,ouest	,ponant	
bord	,rive	
éructation	,rot	
capote	,préservatif	,condom	
multiplier	,se multiplier	
quéquette	,moineau	,zigounette	,zizi	,braquemart	,manche	,membre	,teub	,bite	,pine	,queue	,zob	,biroute	,chibre	,pénis	,verge	
lave-linge	,machine	
Ouais	,oui	
soldat	,soldate	,femme soldat	
chaise de bébé	,chaise haute	
Web	,Internet	,Net	
gaspillage	,gaspi	
plantage	,plantation	
costume	,costard	
lattes	,planches	,skis	
tocante	,montre	
trépasser	,mourir	,décéder	,disparaître	,périr	,perdre la vie	,casser sa pipe	,clamser	,crever	
éveil	,veille	
embellir	,s’embellir	
bête	,bestiole	
septentrion	,nord	
à l’intérieur	,dedans	
pinard	,picrate	,vin	
micro	,microphone	
éducs	,éducatrice	
chef	,boule	,caboche	,carafe	,cigare	,crâne	,poire	,pomme	,tête	
nationale	,route nationale	
vendre père et mère	,tuer père et mère	
se mélanger les pédales	,s’emmêler les pédales	
expirer	,mourir	
gargamelle	,gorge	,kiki	,gaviot	
ru	,ruisselet	
pincement	,pinçage	
mouvement	,geste	
s’angoisser	,angoisser	
lapin	,lapinou	
>>>	S_1Pred
faible	,faible	
sourd	,sourd	,sourde	,bruit	
lâche	,lâche	,lâche	
protestant	,protestant	,protestante	
laid	,laid	,laide	
myope	,myope	,myope	
riverain	,riverain	,riveraine	
pauvre	,pauvre	,pauvre	
affirmatif	,affirmative	
russe	,Russe	,Russe	
jeune	,jeune	,jeune	
accidenté	,accidenté	,accidentée	
agressé	,agressé	,agressée	
infirme	,infirme	,infirme	
miraculé	,miraculé	,miraculée	
imbécile	,imbécile	,imbécile	
suisse	,Suisse	,Suisse	,Suissesse	
européen	,Européen	,Européenne	
mâle	,mâle	
asiatique	,Asiatique	,Asiatique	
orphelin	,orphelin	,orphelin	,orphelin	
millionnaire	,millionnaire	,millionnaire	
nul	,nul	,nulle	
adulte	,adulte	,adulte	
hospitalisé	,hospitalisé	,hospitalisée	
chauve	,chauve	
vivant	,vivant	;vivante	
immortel	,immortel	,immortelle	
acquéreur	,acquéreur	
catholique	,catholique	,catholique	
inconnu	,inconnu	,inconnue	
futé	,futé	,futée	
handicapé	,handicapé	,handicapée	
immigré	,immigré	,immigrée	
timide	,timide	,timide	
têtu	,têtu	,têtue	<entêté	,entêtée	;cabochard	,cabocharde	,tête de mule	,tête de cochon	
héroïque	,héros	,héroïne	
carié	,dent	
fort	,fort	
xénophobe	,xénophobe	,xénophobe	
voyou	,voyou	
innocent	,innocent	,innocente	
chrétien	,chrétienne	,chrétien	
rival	,rival	;rivale	
mort	,mort	,morte	
célibataire	,célibataire	,célibataire	
femelle	,femelle	
grec	,Grec	,Grecque	
cul-de-jatte	,cul-de-jatte	,cul-de-jatte	
québécois	,Québécois	,Québécoise	
tentateur	,tentateur	,tentatrice	
titulaire	,titulaire	
frisé	,frisée	
milliardaire	,milliardaire	,milliardaire	
coupable	,coupable	,coupable	
favori	,favori	,favorite	
idiot	,idiot	,idiote	
espagnol	,Espagnol	,Espagnole	
fidèle	,fidèle	
puni	,punie	
mineur	,mineur	,mineure	
bon	,bon	
criminel	,crime	,crime	,crime	
mauvais	,mauvais	
gourmand	,gourmand	,gourmande	
bavard	,bavarde	,bavard	
portugais	,Portugais	,Portugaise	
moche	,moche	,moche	;mocheté	
juif	,juif	,juive	
chinois	,Chinoise	,Chinois	
>>>	S_2
facteur	,courrier	
gelée royale	,reine	
théâtre	,tragédie	
table	,client	,cliente	
désir	,désir	
diriger	,débat	,véhicule	
Enfer	,damné	,damnée	
week-end	,semaine	
volant	,véhicule	
bétail	,éleveur	,éleveuse	
coûter	;prix	,coût	
en garder sous la pédale	,course	
contribuable	,impôt	,impôt	
sondage	,sondé	
dire	,propos	
xénophobie	,victime	
vendredi	,semaine	
adoptable	,maître	,maîtresse	
balai	,percussions	
défaite	,gagnant	,gagnante	;vainqueur	
mère	;enfant	,congrégation	;couvent	
exploré	,explorateur	,exploratrice	
contenir	,contenu	
aidé	,aide	,aide	
assis	,assiette	
débat	,sujet	,objet	,objet	,thème	,sujet	
s’occuper	,occupation	
suggérer	,suggestion	
administrable	,administrateur	
semer	,semence	;graine	
bague	,animal	
se prénommer	,prénom	
mot	,langue	
père	;enfant	,congrégation	;couvent	
tramway	,arrêt	,station	
thermomètre	,température	
orgueil	;objet	
emploi	,employé	,employée	;salarié	,salariée	
arbitrer	,match	
université	,universitaire	,universitaire	
empoisonné	,poison	
représenter	,représentation	
dette	,dette	;argent	
ressentir	,émotion	,sentiment	;sensation	
chèque	,montant	
regretter	,regret	
desservir	,arrêt	,station	
laver	,lessive	,linge	
mouche	,poisson	
enterrer	,mort	,morte	;cadavre	
abdiquer	,obligation	,responsabilité	
mobiler	,mobiler	
placard	,peau	
cheval	,cheval	
soutien-gorge	,poitrine	,seins	
mercredi	,semaine	
couleur	,couleur	
cauchemar	,cauchemar	
retaper	,drap	;lit	
déchetterie	,déchets	
imposer	,contribuable	,contribuable	
dégager	,enveloppe	
faculté	,université	
chiffre	,nombre	,chiffre	
durer	,durée	
véhicule	,passager	,passagère	;cargaison	,chargement	;fret	
erreur	,erreur	
rêve	,rêve	
soutif	,poitrine	,seins	
soulevé	,sentiment	
>>>	S_1^usual
couleur	,coiffeur	,coiffeuse	;coloriste	,coloriste	,coiffeur	,coiffeuse	;coloriste	,coloriste	
goudron	,goudronneur	
frileux	,frileux	,frileuse	
grammaire	,grammairien	
portrait	,portraitiste	,portraitiste	
sondage	,sondeur	
lessive	,laveuse	,lavandière	
mine	,mineur	
ville	,citadin	,citadine	
art	,artiste	,artiste	
station-service	,pompiste	
camping	,campeur	,campeuse	
coupage de cheveux en quatre	,coupeur de cheveux en quatre	,coupeuse de cheveux en quatre	
sagesse	,sage	
diagnostic	,diagnosticien	,diagnosticienne	,diagnostiqueur	,diagnostiqueuse	
tarte	,pâtissier	,pâtissière	
marathon	,marathonien	
bus	,chauffeur	,conducteur	,conductrice	
rugby	;joueur	,joueuse	,rugbyman	,rugbyman	,rugbywoman	
brosser	,peintre	,peintre	
étoilé	,ciel	
dessiner	,dessinatrice	,dessinateur	
blague	,blagueur	,blagueuse	
manier	,manieur	,manieuse	
manger	,mangeur	,mangeuse	
s’engager	,engagé	,engagée	
photographier	,photographe	
champ	,paysan	,agriculteur	,agricultrice	,paysanne	
découper	,découpeur	,découpeuse	
cultiver	,cultivateur	,cultivatrice	
éplucher	,éplucheur	,éplucheuse	
contrôler	,contrôleur	,contrôleuse	
ambulance	,ambulancière	,ambulancier	
cuisine	,cuisinier	,cuisinière	,cuisinier	,cuisinière	
résorber	,médecin	,médecin	;chirurgien	,chirurgienne	
angoisse	,angoissé	,angoissée	
enseignable	,enseignant	,enseignante	
caprice	,capricieux	,capricieuse	
poulet	,éleveur	,éleveuse	
raconter	,raconteur	,raconteuse	,conteur	,conteuse	
camion	,routier	;chauffeur	,conducteur	,conductrice	
enculer les mouches	,enculeur de mouches	
mensonge	,menteur	,menteuse	
ronflements	,ronfleur	,ronfleuse	
envoyé	,expéditeur	,expéditrice	
réparer	,réparateur	,réparatrice	
pizza	,pizzaiolo	,pizzaiola	
museau	,arme à feu	
surveiller	,surveillant	,surveillante	
nettoyer	,nettoyeuse	,nettoyeur	,chirurgien	,chirurgienne	,nettoyeur	,nettoyeuse	
production	,producteur	,productrice	
apiculture	,apiculteur	,apicultrice	
habiller	,habilleur	,habilleuse	
publicité	,publicitaire	,publicitaire	
se résigner	,résigné	,résignée	
carotte	,cultivateur	,cultivatrice	
fournir	,fournisseur	,fournisseuse	
pois	,cultivateur	,cultivatrice	
photo	,photographe	
chirurgie	,chirurgien	,chirurgienne	
balayer	,balayeuse	,balayeur	
enthousiasme	,enthousiaste	,enthousiaste	
ping-pong	,pongiste	,pongiste	
navigation	,navigateur	
tennis	;joueur	,joueuse	,tennisman	,tennisman	,tenniswoman	
électronique	,électronicien	,électronicienne	
jardin	,jardinier	,jardinière	
volley-ball	;joueur	,joueuse	,volleyeur	,volleyeuse	
traiter	,médecin	,médecin	;vétérinaire	,vétérinaire	;dentiste	,dentiste	
taxi	,chauffeur	
>>>	A_2
serrer	,serré	
poison	,empoisonné	
disputer	,disputé	
électronique	,électronique	
déchirer	,déchiré	
couleurs	,à	
accusation	,visé	,en butte	
bague	,bagué	
considération	,considéré	
supplément	,supplémentaire	
miracle	,miraculé	
intention	,intentionnel	
vents	,à	
attrait	,attrayant	
conserver	,conservé	
employer	,employé	
étouffer	,étouffé	
livrer	,livrable	
habitation	,habité	
décalage	,décalé	
lac	,noyé	
pension	,pensionné	
exploiter	,exploité	
agresser	,agressé	
plaisir	,plaisant	
chiffre	,chiffré	
exposer	,exposé	,exposé	
éducation	,éducateur	
concerner	,concerné	
désirer	,désirable	
devoir	,dû	
schéma	,schématique	
consentir	,consenti	
victoire	,vaincu	
savoir	,su	,su	
aéroporter	,aéroporté	
profit	,profitable	
essouflé	,essouflant	
essouflant	,essouflé	
occupation	,occupé	
connaître	,connu	
recouvrir	,recouvert	,recouvert	
air	,sur	
réfléchir	,réfléchi	
antenne	,à	,sur	,en ondes	
former	,formé	
électricité	,électrique	
barrer	,barré	
entretenir	,entretenu	
agacer	,agacé	
génération	,générateur	
Enfer	,damné	
suspecter	,suspect	
faute	,fautif	
inspirer	,inspiré	,inspiré	
gonfler	,gonflé	
se distraire	,distrayant	
éprouvé	,éprouvant	
raisonner	,raisonné	
parfumer	,parfumé	
sport	,sportif	
béton	,bétonné	
s’appauvrir	,appauvrissant	
tissu	,musculaire	
rassurer	,rassuré	
considérer	,considéré	
cercueil	,mort	
exporter	,exporté	
épreuve	,éprouvé	
éclairer	,éclairé	
>>>	S_0Pred
insuffisant	,insuffisance	
courageux	,courage	
clandestin	,clandestinité	
convaincu	,conviction	
innocent	,innocence	
sale	,saleté	,saleté	
nu	,nudité	
mécontent	,mécontentement	
intime	,intimité	
têtu	,entêtement	
citoyen	,citoyenneté	
étanche	,étanchéité	
uniforme	,uniformité	
complet	,complétude	
acide	,acidité	
accessible	,accessibilité	
vengeur	,vengeance	
léger	,légèreté	
tranquille	,tranquilité	
distingué	,distinction	
enceinte	,grossesse	
tendre	,tendreté	
mère	,maternité	
racé	,race	
original	,originalité	
silencieux	,silence	
fantastique	,fantastique	
raciste	,racisme	
faux	,fausseté	
féroce	,férocité	
imbécile	,imbécillité	
immédiat	,immédiateté	
réel	,réalité	
constant	,constance	
frais	,fraîcheur	,fraîcheur	
toxique	,toxicité	
gentil	,gentillesse	
ivre	,ivresse	;coup dans le nez	
inaccessible	,inaccessibilité	
jaloux	,jalousie	
adroit	,adresse	
alcoolique	,alcoolisme	
intuitif	,intuition	
parfait	,perfection	
oblique	,obliquité	
charmant	,charme	
violent	,violence	
vrai	,vérité	
égoïste	,égoïsme	
ironique	,ironie	
pessimiste	,pessimisme	
vertical	,verticalité	
délicat	,délicatesse	
hospitalier	,hospitalité	
débutant	,début	
incompréhensible	,incompréhensibilité	
hésitant	,hésitation	
salarié	,salariat	
frileux	,frilosité	
idiot	,idiotie	
créatif	,créativité	
généreux	,générosité	
fade	,fadeur	
amusé	,amusement	
discipliné	,discipline	
vif	,vivacité	,vivacité	,vivacité	
solide	,solidité	,solidité	
drôle	,drôlerie	
timide	,timidité	
facile	,facilité	
>>>	S_1^prototyp
pompes	,cérémonie	
feuilleter	,livre	
lacet	,chaussures	,souliers	
couvent	,moine	,religieux	,religieuse	
pare-brise	,véhicule	
fesses	,pantalon	
miette	,pain	
dentifrice	,tube	;pâte	,gel	;poudre	,eau	,élixir	
trombe	,eau	
récoltable	;légume	
joues	,marteau	
skis	,motoneige	;véloski	
soute	,bateau	
galop	,cheval	
mégot	,cigarette	,cigare	,cigarillo	
vitré	,paroi	
vestiaire	,restaurant	,discothèque	,gymnase	,piscine	
aval	,fleuve	,rivière	
flocon	,laine	
assis	;impôt	
dent	,feuille	;timbre	
tour	,château	
plateau	,légume	
gueule	,arme à feu	;fusil	
traduisible	,livre	;texte	
remboursable	,dette	
embouteiller	,vin	
clé	,robinet	,sol	;fa	
boucher	,chirurgien	,chirurgienne	;dentiste	,dentiste	
barrir	,éléphant	
croasser	,corbeau	,corbeau	
petit chien	,maman	
essaimer	,abeille	
course	,coureur	,coureuse	;coureur	,coureuse	,pilote	
aube	,religieux	
flaque	,eau	
glace	,cuisinier	
fuir	,nuage	
bouse	,vache	
griffu	,patte	
juger	,juge	;tribunal	
traîne	,robe	
amont	,fleuve	,rivière	
abdiquer	,empereur	,souverain	,roi	,monarque	
lit	,fleuve	,rivière	,ruisseau	,torrent	
ameublement	,pièce	;appartement	,maison	
menu	,entrée	,plat	,dessert	
courant	,fleuve	,rivière	,ruisseau	
poil	,tapis	,brosse	,pinceau	,pinceau	
abat-jour	,lampe	,ampoule	,lampadaire	
article	,journaliste	,journaliste	
discothèque	,client	,cliente	
corps	,professeur	,professeure	;enseignant	,enseignante	;fonctionnaire	,fonctionnaire	;médecin	,médecin	,état	,doctrine	;théorie	,vin	;liqueur	
versant	,colline	;montagne	;vallée	
rouge	,cheveu	;pelage	
double	,fenêtre	
abbaye	,religieuse	,religieux	
fruit	,arbre	,plante	
souffler	,vent	
sonneur	,cloche	
murmurer	,rivière	;lac	
serviette	,femme	
élément de langage	,communicant	
majorité	,électeur	,électrice	
dîner	,dîneur	,dîneuse	
traverser	,pluie	
crottin	,cheval	
réseau	,ami	
être	,être	
pelouse	,parc	
>>>	Contr
R.E.R	,métro	
visage	,corps	
vouvoyer	,tutoyer	
mon	,ton	
brune	,blonde	
acidité	,douceur	
faune	,flore	
d’abord	,enfin	,ensuite	,puis	
monarchie	,démocratie	,république	,démocratie	
fellation	,cunnilingus	
eau	,glace	
sortie	,entrée	
maître	,esclave	
nuage	,soleil	
toi	,moi	
bruit	,silence	
chercher	,trouver	
raison	;cœur	
poisson	,viande	
ange	,démon	
atterrir	,décoller	
se coucher	,se lever	
couteau	,cuillère	;fourchette	
ensuite	,d’abord	
cuillère	,couteau	,fourchette	
femelle	,mâle	
tête	,pieds	;corps	;jambes	,queue	,queue	
première	,dernière	
question	,réponse	
avant-hier	,après-demain	
poésie	,prose	
premier	,dernier	,dernier	
loup	,chien	
plein	,vide	
au revoir	,bonjour	
république	,monarchie	
plaine	,colline	;vallée	
largeur	,longueur	
demander	,répondre	
graisse	;muscle	;muscles	
vaches maigres	,vaches grasses	
pain	,brioche	
nord	,sud	
continent	;mer	;île	
nerf	,muscle	
bretelles	,ceinture	
vents	,cordes	;percussions	
personnel	,direction	,patronat	
paradis	,Enfer	;purgatoire	
vertical	,horizontal	
nombre	,genre	
réponse	,question	
tu	,je	
meuble	,pièce	
bras	,jambes	
Homme	,animal	
motrice	,voiture	
sud	,nord	
double	,simple	
matin	,soir	
s’allonger	,se lever	
analogue	,homologue	
mental	,écrit	
vouvoiement	,tutoiement	
moyen	,exceptionnel	,extraordinaire	;nul	
bonjour	,au revoir	
éclair	,tonnerre	
tonnerre	,éclair	
pantalon	,jupe	
cave	,grenier	
>>>	Gener
souci	,sentiment	
jambes	,membre	,membre	
abcès	,affection	
poisson rouge	,poisson	
paquet	,contenant	
septembre	,mois	
avril	,mois	
encouragement	,cri	;geste	,signe	
bar	,poisson	
pelle	,outil	
canapés	,hors-d’œuvre	
marguerite	;plante	
frustration	,sentiment	
moineau	,oiseau	
médaille	,bijou	
véloski	,véhicule	
uniforme	,vêtement	;habit	,tenue	
camionnette	,véhicule	
chiot	,animal	
vert	,couleur	
tournevis	,outil	
habitacle	,habitation	
somme	,opération	
main	,faute	
Inde	,pays	
football	,sport	
marcheur	,athlète	
taureau	,signe	
caramel	,couleur	
bourre-pipe	,instrument	
violon alto	,violon	
frégate	,bateau	
marathon	,compétition	;épreuve	
théâtre	,lieu	
tisane	,boisson	
instrument à percussion	,instrument de musique	
serviette	,linge	
rhume	,maladie	
béton	,matériau	
oiseau coureur	,animal	
messe	,cérémonie	
chat de gouttière	,chat	
clinique	,établissement de soins	,établissement de santé	
ferry	,bateau	
chemisier	,vêtement	
rubis	,pierre précieuse	
manteau	,vêtement	,vêtement	
merle	,oiseau	
dessus	,quelque part	
alto	,violon	
flèche	,projectile	
capitaine	,officier	
palabres	,échange verbal	
mi	,note	
bottes	,chaussures	
aller	,se déplacer	
poireau	,légume	
observer	,regarder	
assassinat	,crime	
mail	,message	
maire	,élu	
averse	,précipitation	
octobre	,mois	
lard	,charcuterie	
cognement	,bruit	
rouge-queue	,oiseau	
écrase-merde	,chaussures	
avocate	,métier	,profession	;femme de loi	
émoi	,sentiment	
français	,langue	
>>>	S_loc
camper	,camping	
cercueil	,tombe	,tombeau	
abeille	,nid	,ruche	
judo	,tapis	,tatami	;dojo	,salle	
rugby	,terrain	;stade	
gazon	,pelouse	
exemple	,exemplier	
football	,terrain	;stade	
noix	,noyer	
noisette	,noisetier	
coiffeuse	,salon	
citron	,citronnier	
boxeur	,ring	
cerise	,cerisier	
emprisonner	,prison	
Allemagne	,en	
Belgique	,en	
amande	,amandier	
entrer	,entrée	,entrée	
lointain	,lointain	
enterrer	,cimetière	
tasse	,tasse	
sentiment	,cœur	
gendarme	,gendarmerie	
vache	,étable	,vacherie	
laver	,lavoir	,laverie	,buanderie	,buanderie	,lavomatique	,douche	,lavabos	,salle de bain	,salle d’eau	,salle de douche	
sortir	,sortie	
environnement	,Terre	
orange	,oranger	
se laver	,salle de bain	,salle de douche	,salle d’eau	
banane	,bananier	
éléphant de mer	,mer	
lessive	,blanchisserie	;laverie	;lavoir	;buanderie	
doucher	,douche	;salle de bain	,salle de douche	
melon	,melon	
se doucher	,douche	,salle de douche	;salle de bain	
coiffeur	,salon	
voter	,bureau de vote	
corail	,mer	
poire	,poirier	
oiseau	,nid	
coton	,cotonnier	
clémentine	,clémentinier	
ananas	,ananas	
emprisonné	,prison	
gymnastique	,salle	;gymnase	,salle	;gymnase	
sandwich	,sandwicherie	
olive	,olivier	
pompier	,caserne	,caserne	
langue	,bouche	
guêpe	,nid	,guêpier	
citadin	,ville	
basket	,terrain	
citadine	,ville	
lait	,seins	
pomme	,pommier	
ski	,piste	;station	
Occidental	,ouest	
assiette	,assiette	
prune	,prunier	
à l’eau	,eau	
sport	,salle	;terrain	;palais des sports	
déchets	,déchetterie	
douche	;douche	,salle de douche	,salle de bain	
tennis	,court	,terrain	,tennis	
thé	,théier	
curé	,cure	;paroisse	
papetier	,papeterie	,papeterie	
karaté	,tapis	,tatami	;dojo	,salle	
plein	,station-service	
>>>	Cf
arbre	,buisson	
métro	,chemin de fer	,tramway	
chacun	,chaque	
chevilles	,pieds	;mollets	
géranium	,pélargonium	
casserole	,poêle	
mayonnaise	,ketchup	;moutarde	
horloge	,montre	
yaourt	,fromage blanc	
imam	,prêtre	
payer	,subir	
viennoiserie	,pâtisserie	
cœur	,carreau	
urine	,excréments	
biscotte	,tartine	
costume	,tailleur	
buée	,vapeur	
portefeuille	,porte-monnaie	
direction	,destination	
échelle	,escabeau	
café	,thé	,thé	
pélargonium	,géranium	
vapeur	,buée	
cloche	,timbre	
mission	,devoir	
tisane	,thé	
rideau	,store	
avocat	,juriste	
rat	,souris	
limace	,escargot	
avertissement	,sanction	
analogie	,métaphore	
chaîne	,collier	
si	,do	,ré	,mi	,fa	,sol	,la	
planche à pain	,poitrine	
précaution	,prévention	
tasse	,verre	,verre	
seconde	,minute	
marche	,course à pied	
être	,avoir	
bourdon	,abeille	
rire	,sourire	,sourire	
TER	,T.G.V.	
givre	,neige	
seins	,fesses	
marcher	,nager	,ramper	,voler	
moi	,soi	
soi	,moi	
dizaine	,dix	
doigts	,aube	
s’allonger	,s’asseoir	
plateau	,plaine	,montagne	,vallée	
fleuve	,voie navigable	
escargot	,limace	
source	,eau	
diamant	,disque	
fa	,do	,ré	,mi	,sol	,la	,si	
volant	,guidon	,aérien	
disque	,rond	;plat	
guêpe	,abeille	;frelon	
tonnerre	,foudre	;orage	
manger	,boire	
allumette	,briquet	
houle	,vague	
store	,rideau	
crapaud	,grenouille	
flûte	,baguette	
fauteuil	,chaise	
le	,un	
tramway	,métro	;chemin de fer	
>>>	Mult
symptôme	,syndrome	
vents	,ensemble	
pièce de vaisselle	,vaisselle	
client	,clientèle	
rabbin	,rabbinat	
mât	,mâture	
paysan	,paysannat	,paysannerie	
moustique	,essaim	;horde	,nuage	,nuée	
siège	,rangée	
touche	,clavier	
chaussettes	,paire	
ennemi	,ennemi	
journaliste	,équipe	,groupe	;horde	,meute	;équipe	,groupe	;horde	,meute	
parent	,famille	
jumeau	,jumeaux	
verre	,bouteille	
mouche	,nuage	,nuée	
bandit	,bande	,gang	,horde	
jambes	,paire	
corbeau	,bande	,colonie	;nuée	,bande	,colonie	;nuée	
rayon	,rayonnage	
comprimé	,boîte	
poisson	,banc	
éléphant	,troupeau	
bateau	,flottille	,flotte	
fleur	,grappe	
abeille	,colonie	,essaim	;horde	,nuage	,nuée	
jour	,semaine	<mois	,mois	
fruit	,grappe	
tabouret	,rangée	
famille	,mafia	
courrier	,courrier	
musicien	,ensemble	,groupe	
enfant	,enfance	
criminel	,bande	,gang	,mafia	,milieu	,pègre	
muscle	,musculature	
ministre	,gouvernement	,ministère	,cabinet	
patron	,patronat	
skis	,paire	
punaise	,colonie	
cliente	,clientèle	
navire	,flotte	,flottille	
oiseau	,volée	
sous-vêtement	,sous-vêtement	
outil	,outillage	
marche	,escalier	,marches	
membre	,membrure	,groupe	
pin	,pinède	,pineraie	,pinière	
pompier	,caserne	,caserne	
sardine	,banc	
assiette	,pile	
banane	,régime	
saucisse	,chapelet	
ami	,réseau	
poussin	,couvée	
carte	,jeu	
poil	,pelage	
poireau	,botte	
fibre	,tissu	
chèvre	,troupeau	
cerise	,poignée	
homme	,humanité	
gendarme	,gendarmerie	
musicienne	,ensemble	,groupe	
seins	,poitrine	;paire	
chaussures	,paire	
cigare	,boîte	
oignon	,botte	
employée	,personnel	
lion	,bande	
>>>	Sing
ail	<gousse	<tête	<botte	
marches	,marche	
laser	,rayon	
miel	,pot	
tarte	,part	
sauciflard	,rondelle	
tissu	,cellule	;fibre	
boxe	<combat	,match	<compétition	,tournoi	<championnat	
poivre	,grain	
bière	,bouteille	,verre	,bière	,canette	,chope	,demi	<pinte	
vent	,brin	
mâture	,mât	
crime	,crime	;crime	
racaille	,racaille	
outillage	,outil	
tennis	,match	,partie	,tennis	<compétition	,open	,tournoi	
champagne	,verre	
ski	,championnat	,compétition	
basket	,match	,partie	,basket	<compétition	,tournoi	<championnat	
moutarde	,pot	,verre	
crinière	,cheveu	
sable	,grain	
guerre	,bataille	
sucre	;grain	<cuillerée	,pincée	;morceau	,sucre	<pain	
tramway	,ligne	
pharmacopée	,médicament	
voirie	,voie	
saucisson	,rondelle	
judo	,combat	<compétition	,tournoi	<championnat	
farine	;sac	
mayo	,pot	
rayonnage	,rayon	
humanité	,homme	
marche	,marche	
membrure	,membre	
ping-pong	,match	,partie	,ping-pong	<compétition	,tournoi	
papier	,feuille	
mois	,semaine	<jour	
escalier	,marche	
feuillage	,feuille	
denture	,dent	
mobiler	,meuble	
cheveux	,cheveu	
groupe	,membre	
averse	,goutte	
sel	,grain	
tabac	,pied	,pot	
raisin	,grain	
aviation	,avion	
alcool	,verre	<bouteille	
bouteille	,verre	
gâteau	,part	,tranche	
courrier	,courrier	
toison	,cheveu	
jambon	,tranche	
musculature	,muscle	
rugby	,match	,partie	,rugby	<compétition	,tournoi	<championnat	
saucisse sèche	,rondelle	
saleté	,saleté	
beurre	,noisette	,noix	;motte	
jogging	,jogging	
corolle	,pétales	
sueur	,goutte	
terre	,motte	
glace	;glaçon	;bloc	
bol	,coup	
métro	,ligne	
ennemi	,ennemi	
conflit	,bataille	
maladie	,crise	
>>>	Syn_⊂^sex
gauchère	,gaucher	
organisatrice	,organisateur	
étourdie	,étourdi	
demandeuse	,demandeur	
machiniste	,machiniste	,machiniste	
concierge	,concierge	
cliente	,client	
panseuse	,panseur	
éducatrice	,éducateur	,éduc	
concitoyenne	,concitoyen	
pouilleuse	,pouilleux	
négociatrice	,négociateur	
exposante	,exposant	
compatriote	,compatriote	
écologue	,écologue	
concertiste	,concertiste	
ministre	,ministre	
raciste	,raciste	
créancière	,créancier	
empoisonneuse	,empoisonneur	
journaleuse	,journaleux	
sans-papiers	,sans-papiers	
générale	,général	
autochtone	,autochtone	
pleureuse	,pleureur	
commentatrice	,commentateur	
partenaire	,partenaire	
analyste	,analyste	
brebis	,mouton	
malfaitrice	,malfaiteur	
vivante	,vivant	
récolteuse	,récolteur	
gamine	,gamin	
aveugle	,aveugle	
avocate	,avocat	,avocat	
margrave	,margrave	
passagère	,passager	
surveillante	,surveillant	
kiosquière	,kiosquier	
universitaire	,universitaire	,universitaire	
soiffarde	,soiffard	
sans-logis	,sans-logis	
banlieusarde	,banlieusard	
ânesse	,âne	
convive	,convive	
démissionnaire	,démissionnaire	
compositrice	,compositeur	
rivale	,rival	
Suisse	,Suisse	
imaginative	,imaginatif	
résignée	,résigné	
patineuse	,patineur	
navigatrice	,navigateur	
consommatrice	,consommateur	
diagnosticienne	,diagnosticien	
tireuse	,tireur	
Allemande	,Allemand	
criminelle	,criminel	
trieuse	,trieur	
décoratrice	,décorateur	
tailleuse	,tailleur	
citoyenne	,citoyen	
complice	,complice	
cyclotouriste	,cyclotouriste	
esclave	,esclave	
usagère	,usager	
trompettiste	,trompettiste	
coupable	,coupable	
officière	,officier	
reine	,roi	
