>>>	S_0
sismique	,séisme	
désobéir	,désobéissance	
piétonnier	,piéton	,piétonne	
avertir	,avertissement	,avertissement	
se balader	,balade	
travailler	,travail	,travail	
céder	,cession	
marinier	,marine	
importer	,importation	
s’approprier	,appropriation	
luxueusement	,luxe	
introduire	,introduction	
jugulaire	,gorge	
théâtral	,théatre	
équin	,cheval	
terreux	,terre	
ainsi	,façon	
déboucher	,débouchage	
féminin	,femme	
maigrir	,amaigrissement	
chinois	,Chine	
attaquer	,attaque	
palmaire	,paume	
historiquement	,histoire	
insulter	,insulte	
repasser	,repassage	
succéder	,succession	
instantanément	,instant	
oculaire	,yeux	
venger	,vengeance	
sylvestre	,forêt	
occidental	,ouest	,ouest	,ouest	,ouest	
se déplacer	,déplacement	,déplacement	,déplacement	
écraser	,écrasement	
abonner	,abonnement	
se disputer	,dispute	
politique	,politique	,politique	,politique	
évaluer	,évaluation	
écœurer	,écœurement	
donner	,don	
angélique	,ange	
ouvrier	,ouvrier	,ouvrière	
coopératif	,coopération	
témoigner	,témoignage	
stratégique	,stratégie	
fiévreux	,fièvre	
rétablir	,rétablissement	
après coup	,après-coup	
attendrir	,attendrissement	
consentir	,consentement	,consentement	
géométriquement	,géométrie	
palpébral	,paupières	
triompher	,triomphe	
gâcher	,gâchage	
illustrer	,illustration	
auto	,auto	,voiture	
brosser	,brossage	,brossage	,brossage	
moucher	,mouchage	
corriger	,correction	
aggraver	,aggravation	
accéder	,accès	
hexagonal	,hexagone	
gingival	,gencives	
améliorer	,amélioration	
miraculeux	,miracle	
alimenter	,alimentation	
nationaliste	,nationalisme	
s’éprendre	,coup de foudre	
grandir	,croissance	
cuire	,cuisson	
>>>	A_2Perf
imposer	,imposé	
autoriser	,autorisé	
disposer	,disposé	
détacher	,détaché	
abonner	,abonné	
élargir	,élargi	
nationaliser	,nationalisé	
promettre	,promis	
décider	,décidé	
meubler	,meublé	
charger	,chargé	
approvisionner	,approvisionné	
attacher	,attaché	
détourner	,détourné	,détourné	
orienter	,orienté	
décoration	,décoré	,décoré	
affaiblir	,affaibli	
souligner	,souligné	
extraire	,extrait	
lisser	,lissé	
éteindre	,éteint	
accepter	,accepté	
étrangler	,étranglé	
obtenir	,obtenu	
appauvrir	,pauvre	
soulager	,soulagé	
réveiller	,réveillé	
entasser	,entassé	
afficher	,affiché	
salissant	,sale	
entendre	,entendu	
décourager	,découragé	
allonger	,couché	
éloigner	,éloigné	
hospitaliser	,hospitalisé	
user	,usé	
fâcher	,fâché	
déchirer	,déchiré	
installer	,installé	
dégoûter	,dégoûté	
détruire	,détruit	,détruit	
développer	,développé	
doubler	,doublé	
décorer	,décoré	,décoré	
emprunter	,emprunté	
goudronner	,goudronné	
imaginer	,imaginé	
réaliser	,réalisé	
imprimer	,imprimé	
barrer	,barré	
envelopper	,enveloppé	
brosser	,brossé	
contraindre	,contraint	
asseoir	,assis	
bourrer	,bourré	
défaire	,défait	,défait	
hacher	,haché	
animer	,animé	
domestiquer	,domestique	
diminution	,diminué	
voiler	,voilé	
enrouler	,enroulé	
envoi	,envoyé	
soumettre	,soumis	,soumis	
diviser	,divisé	
lacer	,lacé	
pardonner	,pardonné	
épouvanter	,épouvanté	
diplômer	,diplômé	
râper	,râpé	
>>>	Syn_∩
maisonnée	,maison	
interroger	,demander	
facilité	,aisance	
rupture	,divorce	,divorce	
bizarrement	,étrangement	
coup de théâtre	,coup d’éclat	
figure	,bouille	,face	,gueule	,mine	,tête	,visage	,personnalité	,figure de proue	,illustration	,schéma	,dessin	,apparence	,visage	,personnage	
enfermé	,prisonnier	
vert	,écologique	,propre	
comme un oiseau	,peu	
scintiller	,étinceler	
personnage	,héros	,figure	,figure de proue	
bijoutier	,joaillier	
station balnéaire	;plage	
inscrit	,enregistré	
frère	,jumeau	
Ah !	,Oh !	
confirmer	,affirmer	,déclarer	
dégoût	,aversion	
rivière	,fleuve	;ruisseau	;torrent	,fleuve	,torrent	,lac	,flot	,fleuve	,océan	
géant	,gigantesque	
déjà	,tôt	,à nouveau	
buanderie	,blanchisserie	
humiliant	,cuisant	
fête	,bombe	;cérémonie	
se retrouver	,devenir	
garde-manger	,placard	
autocar	,autobus	,bus	
reprendre	,repéter	
ombre	,obscurité	
boulangère-pâtissière	,boulangère	;pâtissière	,boulangère	;pâtissière	
imaginer	,supposer	
fuselé	,mince	
forêt	,bois	,fleuve	
louche	,suspect	
justesse	,précision	
espérance	,espoir	
larme	,dé à coudre	
courir la poste	,courir	;se grouiller les fesses	
boucherie	,boucherie-charcuterie	
évacuation	,fuir	
triable	,ordonnable	
au bec	,aux lèvres	,à la bouche	
représenter	,figurer	
hôtesse de l’air	,steward	
ivre	,saoul	,blindé	,cuité	<bourré	,pinté	<beurré	,rond	,plein	,pété	,torché	,déchiré	,raide	,arraché	,transporté	,rempli	
buste	,poitrine	,poitrine	;gorge	
saisissant	,frappant	
se taper	,s’enfiler	,s’envoyer	,manger	,bouffer	
délinquance	,crime	;criminalité	;banditisme	
couché	,horizontalement	
base	,fondations	
heurt	,choc	
enchaîné	,attaché	
mer intérieure	,lac	
salaud	,connard	;fumier	,ordure	,pourriture	,vache	
opposé	,adverse	;contraire	
rive	,rivage	;berge	,bord	;coteau	,rivage	,berge	,bord	,littoral	,côte	,littoral	,rivage	,bord	<accotement	,bord	,bordure	,lisière	,bordure	,rebord	,bordure	,marge	,rebord	,bord	,confins	,frontière	,limite	
partout	,où que ce soit	;par monts et par vaux	
irriguer	,arroser	
instruction	,savoir	
express	,éclair	,rapide	
traducteur	,interprète	
s’arrêter	,s’immobiliser	,s’éteindre	,arrêter	;lever le nez du guidon	
acharné	,tenace	
ventre	,abdomen	
trempé	,mouillé	
dire	,prononcer	
réserve	,provision	
garde-robe	,armoire	
>>>	Anti
décéder	,naître	
innocent	,coupable	
raisonner	,déraisonner	
minimum	,maximum	
lent	,rapide	
débarrasser	,embarrasser	
fermé	,ouvert	,ouvert	
accessibilité	,inaccessibilité	
poupe	,proue	
disparaître	,apparaître	,naître	,apparaître	
impatient	,patient	
organiser	,désorganiser	
comme un fer à repasser	,comme un poisson	
probable	,improbable	
arrière	,avant	
développer	,envelopper	
incapacité	,capacité	
endroit	,envers	
indiscret	,discret	
impair	,pair	,pair	,pair	
s’envoler	,chuter	
inaccessible	,accessible	
déterrer	,enterrer	
maladresse	,adresse	
lever l’ancre	,jeter l’ancre	
hypertrophié	,atrophié	
salement	,proprement	,proprement	,proprement	,proprement	
pudeur	,impudeur	
départ	,arrivée	
embarrasser	,débarrasser	
exploitable	,inexploitable	
éteint	,allumé	
tendreté	,dureté	
insincérité	,sincérité	
incomplet	,complet	
mineur	,majeur	,majeur	
inexploitable	,exploitable	
arrêt	,marche	
désavantage	,avantage	
inconnaissable	,connaissable	
se lever	,se coucher	
original	,copie	
particulier	,général	
synonyme	,antonyme	
dégonfler	,gonfler	,gonfler	
pair	,impair	,impair	,impair	
infertile	,fertile	
compréhensible	,incompréhensible	
attention	,inattention	
potable	,non potable	
normal	,anormal	
sain	,malsain	
intérieur	,extérieur	,extérieur	
sec	,humide	
minuscule	,majuscule	
importateur	,exportateur	
inacceptable	,acceptable	
nulle part	,quelque part	
désaccord	,accord	
embellir	,enlaidir	,s’enlaidir	
adroit	,maladroit	,maladroit	
direct	,indirect	
envers	,endroit	
froncer	,défroncer	
mains sales	,mains propres	
heureusement	,malheureusement	
désagréable	,agréable	
xénophobie	,xénophilie	
réveillé	,endormi	
avoir froid	,avoir chaud	
>>>	Syn_⊃
salir	,tacher	,tacher	
liste	,catalogue	;répertoire	
cap	,nez	
revêtement	,enveloppe	
battre	,cogner	;passer à tabac	,cogner	
arrière-grand-parent	,arrière-grand-mère	,arrière-grand-père	
contenu	,corps	
peau	,épiderme	
détacher	,dénouer	
tornade	,trombe	
laveuse	,lavandière	
ingérer	,manger	,boire	
fonctionner	,marcher	
loger	,héberger	
braquemart	,cigare	,phallus	
soixante	,soixantaine	
toison	,triangle	
nez	,museau	;bec	
cravate	,lavallière	,régate	
habillement	,costume	
se disputer	,se brouiller	
élire	,voter	
mille	,millier	
avion	,avionnette	
malfaiteur	,délinquant	,malfrat	,racaille	,voyou	;escroc	,truand	;bandit	,gangster	
fesses	,croupe	
périr	,succomber	,passer l’arme à gauche	,s’éteindre	
rêve	,cauchemar	
femme	,mère	
entrée	,hors-d’œuvre	
liqueur	,crème	;vin	
tennis	,double	
envoyer	,renvoyer	
journaliste	,correspondant	;pigiste	;reporter	,correspondante	;pigiste	;reporter	
crado	,dégueu	,dégueulasse	
enfant	,petit	;fils	,fille	,petite	
dentiste	;stomatologue	;orthodontiste	
enseignant	,maître	
bête	,animal	
marche	,expansion	
beau	,superbe	
visage	,minois	
croupion	,bonnet d’évêque	
habits	,frusques	,nippes	;garde-robe	;costume	;toilette	
crade	,dégueu	,dégueulasse	
course à pied	,jogging	
odeur	,arôme	
cellule familiale	,famille	
état	,État-nation	
cyclisme	,petite reine	
enfantin	,infantile	
vent	,air	
boucher	,charcutier	,charcutier	
lopette	,tante	
intérieur	,dedans	
choisir	,préférer	
sentiment	,émotion	
dilapider	,manger la grenouille	
politique	,politicard	
bateau	,barque	,esquif	
pression	,chantage	
crotte	,cigare	,colombin	
subir	,accuser le coup	,en voir de toutes les couleurs	
célibataire	,fille mère	
analogie	,métaphore	;image	,analogie	;point commun	
pot	,vin d’honneur	
membre	,cigare	,phallus	
vide	,néant	
dépourvu	,veuf	
arriver	;retomber sur la figure	
>>>	S_1
malade	,malade	,malade	
accompagnement	,accompagnatrice	,accompagnateur	,accompagnateur	
enthousiasme	,enthousiaste	,enthousiaste	
drôle	,numéro	
inventer	,inventeur	,inventrice	
aboiement	,chien	,chienne	
impôt	,impôts	
importer	,importateur	,importatrice	
parler	,locuteur	
voiture	;conducteur	,conductrice	;automobiliste	,automobiliste	,train	
habitation	,habitant	,habitante	
s’enfuir	,fuyard	,fuyarde	
kidnapper	,kidnappeur	,kidnappeuse	
écrire	,écriveur	,écriveuse	
alvéole	,rayon	
pécher	,pécheur	,pécheresse	
jeûne	,jeûneur	,jeûneuse	
donner le sein	,mère	;nourrice	
plongée	,plongeur	,plongeuse	
bouton	,vêtement	
Chine	,Chine	
moto	,motocycliste	,motocycliste	;motard	,motarde	
goulot	,bouteille	
pays	,pays	,compatriote	,compatriote	
patiner	,patineur	,patineuse	
Hollande	,Hollande	
église	,ecclésiastique	
attraper	,attrapeur	
tête-à-queue	,cheval	
fouiller	,fouilleur	
timidité	,timide	,timide	
éléphant	,cornac	
chaussure	,ouvrier	,ouvrière	,chausseur	,chausseuse	
oranger	,orange	
enlever	,ravisseur	
chatte	,maître	,maîtresse	;propriétaire	,propriétaire	
poil	,animal	
Grèce	,Grèce	
assassiner	,assassin	
allumette	,aliment	
réalisé	,réalisation	
chasse	,chasseur	,chasseuse	;chasseresse	
documentaire	,documentariste	,documentariste	
pièce	,écu	
boulangerie	,boulanger	,boulangère	,boulanger	,boulangère	
Enfer	,diable	,diablesse	
composer	,composant	,compositeur	,compositrice	
compétition	,compétiteur	,compétitrice	
flânerie	,flâneur	,flâneuse	
emploi	,employeur	,employeuse	;employeur	
triangle	,femme	
instruire	,instructeur	,instructrice	
monture	,lunettes	
figure de proue	,navire	
information	,informateur	,informatrice	
causer	,cause	
combat	,combattant	,combattante	
force	,fort	
camper	,campeur	,campeuse	
utiliser	,utilisateur	;utilisatrice	
loyer	,locataire	,locataire	
meurtre	,meurtrier	,meurtrière	
fauteuil	,administrateur	
parrainage	,marraine	,parrain	
boulange	,boulanger	,boulangère	
critique	,critique	
exposer	,exposant	,exposante	
défaite	,perdant	,perdante	;vaincu	,vaincue	
éclair de magnésium	,appareil photo	
migraine	,migraineux	,migraineuse	
>>>	A_0
heure	,horaire	
paralytique	,paralysie	
matériellement	,matériel	
front	,frontal	
marbre	,marbrier	
préméditer	,prémédité	
Inde	,indien	
avocat	,avocassier	
aînesse	,aîné	
côte	,costal	,côtier	
comportement	,comportemental	
corporellement	,corporel	
généralement	,général	
intimement	,intime	
valablement	,valable	
schématiquement	,schématique	
ennemi	,ennemi	,ennemi	
adulte	,adulte	,adulte	
protestantisme	,protestant	
dynamiquement	,dynamique	
virus	,viral	
curé	,curial	
touristiquement	,touristique	
orphelin	,orphelin	,orphelin	
Angleterre	,anglais	
flore	,floristique	
tombe	,tombal	
banalement	,banal	
orange	,orange	
absolument	,absolu	
gorge	,jugulaire	,guttural	
callipyge	,callipyge	
Soleil	,solaire	
indépendamment	,indépendant	
salement	,sale	,sale	,sale	,sale	
porc	,porcin	
Chine	,chinois	
adolescente	,adolescent	
estomac	,stomacal	,gastrique	
institution	,institutionnel	
exceptionnellement	,exceptionnel	,exceptionnel	
festival	,festivalier	
orthographe	,orthographique	
mine	,minier	
nage	,natatoire	
incroyablement	,incroyable	
patron	,patronal	
autoroute	,autoroutier	
mouton	,ovin	
rose	,rose	
meurtre	,meurtrier	
buriner	,buriné	
probablement	,probable	
général	,général	
mâchoires	,maxillaire	
synthèse	,synthétique	
intellectuellement	,intellectuel	
carré	,carré	,carré	
volcan	,volcanique	
lune	,lunaire	
directement	,direct	
électriquement	,électrique	
gendarmette	,gendarmesque	
ventre	,ventral	,ventral	
formidablement	,formidable	,formidable	
normalement	,normal	
cœur	,cardiaque	
pudiquement	,pudique	
Portugal	,portugais	
cuisine	,culinaire	
>>>	Able_2
scier	,sciable	
composition	,composable	
proposer	,proposable	
détester	,détestable	
franchir	,franchissable	
transformer	,transformable	
consommer	,consommable	
tourner	,tournant	
déformer	,déformable	
exiger	,exigible	
élire	,éligible	
reproduire	,reproductible	
bicyclette	,cyclable	
acheter	,achetable	
partager	,partageable	
tempête	,exposé	
critiquer	,critiquable	
écraser	,écrasable	
prévoir	,prévisible	
observer	,observable	
consommation	,consommable	
démonter	,démontable	
facture	,facturable	
soupçonner	,soupçonnable	;suspect	
atteindre	,atteignable	
toucher	,touchable	
attraper	,attrapable	
gouverner	,gouvernable	
améliorer	,améliorable	
voir	,visible	
supprimer	,supprimable	
détruire	,destructible	,destructible	
calculer	,calculable	
solution	,soluble	
incliner	,inclinable	
modifier	,modifiable	
adapter	,adaptable	
opposer	,opposable	
rabattre	,rabattable	
laver	,lavable	,lavable	
éviter	,évitable	
détacher	,détachable	
constatation	,constatable	
paralysie	,paralysant	
utiliser	,utilisable	
manger	,mangeable	,comestible	
multiplier	,multipliable	
exprimer	,exprimable	
allergie	,allergène	,allergisant	
prononcer	,prononçable	
maîtriser	,maîtrisable	
réparer	,réparable	
remuer	,remuable	
licencier	,licenciable	
réaliser	,réalisable	
expliquer	,explicable	
éduquer	,éducable	
citer	,citable	
recycler	,recyclable	
réalisation	,réalisable	,réalisable	
cultiver	,cultivable	
arracher	,arrachable	
libérer	,libérable	
expérimenter	,expérimentable	
vacciner	,vaccinable	
boucher	,bouchable	
absorber	,absorbable	
danser	,dansable	
imiter	,imitable	
déplacer	,déplaçable	
>>>	Anti_∩
par à-coups	,régulièrement	
rudesse	,douceur	
discrètement	,indiscrètement	
encombré	,dégagé	
mauvais	,bon	,bon	,bon	
mari	,célibataire	
altruisme	,égoïsme	
se marier	,divorcer	
rarement	,souvent	,jamais	,toujours	
nager	,aller	
crâne	,lâche	
longtemps	,brièvement	,rapidement	,promptement	,toujours	
davantage	,moins	
médiocre	,remarquable	
idéalité	,réalité	
optimisme	,pessimisme	
traîner	,se dépêcher	
ancienneté	,nouveauté	
xénophobie	,tolérance	
ressemblance	,différence	,dissimilitude	,dissemblance	,dissimilarité	,dissemblance	
charitable	,égoïste	
contradiction	,analogie	
refroidir	,refroidir	
tarir	,jaillir	
vallée	,colline	
arrêter	,s’initer	
rien	,tout	
couleur	,noir et blanc	
solidement	,fragilement	
opposition	,analogie	
obscurité	,clarté	
vert	,rouge	
baisser	,lever	
vite	,lentement	
fleuve	;bref	;concis	;éclair	
anguleux	,rond	
aride	,humide	
spacieux	,compact	;exigu	,minuscule	
pauvre	,riche	
bouffer	,jeûner	,articuler	
connaissance	,ignorance	
retrouver	,perdre	
prendre la robe	,quitter l’habit	
marié	,célibataire	;divorcé	;veuf	
s’ouvrir	,se fermer	
noyer	,assécher	
alcoolique	,sobre	
rassuré	,inquiet	
marcher à l’eau claire	,boire	
bien	,peu	,un peu	,peu	,malade	
accommodant	,têtu	
oui	,non	
bande d’arrêt d’urgence	,bande de circulation	
amer	,doux	
différent	,similaire	,analogue	
conserver	,quitter	
détacher	,attacher	
accélérer	,ralentir	
souple	,têtu	
éloge	,blâme	,reproche	,critique	
dans	,hors	
ignorer	,connaître	,savoir	
tuable	,immortel	
recette	,dépense	
crime	,merveille	
peu	,très	,bien	
épouse	,célibataire	
approvisionné	,vide	
trouver	,ne pas voir la couleur	
solide	,liquide	,gazeux	
>>>	V_0
fond	,fonder	
expédition	,expédier	,expédier	
crevaison	,crever	
apprentissage	,apprendre	
appréciation	,apprécier	
approbation	,approuver	
attelage	,atteler	
étirement	,s’étirer	
entassement	,s’entasser	
pompage	,pomper	
menace	,menacer	
autorisation	,autoriser	
pari	,parier	
nettoyage	,nettoyer	,nettoyer	,nettoyer	,nettoyer	,nettoyer	,nettoyer	,nettoyer	,nettoyer	,nettoyer	,nettoyer	,nettoyer	
permission	,permettre	
grondant	,gronder	
fonte	,fondre	
imitation	,imiter	
pardon	,pardonner	
soupir	,soupirer	
doublage	,doubler	,doubler	
maltraitance	,maltraiter	
remplissage	,remplir	
cri	,crier	,crier	
rasage	,raser	
hachage	,hacher	
commandement	,commander	
sacrifice	,sacrifier	
bénédiction	,bénir	
Compliments	,complimenter	
flottement	,flotter	
rongement	,ronger	
mesure	,mesurer	
aplatissement	,aplatir	
traite	,traire	
contrainte	,contraindre	
péché	,pécher	
évanouissement	,s’évanouir	
croyance	,croire	
navigation	,naviguer	,naviguer	,naviguer	
puanteur	,puer	
alimenté	,alimenter	
poursuite	,poursuivre	
tranchage	,trancher	
ramassage	,ramasser	
viol	,violer	
souper	,souper	
bouleversement	,bouleverser	
négligence	,négliger	
résidence	,résider	
décision	,décider	
pesage	,peser	
amélioration	,améliorer	,s’améliorer	
suggestion	,suggérer	
frottement	,frotter	
gaspillage	,gaspiller	
désignation	,désigner	,désigner	
aboiements	,aboyer	
adoption	,adopter	
engagement	,s’engager	
allongement	,s’allonger	
sifflet	,siffler	
accord	,s’accorder	
détente	,se détendre	,se détendre	
prévision	,prévoir	
progression	,progresser	
résultat	,résulter	
sucrage	,sucrer	
abdication	,abdiquer	,abdiquer	
Félicitations	,féliciter	
>>>	S_3
payer	,paiement	
arracher	,arracheuse	
hôpital	,patient	,patiente	
décharger	,chargement	
accusation	,objet	;motif	
différence	,différence	
voter	,élection	
cuir	,article	
piocher	,pioche	
supérette	,client	,cliente	,clientèle	
admiration	,objet	,source	
hypermarché	,client	,cliente	,clientèle	
mairie	,administré	,administrée	
enveloppe	,destinataire	,destinataire	,bénéficiaire	
bijouterie	,client	,cliente	
juger	,délit	;crime	
travailler	,employeur	,employeuse	,patron	,patronne	;employeur	
épicerie	,client	,cliente	
compte	,banque	
parier	,mise	
boulanger	,client	,cliente	
compensation	,compensation	
tailler	,vêtement	
pansement	,pansement	
bombarder	,bombe	,bombardier	
nommer	,nom	;prénom	
armer	,arme	;armement	
boîte aux lettres	;courrier	
carré	,jardin	,potager	
compenser	,compensation	
unanimité	,élection	;vote	
comprimé	,substance active	
accentuer	,accent	,accent	
multiplier	,multiplicateur	
discuter	,sujet	,thème	
couleur	,poker	
pâtisserie	,cliente	,client	
tirage	,tirage	
cirer	,cire	
gommer	,gomme	
débiteur	,dette	
coiffer	,coiffure	
plateau	,tir	;ball-trap	
empoisonner	,poison	
similarité	,similarité	,point commun	
accentuation	,accent	,accent	
boucher	,client	,cliente	
bouchère	,client	,cliente	
habiller	,habits	,vêtements	
restaurant	,clientèle	;client	,cliente	
procès	,affaire	
maire	,administré	,administrée	
film	,acteur	,actrice	,comédien	,comédienne	
panser	,pansement	
attaché	,attache	
expédier	,destinataire	,destinataire	
chèque	,bénéficiaire	;porteur	
poissonnerie	,client	,cliente	
accès	,accès	
louange	,louange	
coiffage	,peigne	,brosse	
ministre	,gouvernement	,état	
administrable	,administrateur	
envoi	,destinataire	,destinataire	
analogie	,analogie	,point commun	
juge	,tribunal	
collège	,collégien	,collégienne	
papeterie	,papier	
addition	,client	,cliente	
dieu	,culte	
>>>	A_1
fuir	,fugitif	
orgueil	,orgueilleux	
s’enfuir	,fuyard	
manquer	,manquant	
rassurer	,rassurant	
hésiter	,hésitant	
construction	,constructeur	
ennemi	,ennemi	
superbe	,superbe	
aggraver	,aggravant	
symbole	,symbolique	
Grèce	,grec	
adolescente	,adolescent	
humilier	,humiliant	
transparence	,transparent	
christianisme	,chrétien	
déborder	,plein	,rempli	
nombre	,nombreux	
diplôme	,diplômé	
forme	,en	,en	
marche	,en	,en marche	,en marche	,allumé	,composé	
fonctionner	,en service	
dents longues	,à	
talent	,talentueux	
griffes	,griffu	
pauvreté	,pauvre	
situation	,situé	
négliger	,négligent	
défendre	,défensif	
maladresse	,maladroit	
monter	,montant	
effrayer	,effrayant	
fleurir	,fleurissant	
se résigner	,résigné	
bon sens	<plein	
agacement	,agacé	
dévaster	,dévastateur	
exporter	,exportateur	
affirmer	,affirmatif	
perfection	,parfait	
déchirer	,déchirant	
difficulté	,difficile	
amateur	,amateur	
paresse	,paresseux	
pouvoir	,capable	,à	
vie	,vivant	,en	
illusoirement	,illusoire	
venger	,vengeur	,vengeur	
orage	,traverser	,orageux	
occuper	,occupant	
banalité	,banal	
parole	,parlant	
angle	,anguleux	
ignorer	,ignorant	
pudeur	,pudique	
lumière	,lumineux	
transport	,transporté	
condamné	,condamné	
beauté	,beau	
participer	,participant	
s’appuyer	,appuyé	
Espagne	,espagnol	
force	,fort	
déplacement	,en	,en	
nécessaire	,nécessaire	
extrême	,extrême	
épuisement	,épuisé	
barbe	,barbu	
décourager	,décourageant	
affoler	,affolant	
>>>	S_2^prototyp
automobile	,automobile	
boulangère	,pain	;viennoiserie	
élément de langage	,politicien	,politicienne	
tarte	,citron	,fraise	,pomme	,prune	,fromage blanc	,crème	,sucre	,chocolat	
battre	,adversaire	,adversaire	,compétitrice	,compétiteur	;record	
dire	,injure	
dresser	,table	,table	
conduite	,véhicule	,auto	,train	,moto	,voiture	,automobile	
navigation	,Internet	
condamner	,accusé	,accusée	
facteur	,courrier	,lettre	;colis	,paquet	,clavecin	;flûte	;orgue	;piano	
dans	,habit	,vêtement	
vestiaire	,cliente	,client	
éclair	,café	;chocolat	;vanille	
envoi	,colis	,lettre	
recouvert	,tissu	
factrice	,courrier	,lettre	;colis	,paquet	,clavecin	;flûte	;orgue	;piano	
fonder	,famille	
gratter	,guitare	,gratte	
avion	,passager	,passagère	,voyageur	,voyageuse	;cargaison	,fret	
chiffon	,poussière	
hisser	,voile	;drapeau	
piste	,aéroport	
boulanger	,pain	;viennoiserie	
rivière	,steeple	
cadre	,entreprise	,parti	,armée	
transmettre	,maladie	;microbe	
nappe	,table	
bouchon	,bouteille	,bouteille	
parapluie	,pluie	
titulaire	,passeport	;permis	,passeport	,permis	
voie	,véhicule roulant	,véhicule	
tempête	,protestation	
fromage	,brebis	,chèvre	,vache	
panier	,basket	
cible	,chantage	
fibre	,muscle	,tissu	
boucher	,viande	
amputer	,membre	
péage	,autoroute	
fumeur	,cigare	,cigarette	,pipe	;tabac	
symptomatique	,maladie	
monopoliser	,antenne	
visé	,accusation	
plan	,film	
tramway	,terminus	
paroles	,chanson	
transporté	,admiration	
arrêt	,bus	
éléments de langage	,politicien	,politicienne	
pâté	,lapin	,volaille	
verrou	,porte	
forme	,chaussures	,chapeau	,pain	,fromage	,sucre	
conducteur	,voiture	,véhicule	,automobile	,moto	,auto	,autobus	,autocar	,bus	,camion	,car	,métro	,train	,tramway	
nœud	,cravate	
transférer	,prisonnier	,prisonnière	
chausson	,pomme	
avoir	,propriété	
ceinture	,pantalon	,jupe	,robe	,manteau	,véhicule	,agglomération	
s’éponger	,front	
sirop	,fraise	,menthe	
lire	,livre	;magazine	
enveloppe	,lettre	,document	
traire	,vache	
patiente	,médecin	,médecin	,docteur	,docteure	
farter	,skis	
pharmacie	,médicament	
marcher	,carburant	,électricité	,vapeur	
s’asseoir	,chaise	,fauteuil	,siège	
placarder	,avis	,affiche	
>>>	Syn_⊃^sex
pochetron	,pochetronne	
cyclotouriste	,cyclotouriste	
prince	,princesse	
pouilleux	,pouilleuse	
écolier	,écolière	
descripteur	,descriptrice	
partenaire	,partenaire	
auteur	,auteure	
jardinier	,jardinière	
berger	,bergère	
miraculé	,miraculée	
campeur	,campeuse	
émigrant	,émigrante	
fiancé	,fiancée	
Belge	,Belge	
ministre	,ministre	
chasseur	,chasseuse	;chasseresse	
aviculteur	,avicultrice	
coopérant	,coopérante	
esclave	,esclave	
meilleur	,meilleure	
interprète	,interprète	,interprète	
médicastre	,médicastre	
roi	,reine	
saoulard	,saoularde	
témoin	,témoin	
peau-rouge	,peau-rouge	
arrivant	,arrivante	
diplômé	,diplômée	
péteur	,péteuse	
calomniateur	,calomniatrice	
joggeur	,joggeuse	
vendeur	,vendeuse	
maçon	,maçonne	
messager	,messagère	
shampouineur	,shampouineuse	
continental	,continentale	
Franc	,Franque	
inconnu	,inconnue	
gaspilleur	,gaspilleuse	
baigneur	,baigneuse	
sans-logis	,sans-logis	
sourd	,sourde	
mendiant	,mendiante	
festivalier	,festivalière	
coursier	,coursière	
observateur	,observatrice	
otage	,otage	
siffleur	,siffleuse	
gros	,grosse	
fermier	,fermière	
truand	,truande	
prêteur	,prêteuse	
lecteur	,lectrice	
titulaire	,titulaire	
meunier	,meunière	
intellectuel	,intellectuelle	
boucher-charcutier	,bouchère-charcutière	,bouchère-charcutière	
dévoreur	,dévoreuse	,dévoreuse	
résidant	,résidante	
paresseux	,paresseuse	
malade	,malade	
météorologue	,météorologue	
gaucher	,gauchère	
opposant	,opposante	
couturier	,couturière	
député	,députée	
veuf	,veuve	
assoiffé	,assoiffée	
pigeon	,pigeonne	
>>>	Adv_0
délicieux	,délicieusement	
continuité	,continûment	
formel	,formellement	
gracieux	,gracieusement	
apparent	,en apparence	,apparemment	
continuel	,continuellement	
musculaire	,musculairement	
électrique	,électriquement	
gratuit	,gratuitement	
sale	,salement	,salement	,salement	,salement	
humble	,humblement	
acceptable	,acceptablement	
conceptuel	,conceptuellement	
maternel	,maternellement	
désagréable	,désagréablement	
clandestinité	,clandestinement	
divers	,diversement	
confortable	,confortablement	
régulier	,régulièrement	
religion	,religieusement	
dieu	,divinement	
geste	,gestuellement	
commercial	,commercialement	
synthèse	,synthétiquement	
mental	,mentalement	
intime	,intimement	
curieux	,curieusement	
furieux	,furieusement	
vraisemblable	,vraisemblablement	
banal	,banalement	
parallèle	,parallèlement	
superficiel	,superficiellement	
constance	,constamment	
territoire	,territorialement	
supplément	,supplémentairement	
grammaire	,grammaticalement	
évident	,évidemment	
diable	,diaboliquement	
vif	,vivement	,vivement	,vivement	
schéma	,schématiquement	
torrentiel	,torrentiellement	
bas	,bassement	
alphabet	,alphabétiquement	
tonnerre	,dans	
allusion	,allusivement	
religieux	,religieusement	,religieusement	
normal	,normalement	
homme	,humainement	
façon	,ainsi	
incroyable	,incroyablement	
moral	,moralement	
fantastique	,fantastiquement	
simple	,simplement	
temps	,temporellement	
valable	,valablement	
souterrain	,souterrainement	
collectivement	,collectif	
général	,généralement	
odieux	,odieusement	
profitable	,profitablement	
morale	,moralement	
lexique	,lexicalement	
timidité	,timidement	
agréable	,agréablement	
discret	,discrètement	
force	,fort	,fortement	
danger	,dangereusement	
impatient	,impatiemment	
individu	,individuellement	
aucun	,aucunement	
>>>	Syn_⊂
véhicule volant	,véhicule	
tortillard	,train	
soupir	,bruit	
studio	,appartement	
extrait	,enlevé	
guéer	,traverser	
immédiat	,période	
pleuvoir	,tomber	
pain	,bloc	
train-train	,vie	
steeple	,course	
réprimer	,empêcher	
couleurs	,teint	
quart-temps	,période	
budget	,enveloppe	
affreux	,moche	
piano droit	,piano	
se traîner	,se déplacer	
forme	,état	,état	,matrice	
toile	,tissu	
victoire	,succès	
alcool	,alcool	,alcool	
rideau de bambou	,limite	
s’employer	,agir	
éléphanteau	,petit	
corps franc	,troupe	
batterie	,tas	
vin de glace	,vin	
papa	,père	,père	
allaiter	,nourrir	
bouger	,agir	
chiffon rouge	,sujet	
cracher	,projeter	
ramper	,se déplacer	,se déplacer	
meuble	,bien	,ameublement	
désolé	,désert	
fiacre	,voiture	
impitoyable	,sévère	
chevalin	,équin	
s’évader	,s’enfuir	
siester	,dormir	
strident	,aigu	
vélo elliptique	,appareil	
recrue	,soldat	,soldat	,soldate	
comme un balai	,très	
avancer	,se déplacer	,placer	
hold-up	,attaque	,appropriation	;attaque	
fille	,enfant	
lessive	,nettoyant	,lavage	,solution	,tri	
raccommodable	,réparable	
pogne	,main	
chaîne	,lien	,rangée	
combattante du feu	,pompier	
grailler	,crier	
assimilable	,similaire	
Pays du Soleil Levant	,Japon	
collision	,choc	
jogging	,course à pied	
coudre	,fabriquer	
coup de filet	,opération	
analogue	,analogue	,équivalent	,équivalent	
marin	,aquatique	
à toute vitesse	,vite	
néant	,vide	
centaine	,cent	
pantoufles	,chaussons	
déconvenue	,déception	
se geler les fesses	,avoir froid	
remettre	,mettre	
roulette	,roue	
>>>	Syn
Bon app’!	,Bon appétit	
directeur	,dirlo	
se casser	,se fracturer	
karatéka	,karatékate	
durant	,pendant	
armoire à glace	,armoire normande	
se ramasser	,prendre	,ramasser	,se manger	,se prendre	
laid	,moche	
karatékate	,karatéka	
Dieu	,père	
gratuit	,gratis	,gratos	
se saper	,se fringuer	,s’habiller	,se vêtir	
guillotine	,coupe-cigare	
lessiviel	,lessivier	
balayeuse	,aspiratrice	
s’appeler	,se nommer	
mastiquer	,mâcher	
hôtesse	,hôte	
instrument	,instrument de musique	
sèche	,cancéreuse	,cibiche	,cigarette	,clope	,garo	,tige	,schmer	
doctoresse	,doc	,toubib	,docteure	,femme médecin	,médecin	
océanique	,océane	
tente	,guitoune	
ordi	,ordinateur	
quand les poules auront des dents	,jamais	
chasseresse	,chasseuse	
raconteur	,conteur	
ruiné	,en ruine	
bientôt	,tantôt	
explosif	,explosible	
couleur	,coloration	,teinture	,coloration	,teinture	,coloration	,teinture	
philosophie	,philo	
arable	,labourable	
fendard	,ben	,bénard	,falzar	,froc	,fute	,futal	,culotte	,pantalon	
piano à bretelles	,accordéon	
crapaud	,piano crapaud	
Prudence est mère de sûreté.	,Méfiance est mère de sûreté.	
attraper	,ramasser	
labo	,laboratoire	
survêtement	,survêt	,jogging	
dictionnaire	,dico	
soldate	,soldat	,femme soldat	
mémé	,mamie	,mémère	,bonne-maman	,grand-maman	,aïeule	,mère-grand	,grand-mère	,grand-mère	,mamie	,vieillarde	
pucier	,paddock	,pageot	,pieu	,plumard	,lit	
téléviseur	,télévision	;télé	,téloche	
taille	,stature	,taillage	
furibond	,furibard	
dab	,daron	,pater	,paternel	,père	
grand-maman	,aïeule	,mère-grand	,mamie	,mémé	,mémère	,bonne-maman	,grand-mère	
arrière-train	,fesses	,cul	,derrière	,panier	,postérieur	,séant	,miches	,pétard	,croupe	,croupion	,fessier	,popotin	,derche	,lune	
jetage	,jet	
interrompre	,suspendre	
sculptrice	,sculpteure	
clodo	,clochard	,clocharde	
pieds	,arpion	,panards	,ripatons	
lancer	,jeter	
dernier carré	,carré final	
instit	,instituteur	,institutrice	
judokate	,judoka	
fiancée	,promise	,payse	
imper	,imperméable	
violon alto	,alto	
petit doigt	,auriculaire	
popotin	,cul	,derrière	,panier	,arrière-train	,postérieur	,séant	,miches	,pétard	,croupe	,croupion	,fessier	,derche	,lune	
lit	,paddock	,pageot	,pieu	,plumard	,pucier	
sœurette	,frangine	,sœur	
noble art	,boxe	
hôtel de ville	,mairie	
moto	,motocyclette	,bécane	,meule	
labour	,labourage	
>>>	S_1Pred
merveilleux	,merveille	
chinois	,Chinoise	,Chinois	
laid	,laid	,laide	
riverain	,riverain	,riveraine	
suisse	,Suisse	,Suisse	,Suissesse	
têtu	,têtu	,têtue	<entêté	,entêtée	;cabochard	,cabocharde	,tête de mule	,tête de cochon	
québécois	,Québécois	,Québécoise	
bizarre	,bizarrerie	
bossu	,bossu	,bossue	
asiatique	,Asiatique	,Asiatique	
mort	,mort	,morte	
alcoolique	,alcoolique	
héroïque	,héros	,héroïne	
agressé	,agressé	,agressée	
organique	,organisme	
franc	,Franc	
titulaire	,titulaire	
tentateur	,tentateur	,tentatrice	
immortel	,immortel	,immortelle	
immigré	,immigré	,immigrée	
impair	,nombre	;chiffre	
orphelin	,orphelin	,orphelin	,orphelin	
arabe	,Arabe	,Arabe	
chauve	,chauve	
innocent	,innocent	,innocente	
français	,Français	,Française	
lâche	,lâche	,lâche	
gentil	,gentil	,gentille	
femelle	,femelle	
belge	,Belge	,Belge	
sourd	,sourd	,sourde	,bruit	
américain	,Américain	,Américaine	
protestant	,protestant	,protestante	
mineur	,mineur	,mineure	
russe	,Russe	,Russe	
autochtone	,autochtone	,autochtone	
original	,original	,original	
miraculé	,miraculé	,miraculée	
aveugle	,aveugle	,aveugle	
vivant	,vivant	;vivante	
pair	,nombre	;chiffre	
hospitalisé	,hospitalisé	,hospitalisée	
juif	,juif	,juive	
grec	,Grec	,Grecque	
fort	,fort	
ingrat	,ingrat	,ingrate	
moche	,moche	,moche	;mocheté	
timide	,timide	,timide	
fouetteur	,fouetteur	,fouetteuse	
pauvre	,pauvre	,pauvre	
criminel	,crime	,crime	,crime	
catholique	,catholique	,catholique	
fidèle	,fidèle	
anglais	,Anglais	,Anglaise	
puni	,punie	
acquéreur	,acquéreur	
anonyme	,anonyme	
aîné	,aîné	,aînée	
voyou	,voyou	
myope	,myope	,myope	
inconnu	,inconnu	,inconnue	
faible	,faible	
italien	,Italien	,Italienne	
bon	,bon	
idiot	,idiot	,idiote	
végétarien	,végétarien	,végétarienne	
indiscret	,indiscret	,indiscrète	
accidenté	,accidenté	,accidentée	
jeune	,jeune	,jeune	
débrouillard	,débrouillard	,débrouillarde	
>>>	S_2
crime	,victime	,victime	
coiffeuse	,client	,cliente	
retaper	,drap	;lit	
nation	,pays	
fusil	,cible	
citer	,citation	
chien de chasse	,chasse	
diplômer	,diplômé	,diplômée	
bagage	,connaissance	,savoir	
hériter	,héritage	
boire	;boisson	
mardi	,semaine	
poids	,poids	
masse	,masse	
habillé	,vêtements	;vêtement	
appartenir	,propriétaire	,propriétaire	
manger	,manger	;nourriture	
clinique	,patient	,patiente	
appareiller	,bateau	
samedi	,semaine	
enterrer	,mort	,morte	;cadavre	
lycée	,lycéen	,lycéenne	
bateau	,cargaison	,chargement	,fret	;passager	,passagère	
air	,chanteur	,chanteuse	,paroles	
séchoir	,plante	
chantage	,cible	,victime	,victime	
semer	,semence	;graine	
plein	,réservoir	
aéroport	,avion	
épicerie	,marchandise	
partie	,procès	
éplucheur	,légume	
se confier	,confident	,confidente	
université	,universitaire	,universitaire	
priseur	,tabac	
père	;enfant	,congrégation	;couvent	
empoisonné	,poison	
équivalent	,équivalent	
voiture	,passager	,passagère	,passager	,passagère	,voyageur	,voyageuse	,occupant	,occupante	;cargaison	,chargement	;marchandise	
menuisier	,meuble	
enlever	,victime	
ameublement	;meuble	
visiter	,hôte	,hôte	,hôtesse	
cheval	,cheval	
embarquer	,bateau	
desservir	,arrêt	,station	
dieu	,croyant	,croyante	
exiger	,exigence	
aînesse	,cadette	,cadet	,puîné	,puînée	
en garder sous la pédale	,course	
dire	,propos	
factrice	,courrier	
nationalisme	,nation	
suggérer	,suggestion	
Enfer	,damné	,damnée	
petit	,mère	;père	
instituteur	,élève	,élève	
couleur	,couleur	
éducation	,éducatrice	
coiffeur	,client	,cliente	
juger	,accusé	,accusée	
dette	,dette	;argent	
grands-parents	,petit-fils	,petite-fille	
lexique	,langue	
thermomètre	,température	
soutif	,poitrine	,seins	
dentiste	,patient	,patiente	,patient	,patiente	
se sucrer	,argent	
placard	,peau	
portée	,mère	
>>>	S_1^usual
montrer	,montreur	,montreuse	
couleur	,coiffeur	,coiffeuse	;coloriste	,coloriste	,coiffeur	,coiffeuse	;coloriste	,coloriste	
bus	,chauffeur	,conducteur	,conductrice	
étoilé	,ciel	
assister	,assistante	,assistant	
ambulance	,ambulancière	,ambulancier	
raccommoder	,raccommodeur	,raccommodeuse	
écrire	,écrivaine	,écrivain	
guitare	,guitariste	,guitariste	
tricherie	,tricheur	,tricheuse	
manier	,manieur	,manieuse	
brosser	,peintre	,peintre	
magie	,mage	;magicien	,magicienne	
ail	,cultivateur	,cultivatrice	
pâtisserie	,pâtissier	,pâtissière	
semoule	,semoulier	
volley-ball	;joueur	,joueuse	,volleyeur	,volleyeuse	
former	,formateur	,formatrice	
conseil	,conseiller	,conseillère	
pensionné	,pensionné	,pensionnée	
volaille	,aviculteur	,avicultrice	;éleveur	,éleveuse	
sardine	,sardinier	
questionner	,questionneur	,questionneuse	
commenter	,commentateur	,commentatrice	
chirurgie	,chirurgien	,chirurgienne	
découper	,découpeur	,découpeuse	
diagnostic	,diagnosticien	,diagnosticienne	,diagnostiqueur	,diagnostiqueuse	
espionner	,espion	,espionne	
poulet	,éleveur	,éleveuse	
opéra	,cantatrice	,chanteur	,chanteuse	
marathon	,marathonien	
défendre	,avocat	,avocate	,avocate	,avocat	
production	,producteur	,productrice	
sauce	,saucier	
maïs	,maïsiculteur	,maïsicultrice	
planer	,oiseau	
cultiver	,cultivateur	,cultivatrice	
consommation	,consommateur	,consommatrice	
cheval	,éleveur	,éleveuse	
secourir	,secouriste	
roman	,romancier	;romancière	
haricot	,cultivateur	,cultivatrice	
sauciflard	,charcutier	,charcutière	
fabriquer	,fabricant	,fabricante	
dépanner	,dépanneur	,dépanneuse	
surveiller	,surveillant	,surveillante	
navigation	,navigateur	
imagination	,imaginatif	,imaginative	
sculpter	,sculpteur	,sculptrice	,sculpteure	
bijouterie	,bijoutier	
ping-pong	,pongiste	,pongiste	
laisse	,chien	
malchance	,malchanceux	,malchanceuse	
autopsie	,médecin légiste	,médecin légiste	
traiter	,médecin	,médecin	;vétérinaire	,vétérinaire	;dentiste	,dentiste	
s’entêter	,têtu	,têtue	<entêté	,entêtée	
émigrer	,émigré	,émigrée	
apiculture	,apiculteur	,apicultrice	
karaté	,karatéka	,karatéka	,karatékate	
coiffer	,coiffeur	,coiffeuse	
gueuler	,gueulard	,gueularde	
piste	,disque	
habiller	,habilleur	,habilleuse	
carotte	,cultivateur	,cultivatrice	
aider	,aide	,aide	
enculer les mouches	,enculeur de mouches	
démonter	,démonteur	,démonteuse	
bœuf	,bouvier	;éleveur	,éleveuse	
papeterie	,papetier	
consommer	,consommateur	,consommatrice	
>>>	A_2
béton	,bétonné	
origine	,originaire	
agacer	,agacé	
conservation	,conservé	
inspirer	,inspiré	,inspiré	
vents	,à	
bague	,bagué	
habitation	,habité	
fracture	,fracturé	
livrer	,livrable	
éclairer	,éclairé	
angoisse	,angoissant	
consentir	,consenti	
devoir	,dû	
débat	,en	
tache	,taché	
surveiller	,surveillé	
concerner	,concerné	
exporter	,exporté	
air	,sur	
héliporter	,héliporté	
Enfer	,damné	
accusation	,visé	,en butte	
s’appauvrir	,appauvrissant	
supplément	,supplémentaire	
recouvrir	,recouvert	,recouvert	
agresser	,agressé	
consentement	,consenti	
miel	,mellifère	,mellifique	
pension	,pensionné	
plaisir	,plaisant	
défaite	,gagnant	;vainqueur	;victorieux	
rassurer	,rassuré	
barrer	,barré	
électricité	,électrique	
remplir	,rempli	
éducation	,éducateur	
gonfler	,gonflé	
savoir	,su	,su	
épreuve	,éprouvé	
intention	,intentionnel	
considérer	,considéré	
essouflant	,essouflé	
aéroporter	,aéroporté	
connaissance	,connu	
désespérer	,désespéré	
couleurs	,à	
profit	,profitable	
entretenir	,entretenu	
encombrer	,encombré	
parfumer	,parfumé	
se distraire	,distrayant	
antenne	,à	,sur	,en ondes	
étouffer	,étouffé	
préoccuper	,préoccupé	
employer	,employé	
tissu	,musculaire	
découragement	,décourageant	
occuper	,occupé	,occupé	
disputer	,disputé	
génération	,générateur	
éprouvé	,éprouvant	
exercer	,exercé	
observer	,observé	
électronique	,électronique	
raisonner	,raisonné	
chiffre	,chiffré	
considération	,considéré	
victoire	,vaincu	
éblouir	,ébloui	
>>>	S_0Pred
insuffisant	,insuffisance	
poli	,politesse	
amer	,amertume	,amertume	
mère	,maternité	
fantastique	,fantastique	
vertical	,verticalité	
autonome	,autonomie	
élastique	,élasticité	
lent	,lenteur	
toxique	,toxicité	
nu	,nudité	
fragile	,fragilité	
limpide	,limpidité	
neutre	,neutralité	
stable	,stabilité	
épais	,épaisseur	
comestible	,comestibilité	
victorieux	,victoire	
divers	,diversité	
indépendant	,indépendance	
doux	,douceur	,douceur	
décontracté	,décontraction	
propre	,propreté	,propreté	,propreté	
anonyme	,anonymat	
veuf	,veuvage	
gentil	,gentillesse	
clair	,clarté	
franc	,franchise	
innocent	,innocence	
naïf	,naïveté	
régulier	,régularité	
alcoolique	,alcoolisme	
méchant	,méchanceté	
solide	,solidité	,solidité	
ingrat	,ingratitude	
fertile	,fertilité	
possessif	,possessivité	
agile	,agilité	
aimable	,amabilité	
transpirant	,transpiration	
courageux	,courage	
chauve	,calvitie	
injuste	,injustice	
nécessaire	,nécessité	
possible	,possibilité	
distingué	,distinction	
traître	,trahison	
religieux	,religiosité	
inconscient	,inconscience	,inconscience	
objectif	,objectivité	
tenace	,tenacité	
marié	,mariage	
responsable	,responsabilité	
imbécile	,imbécillité	
mécontent	,mécontentement	
prudent	,prudence	
idéal	,idéalité	
vulgaire	,vulgarité	
zélé	,zèle	
similaire	,similarité	
timide	,timidité	
banal	,banalité	
chaud	,chaleur	
fou	,folie	
carré	,carré	,carré	
racé	,race	
délicat	,délicatesse	
discipliné	,discipline	
étroit	,étroitesse	
vaste	,vastitude	
>>>	S_1^prototyp
cravate	,drapeau	
alcoolisé	,alcool	
juger	,juge	;tribunal	
au torchon	,cuisson	;jambon	
se pelotonner	,chat	,chatte	
crottin	,cheval	
double	,fenêtre	
d’acier	;muscles	;muscles	
course	,coureur	,coureuse	;coureur	,coureuse	,pilote	
plateau	,légume	
foudroyer	,éclair	
pendule	,horloge	
nuage	,pluie	;neige	;grêle	,lait	;crème	,point	;mot	
parole	,locuteur	
passage	,texte	
fuir	,nuage	
versant	,colline	;montagne	;vallée	
dentifrice	,tube	;pâte	,gel	;poudre	,eau	,élixir	
amputé	,membre	
air	,opéra	
poignet	,chemise	,chemisier	
fusillade	,tireur	,tireuse	
brochette	,légume	,viande	
discothèque	,client	,cliente	
petit chien	,maman	
émetteur	,antenne	
éléments de langage	,communicant	
tour	,château	
s’allonger	,gueule	,mine	,tête	,tronche	,visage	
cloche	,chapeau	
pare-brise	,véhicule	
haut-parleur	,téléviseur	;radio	
ameublement	,pièce	;appartement	,maison	
fesse	,navire	
déplier	,membre	,membre	
braguette	,pantalon	
balayer	,tempête	,tornade	
cadran	,montre	
sonneur	,cloche	
pelouse	,parc	
mie	,pain	
gros dos	,chat	,chatte	
traverser	,pluie	
s’étirer	,chat	,chatte	
nageoire	,poisson	
abbaye	,religieuse	,religieux	
paupière	,judas	;œilleton	
seins	,femme	
fenêtre	,enveloppe	
galop	,cheval	
caserne	,pompier	
voile	,voilier	
rinçage	,lave-vaisselle	
apprendre	,enseignant	,enseignante	,professeur	,professeure	,instituteur	,institutrice	,maître	,maîtresse	;instructeur	,instructrice	;formateur	,formatrice	
en prendre un coup	,moral	
feuilleter	,livre	
avoir	,propriétaire	,propriétaire	
propre	,voiture	,transports	
bateau	,chaussures	;col	;lit	
dru	,neige	,pluie	
averse	,larme	
passerelle	,bateau	
tomber	,neige	,pluie	
foi	,croyant	,croyante	
soutien-gorge	,femme	
flaque	,eau	
paragraphe	,texte	
souffler	,vent	
corps	,professeur	,professeure	;enseignant	,enseignante	;fonctionnaire	,fonctionnaire	;médecin	,médecin	,état	,doctrine	;théorie	,vin	;liqueur	
messe	,prêtre	,curé	
>>>	Contr
nord	,sud	
première	,dernière	
numérique	,analogique	
grammaire	,lexique	
cuillère	,couteau	,fourchette	
hiver	,été	
orteils	,doigt	
simple	,double	
homologue	,analogue	,analogue	
maître	,esclave	
terre	,ciel	
chanter	,parler	
muscles	,graisse	
chiquer	,priser	
fesses	,seins	
pipi	,caca	
plaine	,colline	;vallée	
dernière	,première	
midi	,minuit	
tribord	,bâbord	
géométrie	,algèbre	
à gauche	,à droite	
éclair	,tonnerre	
ensuite	,d’abord	
distance	,proximité	
pipe	,cigare	;cigarette	
chaussons	,chaussures	
maritime	;aérien	
majuscule	,minuscule	
bâbord	,tribord	
sucer	,lécher	
tu	,je	
cuit	,cru	
obligation	,droit	
qualitatif	,quantitatif	
allié	,ennemi	
monologue	,dialogue	
Terre	,Soleil	
corps	,âme	,esprit	,bras	;jambes	;tête	,visage	,tête	
horizontale	,verticale	
droit	,obligation	,devoir	
fond	,haut	,sommet	,dessus	,forme	,surface	;plafond	,combles	,devant	,au premier plan	,surface	,apparence	,vitesse	,jour	
serviette	,torchon	
volé	,voleur	
lécher	,sucer	
dos	,poitrine	
demander	,répondre	
devoir	,droit	
dame	,demoiselle	
continent	;mer	;île	
baguette	,bâton	
eau	,glace	
république	,monarchie	
Corée du Nord	,Corée du Sud	
stratégique	,tactique	
d’abord	,enfin	,ensuite	,puis	
marin	;aérien	
rond	,carré	,carré	
muscle	,graisse	;nerf	
jouer	,chanter	
ange	,démon	
dialogue	,monologue	
théorie	,pratique	
thorax	;abdomen	;tête	,abdomen	
bruit	,silence	
pantalon	,jupe	
entre	,autour	
cave	,grenier	
ton	,mon	
visage	,corps	
>>>	Gener
avenue	,voie	
politique de l’autruche	,comportement	
verre	,matériau	,récipient	,boisson	
dialogue	,échange verbal	
narines	,orifice	;émonctoire	
dépression	,état	
violon	,instrument à cordes	
seau	,récipient	,quantité	
coup	,boisson	,son	
automobile	,secteur	
lapin	,animal	,viande	
mars	,mois	
guitoune	,abri	
horreur	,sentiment	
canal	,cours d’eau	
bouteille	,récipient	,récipient	,consommation	
monarque	,papillon	;insecte	,insectes	
plage	,activité	
boxeur	,sportif	
aviron	,sport	
pomme de terre	,légume	
poulette	,oiseau	
vachette	,bovin	
pois	,légume	,plante	
râteau	,outil	
ruminants	;animal	;animaux	,mammifères	
palabres	,échange verbal	
guitariste	,musicien	,musicien	,musicienne	
éloge	,discours	
Portugal	,pays	
prunier	,arbre	
coiffeur	,professionnel	;métier	,profession	
gousse	,fruit	
poisson	,animal	
fourche	,outil	
noyer	,arbre	
étang	,plan d’eau	
assassinat	,crime	
étalon	,animal	
jaune	,couleur	
flèche	,projectile	
cor	,instrument de musique	
cœur	,organe	,couleur	
abcès	,affection	
moto	,deux-roues	
poupée	,jouet	
juin	,mois	
Corse	,île	
répugnance	,sentiment	
cycliste	,vêtement	
table de nuit	,meuble	
prémolaire	,dent	;dent	
poiscaille	,animal	
tarte	,pâtisserie	
badinage	,échange verbal	
grande boucle	,compétition	;épreuve	
mayonnaise	,sauce	
turquoise	,gemme	
vache marine	,mammifères	
destructeur	,appareil	
lendemain	,jour	
escargots	,aliment	;plat	
bocal	,récipient	,lieu	
vache	,animal	;bovin	,viande	
éclair	,pâtisserie	
draisienne	,deux-roues	,deux-roues	
steeple	,épreuve	
cuirassé	,bateau	
ketchup	,sauce	
raie	,poisson	
>>>	S_loc
prisonnier	,prison	
haleine	,bouche	
camper	,camping	
se laver	,salle de bain	,salle de douche	,salle d’eau	
diable	,Enfer	
emprisonner	,prison	
lait	,seins	
cerise	,cerisier	
douche	;douche	,salle de douche	,salle de bain	
Belgique	,en	
cheval	;box	
noix	,noyer	
corail	,mer	
coiffeur	,salon	
poire	,poirier	
cadavre	,cercueil	,bière	
karaté	,tapis	,tatami	;dojo	,salle	
cigare	,bureau de tabac	,tabac	,débit de tabac	
cuisine	,cuisine	
amande	,amandier	
enterrer	,cimetière	
figure	,dans	,en plein	
villageoise	,village	
exemple	,exemplier	
baignoire	,salle de bain	
toilette	,salle de bain	,salle de douche	,cabinet de toilette	
nuage	,ciel	;horizon	
judo	,tapis	,tatami	;dojo	,salle	
entrer	,entrée	,entrée	
citadine	,ville	
banane	,bananier	
Occidental	,ouest	
thé	,théier	
lointain	,lointain	
course	,champ de course	
moustique	,marais	,mare	,marécage	
prune	,prunier	
Allemagne	,en	
orange	,oranger	
rivière	<lit	<piste	;champ de course	,stade	
éléphant de mer	,mer	
algue	,mer	
gazon	,pelouse	
boxeur	,ring	
sport	,salle	;terrain	;palais des sports	
olive	,olivier	
basket	,terrain	
noisette	,noisetier	
laver	,lavoir	,laverie	,buanderie	,buanderie	,lavomatique	,douche	,lavabos	,salle de bain	,salle d’eau	,salle de douche	
chaussures	,boîte	;meuble	
rugby	,terrain	;stade	
volley-ball	,terrain	
tennis	,court	,terrain	,tennis	
valises	,yeux	;visage	
corps	,caserne	
pompier	,caserne	,caserne	
corbeau	,nid	,nid	
sans domicile fixe	,rue	;rue	
gymnastique	,salle	;gymnase	,salle	;gymnase	
doucher	,douche	;salle de bain	,salle de douche	
fraise	,fraisier	
gendarme	,gendarmerie	
tabac	,plantation	,champ	,bureau de tabac	,débit de tabac	,tabac	
eau	,cours d’eau	
langue	,bouche	
cigarette	,bureau de tabac	,tabac	,débit de tabac	
raisin	,vigne	
cercueil	,tombe	,tombeau	
nager	,piscine	;cours d’eau	;étang	,lac	,mer	,océan	;piscine	
fleuve	<lit	
>>>	Cf
évier	,lavabo	
timbre	,son	,cloche	
bas	,chaussettes	
porte-monnaie	,portefeuille	
pluie	,nuage	
précaution	,prévention	
billet	,argent	
ici	,maintenant	
planche à pain	,poitrine	
patins	,chaussons	
centimètre	,mètre	
fleuve	,voie navigable	
arbre	,buisson	
gras	,graisse	
poêle	,casserole	
costume	,tailleur	
source	,eau	
poignet	,main	
disque	,rond	;plat	
talon	,pieds	
excréments	,urine	
placard	,cagibi	
tendon	,muscle	
fromage blanc	,yaourt	
fauteuil	,chaise	
store	,rideau	
ré	,do	,mi	,fa	,sol	,la	,si	
chacun	,chaque	
givre	,neige	
dizaine	,dix	
se lever	,s’asseoir	,se réveiller	
s’allonger	,s’asseoir	
mi	,do	,ré	,fa	,sol	,la	,si	
fa	,do	,ré	,mi	,sol	,la	,si	
serviette	,nappe	,tampon	
portée	,couvée	
grenouille	,crapaud	
gelée royale	,miel	
kilo	,gramme	,tonne	
payer	,subir	
direction	,destination	
souris	,rat	
tasse	,verre	,verre	
tisane	,thé	
feu	,fumée	
double	,triple	
diamant	,disque	
exécutable	,possible	
TER	,T.G.V.	
anniversaire	,fête	
averse	,orage	;ciel	
allumette	,briquet	
portefeuille	,porte-monnaie	
couché	,assis	,endormi	,assis	
chaise	,fauteuil	
testicule	,partie	
chevilles	,pieds	;mollets	
cœur	,carreau	
obstacle	,barrière	
avocat	,juriste	
moutarde	,ketchup	;mayonnaise	
mayonnaise	,ketchup	;moutarde	
mollets	,chevilles	
bourdon	,abeille	
marche	,course à pied	
éclair	,orage	
escargot	,limace	
aller	;avoir	,être	
soi	,moi	
xénophobie	,hostilité	;intolérance	
>>>	Mult
paysan	,paysannat	,paysannerie	
appareil	,appareillage	
seins	,poitrine	;paire	
oignon	,botte	
branche	,branchage	
bataille	,guerre	,conflit	
criminel	,bande	,gang	,mafia	,milieu	,pègre	
chiffon	,tas	
homme	,humanité	
verre	,bouteille	
patron	,patronat	
enveloppe	,paquet	
mât	,mâture	
ennemi	,ennemi	
marche	,escalier	,marches	
symptôme	,syndrome	
cigare	,boîte	
paysanne	,paysannat	,paysannerie	
comprimé	,boîte	
abeille	,colonie	,essaim	;horde	,nuage	,nuée	
sous-vêtement	,sous-vêtement	
voisin	,voisinage	
courrier	,courrier	
diamant	,rivière	
vache	,troupeau	;cheptel	
fauteuil	,rangée	
lettre	,correspondance	
chien	,horde	,meute	
musicien	,ensemble	,groupe	
ministre	,gouvernement	,ministère	,cabinet	
vents	,ensemble	
jumelle	,jumelles	
cliente	,clientèle	
cerise	,poignée	
employé	,personnel	
faux ami	,lexique	,vocabulaire	
rabbin	,rabbinat	
bœuf	,cheptel	;troupeau	;bétail	
carte	,jeu	
mouche	,nuage	,nuée	
chaussettes	,paire	
bandit	,bande	,gang	,horde	
oiseau	,volée	
clé	,trousseau	,jeu	
pétales	,corolle	
bateau	,flottille	,flotte	
arme	,armement	
muscle	,musculature	
ciseaux	,paire	
touche	,clavier	
chaise	,rangée	
corbeau	,bande	,colonie	;nuée	,bande	,colonie	;nuée	
pièce de vaisselle	,vaisselle	
nuage	,masse	,entassement	
os	,ossature	,squelette	
éléphant	,troupeau	
chèvre	,troupeau	
fruit	,grappe	
jambes	,paire	
assiette	,pile	
enfant	,enfance	
parent	,famille	
poussin	,couvée	
médicament	,pharmacopée	
gendarme	,gendarmerie	
fiche	,fichier	
lion	,bande	
fleur	,grappe	
sardine	,banc	
jour	,semaine	<mois	,mois	
>>>	Sing
sable	,grain	
averse	,goutte	
rabbinat	,rabbin	
volley-ball	,match	,partie	,volley-ball	<compétition	,tournoi	<championnat	
métro	,ligne	
ski	,championnat	,compétition	
billard	,jeu	,partie	
sauciflard	,rondelle	
appareillage	,appareil	
racaille	,racaille	
judo	,combat	<compétition	,tournoi	<championnat	
bouteille	,verre	
jogging	,jogging	
champagne	,verre	
boxe	<combat	,match	<compétition	,tournoi	<championnat	
mayo	,pot	
pain	,miette	<bout	,morceau	,tranche	
farine	;sac	
yaourt	,pot	,yaourt	<boîte	
titulature	,titre	
cheval	,compétition	
mayonnaise	,pot	
pelage	,poil	
membrure	,membre	
ping-pong	,match	,partie	,ping-pong	<compétition	,tournoi	
gymnastique	,séance	;gymnastique	,épreuve	<compétition	<championnat	
tennis	,match	,partie	,tennis	<compétition	,open	,tournoi	
armement	,arme	
klaxon	,coup	
neige	,flocons	;boule	
papier	,feuille	
humanité	,homme	
aviation	,avion	
dentition	,dent	
opéra	,air	
sport	,compétition	;tournoi	<championnat	
clientèle	,client	,cliente	
sucre	;grain	<cuillerée	,pincée	;morceau	,sucre	<pain	
mois	,semaine	<jour	
denture	,dent	
beurre	,noisette	,noix	;motte	
ennemi	,ennemi	
maladie	,crise	
raisin	,grain	
parc	,arbre	;pelouse	;allée	
mobiler	,meuble	
poivre	,grain	
glace	;glaçon	;bloc	
corolle	,pétales	
alcool	,verre	<bouteille	
rugby	,match	,partie	,rugby	<compétition	,tournoi	<championnat	
chemin de fer	,ligne	
rayonnage	,rayon	
chéquier	,chèque	
lentilles	,boîte	
bière	,bouteille	,verre	,bière	,canette	,chope	,demi	<pinte	
laser	,rayon	
groupe	,membre	
outillage	,outil	
terminologie	,terme	
crème	,pot	
marche	,marche	
riz	,grain	
cheveu	,cheveu	
pharmacopée	,médicament	
tramway	,ligne	
gâteau	,part	,tranche	
mâture	,mât	
flottille	,bateau	
branchage	,branche	
>>>	Syn_⊂^sex
inscrite	,inscrit	
ébéniste	,ébéniste	
petite amie	,petit ami	
avicultrice	,aviculteur	
interprète	,interprète	,interprète	
colérique	,colérique	
brune	,brun	
chienne	,chien	,chien	
pompière	,pompier	
contradictrice	,contradicteur	
étudiante	,étudiant	
marchande	,marchand	
timide	,timide	
pisseuse de copie	,pisseur de copie	
sinistrée	,sinistré	
aide	,aide	
pompier	,pompier	
consommatrice	,consommateur	
riche	,riche	
provocatrice	,provocateur	
footeuse	,footeux	
lectrice	,lecteur	
bodybuildeuse	,bodybuilder	
avocate	,avocat	,avocat	
meilleure	,meilleur	
panseuse	,panseur	
bouchère-charcutière	,boucher-charcutier	,boucher-charcutier	
défenseuse	,défenseur	,défenseur	,défenseur	
cyclotouriste	,cyclotouriste	
vaincue	,vaincu	
dictatrice	,dictateur	
universitaire	,universitaire	,universitaire	
patronne	,patron	,patron	
étourdie	,étourdi	
indiscrète	,indiscret	
sportive	,sportif	
passante	,passant	
pisse-copie	,pisse-copie	
électricienne	,électricien	
lexicographe	,lexicographe	
coupeuse de cheveux en quatre	,coupeur de cheveux en quatre	
promeneuse	,promeneur	
trieuse	,trieur	
casquettière	,casquettier	
messagère	,messager	
inspiratrice	,inspirateur	
cadette	,cadet	
documentariste	,documentariste	
reine	,roi	
pharmacienne	,pharmacien	
hôtesse	,hôte	
femme politique	,politique	,homme politique	
futée	,futé	
automobiliste	,automobiliste	
députée	,député	
étrangleuse	,étrangleur	
installatrice	,installateur	
sans-logis	,sans-logis	
percussionniste	,percussionniste	
chirurgienne	,chirurgien	
savonnière	,savonnier	
absente	,absent	
ingénieure	,ingénieur	
ravisseuse	,ravisseur	,ravisseur	
engagée	,engagé	,engagé	
participante	,participant	
crémière	,crémier	
boulangère	,boulanger	,boulanger	
cousine	,cousin	
manieuse	,manieur	
