>>>	Syn_∩
se gâter	,se détériorer	
vagabonde	,sans-abri	
bouchée de pain	,grand-chose	
justifié	,normal	
concombre	,cornichon	
charrier	,emporter	,se moquer	,faire marcher	,pousser	,exagérer	,pousser le bouchon trop loin	
champ sémantique	,champ lexical	
douleur	,mal	,plaie	
aiguillonner	,piquer	,piquer	,stimuler	,pousser	
tête de linotte	,étourdi	,étourdie	
électorat	,corps électoral	
angoisser	,hanter	,perturber	,tourmenter	;étouffer	
les yeux de la tête	,cher	
s’amasser	,s’accumuler	,s’amonceler	,s’entasser	
se fixer	,s’installer	,emménager	
boudoir	,biscuit cuillère	
en beauté	,comme il faut	,comme il faut	,beau	;soigné	
brillamment	,intelligemment	
jaunir	,blondir	,blondir	
pochetronne	,alcoolique	
préoccupant	,inquiétant	
en l’espace	,en l’éclair	;en	
larder	,cribler	;percer	,piquer	
doré	,miel	
grade	,corps	
doux	,sucré	,bon	,bienveillant	,agréable	
à toute vitesse	,à fond	,à toute pompe	
incandescent	,rouge	
s’annoncer	,arriver	
étendu	,vaste	,tendu	,généralisé	
sommeil	,bras de Morphée	;repos	,somnolence	,engourdissement	,mort	,repos éternel	
ne pas manger	,ne pas faire de mal à une mouche	
gagner	,atteindre	,emporter	
allergène	,allergisant	
casse-dalle	,casse-croûte	,sandwich	
vérification	,contrôle	
galoper	,trotter	,courir	
muscles	,puissance	,force	
ministère	,mandat	
réalisation	,création	
en avalanche	,soudainement	
bouc émissaire	,souffre-douleur	;victime	;martyr	
bénédiction	,autorisation	
blindé	,ivre	,saoul	,cuité	<bourré	,pinté	<beurré	,rond	,plein	,pété	,torché	,déchiré	,raide	,arraché	,cuirassé	,dur	,endurci	
bronzette	,baignade	
suite	,ensemble	,partie	
drame	,tragédie	,tragédie	
préjuger	,décider	
narcisse	,jonquille	
infirme	,handicapé	
>>>	S_0
téléphonique	,téléphone	
expérimentalement	,expérience	
prêter	,prêt	
malhonnête	,malhonnêteté	,malhonnêteté	
refroidir	,refroidissement	,refroidissement	
maternel	,mère	,mère	
rajouter	,rajout	
artistiquement	,art	
frire	,friture	
collégien	,collège	,collégien	,collégienne	
astral	,astre	
se détacher	,détachement	
sahélien	,Sahel	
jogger	,jogging	
nommer	,nomination	
lire	,lecture	
asiatique	,Asie	
ouvrier	,ouvrier	,ouvrière	
se réchauffer	,réchauffement	
marital	,mariage	,mari	
se tasser	,tassement	
anarchiste	,anarchiste	,anarchiste	
barométrique	,baromètre	
se détendre	,détente	,détente	
raccourcir	,raccourcissement	
banlieusard	,banlieue	
floral	,fleur	,fleur	
élever	,élévation	,élévation	,élevage	
se renverser	,renversement	
laver le cerveau	,lavage de cerveau	
péter	,pet	
mélanger	,mélange	
craindre	,crainte	
dormir	,somme	,sommeil	,sommeil	,léthargie	,torpeur	,sommeil	
abuser	,abus	
hollandais	,Hollande	,hollandais	
opératoire	,opération	
maltraiter	,maltraitance	
guetter	,guet	
explorer	,exploration	
dépenser	,dépense	
se baigner	,bain	
écraser	,écrasement	
exaspérer	,exaspération	
pardonner	,pardon	
circuler	,circulation	,circulation	
circulaire	,cercle	
félin	,félins	
balayer	,balayage	
se mélanger	,mélange	
>>>	A_2Perf
neiger	,enneigé	,neigeux	
pardonner	,pardonné	
enchanter	,enchanté	
garnir	,garni	
vider	,vidé	;vide	
gonfler	,gonflé	
afficher	,affiché	
habiller	,habillé	,habillé	
geler	,glacé	
indiquer	,indiqué	
déplacer	,déplacé	
installer	,installé	
étirer	,étiré	
autoriser	,autorisé	
renouveler	,nouveau	
aider	,aidé	
enregistrer	,enregistré	
entendre	,entendu	
abandonner	,abandonné	
amuser	,amusé	
incliner	,incliné	
ajouter	,ajouté	,ajouté	
appauvrir	,pauvre	
abonner	,abonné	
emprunter	,emprunté	
décourager	,découragé	
empoisonner	,empoisonné	
fonder	,fondé	,fondé	
retraitement	,retraité	
affaiblir	,affaibli	
soulager	,soulagé	
contrainte	,contraint	
engager	,engagé	
définir	,défini	
attacher	,attaché	
prénommer	,prénommé	
coudre	,cousu	
surprendre	,surpris	
brosser	,brossé	,brossé	
dégoûter	,dégoûté	
souligner	,souligné	
diplômer	,diplômé	
éplucher	,épluché	
plisser	,plissé	
trancher	,tranché	
clouer	,cloué	,cloué	,cloué	,cloué	
accentuer	,accentué	,accentué	,accentué	
réveiller	,réveillé	,réveillé	
accomplir	,accompli	
doubler	,doublé	
>>>	Anti
propreté	,saleté	
habile	,malhabile	
praticable	,impraticable	
mort	,naissance	
ouvert	,fermé	,fermé	
jeûner	,s’alimenter	
domestique	,sauvage	,sauvage	
tendreté	,dureté	
efficace	,inefficace	
exporté	,importé	
respirable	,irrespirable	
éloigné	,proche	,proche	,proche	,proche	
imaginable	,inimaginable	
se connecter	,se déconnecter	
innocent	,coupable	
rare	,fréquent	
majuscule	,minuscule	
inintéressant	,intéressant	
avance	,retard	
quelque part	,nulle part	
irrespirable	,respirable	
indiscrétion	,discrétion	
invraisemblable	,vraisemblable	
goûteux	,insipide	
vrai	,faux	,faux	
bénéficiaire	,déficitaire	
occupé	,inoccupé	,libre	,inoccupé	
ouvrir	,fermer	,fermer	,fermer	,fermer	,fermer	,fermer	,fermer	
digne	,indigne	,indigne	
mineur	,majeur	,majeur	,majeur	
accrocher	,décrocher	
gouvernable	,ingouvernable	
ordinaire	,extraordinaire	
avantage	,désavantage	,inconvénient	
inconscience	,conscience	,conscience	
gentille	,méchante	
déshabiller	,habiller	
brancher	,débrancher	
sain	,malsain	
debout	,assis	,couché	
proue	,poupe	
ne pas se faire que des ennemis	,ne pas se faire que des amis	
amateur	,professionnel	
centripète	,centrifuge	
désactiver	,activer	
antimatière	,matière ordinaire	
personne	,quelqu’un	
terrienne	,extraterrestre	
finissant	,commençant	
faible	,fort	
>>>	S_res
test	,résultat	
abonner	,abonnement	
se brûler	,brûlure	
orienter	,orientation	
juger	,jugement	
abonnement	,abonnement	
cadrer	,cadre	;photographie	,prise de vue	,cadre	
écrire	,écriture	
éplucher	,épluchure	
trouer	,trou	
ranger	,rang	,rangée	
ioniser	,ion	,anion	,cation	
compétition	,résultat	
muscler	,muscles	
entassement	,entassement	,entassement	,entassement	,entassement	
aimer	,sexe	
s’éprendre	,amour	
effort	,résultat	
réaliser	,réalisation	
écarter	,écart	,écart	
mesure	,mesure	;résultat	
enrouler	,enroulement	
entasser	,entassement	,entassement	
souffler	,souffle	
pluie	,eau	
vieillir	,vieillesse	
lever de soleil	,jour	
maquette	,maquette	
décalage	,décalage	
dessiner	,dessin	;figure	
se fracturer	,fracture	
division	,quotient	;résultat	
s’ioniser	,ion	,anion	,cation	
humilier	,humiliation	
blesser	,blessure	
soustraction	;différence	;résultat	
encadrer	,encadrement	
politique	,fruit	,résultat	
laver	,lavis	,aquarelle	,lavis	
s’affaiblir	,faiblesse	
match	,résultat	
infecter	,infection	
se décourager	,découragement	
tomate	,tomate	
bilan	,bilan	;compte de bilan	,bilan	
collectionner	,collection	
enfermer	,enfermement	
arranger	,arrangement	,arrangement	
sondage	,résultat	
constater	,constat	
>>>	Syn_⊃
pistolet	,revolver	
pyramide	,pyramide	;pyramide	
énoncé	,paroles	
cigare	,havane	,barreau de chaise	;cigarillo	
ressemblance	,point commun	
nourriture	,aliment	
panier	,corbeille	
tourne-disque	,mange-disque	
étagère	,bibliothèque	
mouvement	,mouvement social	
bouffer	,déjeuner	;dîner	;goûter	;petit-déjeuner	;souper	;dévorer	
quarante	,quarantaine	
en-cas	,goûter	
truc	,objet	
voir	,apercevoir	,revoir	
ancien	,vieillard	;croulant	
location	,crédit-bail	
mort	,décédé	,défunt	;abattu	
acquitter	,solder	
chasser	,lever	
taille	,longueur	;taille	
coup	,coup de poing	,patate	
casser sa pipe	,passer l’arme à gauche	,s’éteindre	,succomber	
affrontement	,bras de fer	,épreuve de force	
tuer	,aplatir	
rose	,fuchsia	,rose fuchsia	;rose pivoine	,fuchsia	,rose fuchsia	;rose pivoine	
voiture	,berline	,break	,coupé	;casserole	,berline	,break	,calèche	,carrosse	,coche	,diligence	,coupé	,sulky	,tilbury	;fiacre	;carriole	,chariot	,charrette	,tombereau	
chapelet	,rosaire	
échangeable	,fongible	
célibataire	,mère célibataire	,fille mère	
chanteur	,choriste	
voyou	,loubard	
montrer	,dévoiler	
engagement	,serment	
élément	,élément	
règle	,réglette	
zob	,cigare	,phallus	
tabac	,cigarette	;pipe	;cigare	
émotion	,émotion	
tout le monde	,tout ce beau monde	
ouvert	,bée	
ami	,petit ami	
plante	,plante verte	,plante des pieds	
unité de mesure	,centimètre	,mètre	,kilomètre	;gramme	,livre	,kilogramme	,tonne	
encadrement	,cadre	
pine	,cigare	,phallus	
graisse	,gras	
musique	,musique	
deuxième	,second	
praticable	,carrossable	
>>>	S_1
éthylique	,alcool	
terrasse	,appartement	,maison	
farouche	,animal	
alcool	,alcool	,alcoolique	,alcoolique	,alcoolo	,alcoolo	
observer	,observateur	,observatrice	
Amérique	,Amérique	
héritage	,héritier	,héritière	
obstiné	,obstiné	,obstinée	
teinté	,vitre	,verre	;lunettes	
époux	,épouse	,femme	
cyclisme	,cycliste	,cycliste	
ralenti	,véhicule	
garantir	,garant	,garante	
infrarouge	,rayon	
pièce	,écu	
ensoleiller	,soleil	
signifier	,signe	
achat	,acheteuse	,acheteur	
lavage	,machine	,lave-linge	
boisé	,bois	
recul	,arme	
phobie	,phobique	,phobique	
Irlande	,Irlande	
épluchure	,fruit	,légume	
interpeler	,policier	,policière	
putschiste	,putschiste	
arnaquer	,arnaqueur	,arnaqueuse	
courir	,coureur	,coureuse	,coureur	,bruit	,nouvelle	,rumeur	;buzz	,coureur	,coureuse	
lieu de travail	,travailleur	
lecture	,lecteur	,lectrice	
foire	,vendeur	
éduquer	,éducateur	,éducatrice	
clapier	,lapin	
plage arrière	,véhicule	,navire	
rêve	,rêveur	,rêveuse	
linguistique	,linguiste	,linguiste	
islam	,musulman	,musulmane	
empoté	,empoté	
cricoïde	,cartilage	
lancer	,lanceur	,lanceuse	
voyage	,voyageur	,voyageuse	
obsédé	,obsédé	
archéologie	,archéologue	
bombarder	,bombardier	
contredire	,contradicteur	,contradictrice	
Incarnation	,Dieu	
sans-gêne	,sans-gêne	
chien	,maître	,maîtresse	;propriétaire	,propriétaire	,arme à feu	,tarot	
bénévolat	,bénévole	,bénévole	
foyer	,séisme	
>>>	Conv_21
au-dessous	,au-dessus	
s’agacer	,agacer	
expliquer	,s’expliquer	
craindre	,effrayer	
s’appliquer	,appliquer	
créancière	,débitrice	
aîné	,cadet	
angoisser	,angoisser	,angoisser	
antérieur	,postérieur	
appauvrissement	,appauvrissement	,appauvrissement	
aller	,avoir	
cause	,conséquence	,effet	,résultat	
colorer	,se colorer	
avoir	,aller	,partir	
alors	,car	
alimenter	,marcher	
à gauche	,à droite	
occuper	,s’occuper	
accueillir	,se trouver	
toucher	,connaître	
se composer	,composer	
se passionner	,passionner	
connaître	,toucher	
causer	,résulter	,tenir	
ébahir	,s’ébahir	
couvrir	,se couvrir	
intéresser	,s’intéresser	
au-dessus	,au-dessous	
déprimer	,déprimer	,déprimer	
creusé	,creusé	,creusé	
cadet	,aîné	
résulter	,causer	
posséder	,appartenir	
créancier	,débiteur	
amuser	,s’amuser	
s’inquiéter	,inquiéter	
devant	,derrière	
tenir à cœur	,tenir à cœur	,tenir à cœur	
se laisser bouffer	,manger la laine sur le dos	
se rappeler	,revenir	
derrière	,devant	
alarmer	,s’alarmer	
affaiblir	,s’affaiblir	
s’affoler	,affoler	
se coucher	,coucher	,coucher	,coucher	,coucher	
retentir	,retentir	,retentir	
se désespérer	,désespérer	
s’expliquer	,expliquer	
inquiéter	,s’inquiéter	
passionner	,se passionner	
>>>	A_0
électriquement	,électrique	
Arctique	,arctique	
hypnotisme	,hypnotique	
textile	,textile	,textile	
créer	,créateur	
direction	,directeur	
aéroport	,aéroportuaire	
synagogue	,synagogal	
compatir	,compassionnel	
compétition	,compétitif	
ONU	,onusien	
récemment	,récent	
rouge	,rouge	,rouge	
gris	,gris	
rage	,rabique	
population	,populationnel	
corail	,corallien	
gracieusement	,gracieux	
filialement	,filial	
contrôle	,contrôlant	
torrent	,torrentiel	,torrentiel	
chair	,charnel	
océan	,océane	,océanique	
impec	,impeccable	,impec	
rockeuse	,rockeur	
étoile	,stellaire	
corps à corps	,corps à corps	
tempête	,tempétueux	
informatiquement	,informatique	
tutelle	,tutélaire	
héroïquement	,héroïque	
religion	,religieux	
racine	,racinaire	
internationalement	,international	
fête	,festif	
insulter	,insultant	
Lune	,lunaire	
France	,français	
contester	,contestataire	
sévèrement	,sévère	
médecine	,médical	
probablement	,probable	
Angliche	,angliche	
grec	,grec	
aéroporter	,aéroporté	
huître	,huîtrier	
pénitencier	,pénitentiaire	
gratuitement	,gratuit	
dos	,dorsal	
félins	,félin	
>>>	Able_1
jouer	,joueur	
compensation	,compensatoire	
soupçonner	,soupçonneux	
chinois	,sinophone	
distinguer	,distinctif	
blague	,blagueur	
se soumettre	,soumis	
questionner	,questionneur	
mordre	,mordeur	
dormir	,somnolent	
perturber	,perturbant	,perturbant	
espagnol	,hispanophone	
ébahir	,ébahissant	
éruption	,éruptif	
coopérer	,coopératif	
tempête	,exposé	
épouvanter	,épouvantable	
réagir	,réactif	
obéir	,obéissant	
exiger	,exigeant	
étouffer	,étouffant	
autorité	,autoritaire	
tolérer	,tolérant	
se casser	,cassant	
portugais	,lusophone	
phobie	,phobique	
frousse	,froussard	
craindre	,craintif	
s’évaporer	,évaporable	
en imposer	,imposant	
changer	,changeant	
s’emporter	,coléreux	,colérique	,soupe au lait	
voler	,volant	
coopération	,coopératif	
créer	,créatif	
flatter	,flatteur	
tracasser	,tracassier	
partager	,partageur	
calcul	,calculateur	
écœurer	,écœurant	
malade	,maladif	
bavarder	,bavard	
rouler	,roulant	
accélérer	,accélérateur	
pleurer	,pleureur	
cogner	,cogneur	
crier	,criard	
rudoyer	,rude	
service	,serviable	
crainte	,craintif	
>>>	Able_2
améliorer	,améliorable	
évaluer	,évaluable	
attirer	,attirable	
contestation	,contestable	
mesurer	,mesurable	
gouverner	,gouvernable	
mépriser	,méprisable	
somme	,sommable	
organiser	,organisable	
utiliser	,utilisable	
éduquer	,éducable	
constatation	,constatable	
reproduire	,reproductible	
connaître	,connaissable	
élire	,éligible	
tolérer	,tolérable	
vaccin	,vaccinable	
importer	,importable	
allonger	,allongeable	
prévoir	,prévisible	
modifier	,modifiable	
annuler	,annulable	
calculer	,calculable	
digérer	,digérable	
raccommoder	,raccommodable	
déduire	,déductible	
cafard	,cafardeux	
influencer	,influençable	
régler	,réglable	
recommander	,recommandable	
composer	,composable	
trouver	,trouvable	
débit	,débitable	
agacement	,agaçant	
déterminer	,déterminable	
détacher	,détachable	
accepter	,acceptable	
éviter	,évitable	
raconter	,racontable	
rembourser	,remboursable	
adapter	,adaptable	
traverser	,traversable	
accès	,accessible	
multiplier	,multipliable	
nier	,niable	
exploiter	,exploitable	
supposer	,supposable	
dater	,datable	
incliner	,inclinable	
compréhension	,compréhensible	
>>>	Anti_∩
écourter	,allonger	,prolonger	
hypocritement	,franchement	
retrouvé	,perdu	
obscurité	,clarté	
confiance	,méfiance	
baisser	,lever	,lever	
aventureux	,prudent	
seins	,faux seins	
tracassier	,arrangeant	
courant	,rare	
robustesse	,fragilité	
local	,national	
supporter	,ennemi	
sommeil	,vigilance	
ressembler	,différer	,correspondre	,différer	
diminuer	,s’allonger	,s’allonger	,s’allonger	,rétrécir	,grandir	,s’allonger	,s’allonger	,rallonger	,agrandir	,rallonger	,étirer	;élargir	,allonger	,rallonger	,allonger	
intelligent	,bête	,idiot	
relever le gant	,abandonner	,baisser les bras	,jeter l’éponge	,laisser tomber	
sac	,valise	
relever ses manches	,baisser les bras	
aux pièces	,au mois	
ancienneté	,nouveauté	
matinal	,tardif	
combatif	,résigné	
s’envoler	,se poser	
ferme	,mou	
gaz	,liquide	,solide	
nettoyer	,salir	
grinçant	,silencieux	
inclinable	,fixe	
porte de prison	,joyeux drille	,joyeux vivant	
nouveau	,ancien	;vieux	,ancien	
se lever	,se coucher	,se pioncer	,se pieuter	,s’abaisser	,s’abaisser	
coup d’éclat	,coup d’épée dans l’eau	
clocher	,se tenir	,tenir la route	
angoissant	,rassurant	
attentif	,distrait	
technique	,courant	
élargir	,diminuer	
tardivement	,tôt	,vite	
malheureux	,bienheureux	
rassuré	,inquiet	
se replier	,se déplier	,s’allonger	
exonérer	,taxer	
peu	,très	,bien	
beau temps	,pluie	
apparent	,latent	
éloge	,blâme	,reproche	,critique	
partageur	,égoïste	
glacé	,brûlant	,mat	
>>>	Real_1
verrou	,mettre	
voie	,passer	,emprunter	,prendre	,faire	;grimper	,gravir	
chien	,avoir	,posséder	
urine	,uriner	,pisser	
cravate	,avoir	,porter	;porter	;arborer	
atmosphère	,respirer	
disque	,lancer	
claque	,donner	,mettre	
chemin de fer	,emprunter	,prendre	,utiliser	
bus	,conduire	
plateau	,porter	;apporter	,transporter	,manger	
appartement	,habiter	,résider	,vivre	,loger	,occuper	
gifle	,donner	,mettre	,donner	
soif	,étancher	
car	,conduire	
jogging	,avoir	,porter	
mobylette	,rouler	
toasteur	,toaster	
expérience	,expérimenter	,expérimenter	
courriel	,adresser	,envoyer	,utiliser	,se servir	;communiquer	
pioche	,piocher	
placard	,remplir	,afficher	,apposer	,coller	,placarder	,afficher	,apposer	,distribuer	
étagère	,garnir	,remplir	<surcharger	,garnir	,remplir	<surcharger	
bière	,boire	,consommer	,boire	,consommer	
pull	,avoir	,porter	
tarot	,jouer	
exemple	,exemplifier	
paupières	,abaisser	,baisser	<fermer	
robe	,avoir	,porter	,porter	
métro	,prendre	,emprunter	,prendre	,utiliser	
abeilles	,élever	
parfum	,porter	
orbite	,décrire	,orbiter	
protection hygiénique	,avoir	,porter	
jour	,éclairer	
chaussures	,avoir	,porter	
narines	,respirer	;inspirer	;expirer	
assiette	,manger	
dette	;honorer	,régler	;acquitter	,payer	
marche arrière	,passer	
cyclisme	,pratiquer	
quarantaine	,respecter	
cheval	,manger	
musée	,visiter	
air	,aspirer	,respirer	,jouer	,siffler	,fredonner	,chantonner	,chanter	
couvercle	,mettre	
chat	,avoir	,posséder	,jouer	
fesses	,s’asseoir	
bifteck	,manger	,gagner	
punaise	,enfoncer	;punaiser	
>>>	V_0
lever	,se lever	,se lever	,lever	
réparation	,réparer	
capture	,capturer	
regret	,regretter	,regretter	,regretter	
portée	,porter	
tordu	,tordre	
rot	,roter	
expérimentation	,expérimenter	
mise en garde	,mettre en garde	
résultat	,résulter	
tabac	,fumer	
illustration	,illustrer	
formation	,se former	,former	
énervé	,avoir les abeilles	
grignotage	,grignoter	
inscription	,inscrire	,inscrire	
émigration	,émigrer	
concentration	,concentrer	,se concentrer	,se concentrer	
surveillance	,surveiller	
résistance	,résister	
gonflement	,gonfler	,gonfler	
désintérêt	,désintéresser	,se désintéresser	
indignation	,s’indigner	
exportation	,exporter	
tentation	,tenter	
enlaidissement	,enlaidir	,s’enlaidir	
gravure	,graver	
génération	,générer	
retour	,retourner	
crâneur	,crâner	
rougissement	,rougir	,rougir	,rougir	
dégagement	,dégager	
support	,supporter	
danse	,danser	
ouvert	,ouvrir	
simplifiable	,simplifier	
fête	,fêter	
jeûne	,jeûner	
puanteur	,puer	
klaxon	,klaxonner	
coopération	,coopérer	
étranglement	,étrangler	
encouragement	,encourager	,encourager	
exagération	,exagérer	,exagérer	
désolé	,se désoler	,désoler	
règlement	,régler	,régler	
inondation	,inonder	
dévoration	,dévorer	,dévorer	
gifle	,gifler	
franchissement	,franchir	
>>>	S_3
combat	,sport de combat	
compte	,banque	
envoi	,destinataire	,destinataire	
baser	,base	
différence	,différence	
fusil	,projectile	,balle	,plomb	
décharger	,chargement	
service	,restaurant	
colis	,destinataire	,destinataire	
unanimité	,élection	;vote	
addition	,client	,cliente	
chèque	,bénéficiaire	,bénéficiaire	;porteur	
somme	,somme	
tailler	,vêtement	
criminel	,victime	
restaurant	,clientèle	;client	,cliente	
conversation	,sujet	,thème	
malade	,partie du corps	,maladie	,maladie	
courriel	,contenu	
honneur	,honneur	
diriger	,direction	
cirer	,cire	
analogie	,analogie	,point commun	
victoire	,bataille	;guerre	
bandit	,victime	
mesure	,mesure	,mesure	
mairie	,administré	,administrée	
compenser	,compensation	
nommer	,nom	;prénom	,nom	
se lier	,molécule	
hypermarché	,client	,cliente	,clientèle	
procès	,affaire	
touche	,tournoi	
marche	,auditeur	,auditrice	
expédier	,destinataire	,destinataire	
consolation	,consolation	
appareiller	,appareil	
cuir	,article	
coiffer	,coiffure	
dater	,date	,datage	
récompense	,récompense	
louange	,louange	
bagage	,domaine	,discipline	
vocabulaire	,langue	
numéroter	,numéro	
visser	,vis	
racket	,victime	
arnaquer	,arnaque	
similarité	,similarité	,point commun	
voter	,élection	
>>>	A_1
effroi	,effrayé	
hétérosexuel	,hétérosexuel	
ruse	,rusé	
bizarrerie	,bizarre	
rhumatisme	,rhumatisant	
imminence	,imminent	
désordre	,en	,désordonné	
imagination	,imaginatif	
flocon	,en	
suffire	,suffisant	
s’appuyer	,appuyé	
se disposer	,disposé	
bâtard	,bâtard	
gris	,gris	
meuble	,meuble	
migraine	,migraineux	
route	,en route	
protestantisme	,protestant	
conclusion	,conclusif	
pessimisme	,pessimiste	
dignité	,digne	
se confronter	,confronté	
mûrir	,mûrissant	
favoriser	,favorable	
ne tenir qu’à un cheveu	,fragile	
âge	,âgé	,âgé	,âgé	
angle	,anguleux	
se divertir	,divertissant	
folie	,fou	,fou	
triangle	,en	
précéder	,précédent	
déplacement	,en	,en	
discontinuité	,discontinu	
paralysé	,paralytique	
bagage	,muni	,avec	
se former	,formé	
se résigner	,résigné	
extravagant	,extravagant	
sommeil	,endormi	,endormi	
grâce	,gracieux	
pencher	,penché	
fécondité	,fécond	
essentiel	,essentiel	
air	,dans	
sexe	,sexué	
trébuchement	,trébuchant	
protection	,protecteur	
affoler	,affolant	
Espagnol	,espagnol	
polluer	,polluant	,pollueur	
>>>	S_2^prototyp
chaussette	,café	;thé	,hydrocarbure	
tube	,pâte	
détourner	,regard	
hold-up	,banque	;bijouterie	;magasin	
rivière	,steeple	
noyer	,chagrin	
verrou	,porte	
forme	,chaussures	,chapeau	,pain	,fromage	,sucre	
porter	,vêtement	;pièce d’habillement	
boulangère	,pain	;viennoiserie	
filet	,tennis	
réserviste	,armée	,police	
colis abandonné	,train	
diète	,médecin	,médecin	,docteur	,doctoresse	,docteure	
simplification	,fraction	,expression	
baguette	,bois	
rideau	,fenêtre	,porte	
gauche	,cœur	
tablette	,chocolat	
fond de volaille	,sauce	
user ses fonds de culotte	,école	
enveloppe	,lettre	,document	
peindre	,peinture	
escalade	,montagne	;rocher	,col	,côte	
téléphone	,répondant	,répondante	
design	,meuble	;site	
tuile	,amande	
simplifier	,expression	,fraction	
lin	,huile	;huile	
main droite	,instrument de musique	
rafraîchir	,cheveu	,cheveux	
toilette	,porc	,veau	
prier	,Dieu	
conducteur	,voiture	,véhicule	,automobile	,moto	,auto	,autobus	,autocar	,bus	,camion	,car	,métro	,train	,tramway	
contracter	,muscle	
ceinture	,pantalon	,jupe	,robe	,manteau	,véhicule	,agglomération	
poitrine	,bœuf	,porc	,veau	,mouton	;poulet	,canard	,volaille	
symptomatique	,maladie	
assise	,siège	
personne	,âgé	,seul	
élément	,société	,armée	
nez	,fruit	,fruit rouge	,cerise	,framboise	;épice	
éplucher	,document	
placarder	,avis	,affiche	
écran	,film	
fumeuse	,cigare	,cigarette	,pipe	;tabac	
culture	,plante	
baguettes	,riz	
vider	,poisson	,volaille	
amarre	,bateau	
>>>	Syn_⊃^sex
mal-aimé	,mal-aimée	
maïsiculteur	,maïsicultrice	
imprimeur	,imprimeuse	
lycéen	,lycéenne	
accusé	,accusée	
kidnappé	,kidnappée	
concierge	,concierge	
historien	,historienne	
emmerdeuse	,emmerdeur	
rat	,rate	
légiste	,légiste	
citateur	,citatrice	
ennemi	,ennemie	,ennemie	
arrivant	,arrivante	
Français	,Française	
médecin	,médecin	,femme médecin	
participant	,participante	
agriculteur	,agricultrice	
russophone	,russophone	
menuisier	,menuisière	
vêto	,véto	
raté	,ratée	
chef de bord	,chef de bord	
parachutiste	,parachutiste	
allié	,alliée	
mécanicien	,mécanicienne	,mécanicienne	,mécanicienne	
bénéficiaire	,bénéficiaire	
prévisionniste	,prévisionniste	
défenseur	,défenseuse	,défenseuse	,défenseuse	
rameur	,rameuse	
rabat-joie	,rabat-joie	
prêteur	,prêteuse	
adopté	,adoptée	
graveur	,graveuse	
gâcheur	,gâcheuse	
donneur	,donneuse	
cancéreux	,cancéreuse	
thésard	,thésarde	
médicastre	,médicastre	
barman	,barmaid	
boucher	,bouchère	,bouchère	
xénophobe	,xénophobe	
noyé	,noyée	
organisateur	,organisatrice	
ajusteur	,ajusteuse	
commentateur	,commentatrice	
merle	,merlette	
actionnaire	,actionnaire	
puîné	,puînée	
défunt	,défunte	
>>>	Adv_0
vulgaire	,vulgairement	
délicieux	,délicieusement	
certain	,certainement	
brutal	,brutalement	
innocence	,innocemment	
temporel	,temporellement	
sain	,sainement	
assurer	,assurément	
urgent	,urgemment	
fond	,foncièrement	,en	,foncièrement	,profondément	,en	
supplément	,supplémentairement	
nation	,nationalement	
général	,généralement	
logique	,logiquement	
amical	,amicalement	
torrentiel	,torrentiellement	
matin	,matinalement	
cérébral	,cérébralement	
évident	,évidemment	
bête	,bêtement	
intuition	,intuitivement	
synthétique	,synthétiquement	
confidentiel	,confidentiellement	
infini	,infiniment	
ingrat	,ingratement	
fier	,fièrement	
région	,régionalement	
étrange	,étrangement	
atroce	,atrocement	
obligatoire	,obligatoirement	
hebdomadaire	,hebdomadairement	
fréquent	,fréquemment	
physique	,physiquement	,physiquement	
tardif	,tard	
épouvantable	,épouvantablement	,épouvantablement	
courant	,couramment	
quotidien	,quotidiennement	
haut	,haut	
excellent	,excellemment	
odieux	,odieusement	
lâche	,lâchement	
similaire	,similairement	
formel	,formellement	,formellement	,formellement	,formellement	
impertinent	,impertinemment	,impertinemment	
malhonnête	,malhonnêtement	
sympathie	,sympathiquement	
normal	,normalement	
molécule	,moléculairement	
danger	,dangereusement	
scandale	,scandaleusement	
>>>	S_instr
matraquer	,matraque	
skier	,skis	
triangle	,baguettes	
radio	,radio	
imaginer	,imagination	
se moucher	,mouchoir	;doigt	
entendre	,oreilles	
bain	,baignoire	
articuler	,articulateur	
piquer	,seringue	
allaiter	,seins	
coiffeur	,ciseaux	;brosse	,peigne	;sèche-cheveux	
mesure	,mètre	,règle	;instrument de mesure	
respirer	,nez	,narines	,narine	
musique	,instrument de musique	,instrument de musique	,instrument de musique	
zapper	,télécommande	
dormir	,lit	
renifler	,nez	;nez	
voiture	,voiture	
chanter	,corde vocale	,larynx	,larynx	,corde vocale	
sentir	,nez	;nez	
faire de l’essence	,pompe	
douche	,douche	;fleur de douche	
observer	,microscope	,loupe	,lunette	
harnacher	,harnais	
plage	;parasol	,paillasse	,tapis de plage	;maillot	,serviette	;bouée	,palmes	,masque	,tuba	
orchestre	,instrument de musique	
bêcher	,bêche	
sucer	,bouche	,lèvres	,bouche	
toilette	,gant de toilette	,linge	,objet	,parure	;gel douche	,produit	,savon	;affaires	,nécessaire	
coup de poing	,coup de poing	
pieuter	,lit	,pieu	,paddock	,pageot	
vol	,avion	
tout oreilles	,oreilles	
chant	,larynx	,corde vocale	
donner le sein	,seins	
coudre	,dé à coudre	;machine à coudre	,machine à coudre	
s’éventer	,éventail	
voyager	,avion	,autocar	,train	,voiture	
crime	,arme	
se laver	,lavabo	,baignoire	,douche	;savon	,gel douche	
trajet	,bus	,tramway	
tennis	,balle	;raquette	;filet	
cirer	,cire	,cirage	
hold-up	,arme	
badminton	,volant	;raquette	
mécanicienne	,outil	
médecin	,stéthoscope	,stéthoscope	
dentiste	,davier	;fraise	;roulette	,davier	;fraise	;roulette	
ski	;bâton	;chaussures	;skis	
>>>	Syn_⊂
décote	,abattement	,baisse	
pattes de mouche	,écriture	
truand	,criminel	;malfaiteur	,malfrat	
verdâtre	,vert	
cheptel	,troupeau	
rechercher	,chercher	
charrette	,voiture	
huile	,corps gras	
relire	,lire	
corsaire	,pantalon	
microscope	,instrument	
japper	,aboyer	
symptôme	,manifestation	;indication	,manifestation	;indication	
beau monde	,gens	
retordre	,tordre	
accuser le coup	,subir	,subir	
lisse	,barre	
accoupler	,réunir	
bled	,village	
nageoter	,nager	
repasser	,passer	
jusqu’aux oreilles	,complètement	
gras	,graisse	
se dire	,dire	
tacher	,salir	,salir	
évènement historique	,évènement	
foule	,ensemble de personnes	
entourer	,choyer	
rouler	,se déplacer	,déplacer	,faire	,fonctionner	,se déplacer	,se déplacer	
réaction physique	,réaction	
frayeur	,peur	
taux de change	,cours	
mécanicienne	,conductrice	;machiniste	
ondée	,averse	
reporter	,journaliste	,journaliste	
capitaux propres	,valeur comptable	
patio	,cour	
capital-risque	,financement	
trésorerie	,administration	,argent	
accélérer	,se déplacer	
du gâteau	,facile	
convention	,accord	
faire route	,se déplacer	
fait main	,cousu main	
annexe	,document	
Boche	,Allemand	,Allemande	
bicross	,vélo	
volte-face	,changement	
se surveiller	,faire attention	
calèche	,voiture	
>>>	Syn
préparation	,préparation alimentaire	
kidnapping	,kidnappage	
gaz	,vent	,flatuosité	
kilo	,kilogramme	
montre	,tocante	
sépulcre	,tombeau	
gratte	,guitare	
cravate de chanvre	,corde	
bouffer la soupe sur la tête	,manger la soupe sur la tête	
coco	,communiste	,rouge	,communiste	,rouge	,communiste	,rouge	,communiste	,rouge	,noix de coco	,cocotier	
babines	,lèvres	
ado	,adolescent	,adolescente	
boîte aux lettres	,boîte à lettres	,boîte mail	,boîte à lettres	
au petit bonheur	,au petit bonheur la chance	
zizique	,musique	,zique	
bol	,bolée	,chatte	,cul	,chance	,pot	
hétéro	,hétérosexuel	,hétérosexuelle	
actif net comptable	,capitaux propres	
treize	,XIII	,XIII	
arrêt	,arrestation	
se rappeler	,se souvenir	
charcutier	,boucher	
éveil	,veille	,réveil	
maison centrale	,centrale	
sans-logis	,sans-abri	,sans-abri	
bouffer la grenouille	,manger la grenouille	
sain	,sainement	
collaborateur	,collabo	
Ceci dit	,maintenant	,après	
OPE	,offre publique d’échange	
labourage	,labour	
toilettage	,toilette	
maintenant	,de nos jours	,Ceci dit	,après	
faire piètre figure	,faire mauvaise figure	,faire triste figure	,faire pâle figure	
rouler	,enrouler	,marcher	,tourner	,rouler dans la farine	
génitrice	,procréatrice	
amuse-gueule	,amuse-bouche	
l’air de rien	,sans en avoir l’air	
crocodile	,croco	
planète rouge	,Mars	
bête à bon Dieu	,coccinelle	
CMPU	,coût moyen unitaire pondéré	
ordinateur	,ordi	
bouquet	,bosquet	
ombilic	,nombril	
deux-pièces	,F2	,T2	
mouvement	,geste	
cradingue	,crasseux	,crado	,cracra	,craspec	,crade	,cradoque	,cracra	,crade	,crado	,cradoque	,cracra	,crade	,crado	,cradoque	,craspec	,crasseux	,cracra	,crade	,crado	,cradoque	,crasseux	,cracra	,crado	,cracra	,crade	,crado	,cradoque	,craspec	,crade	
caoutchouc	,élastique	
stomacal	,gastrique	
>>>	S_1Pred
faible	,faible	
gentil	,gentil	,gentille	
débrouillard	,débrouillard	,débrouillarde	
mélomane	,mélomane	,mélomane	
solide	,solide	
russe	,Russe	,Russe	
criminel	,crime	,crime	,crime	
aîné	,aîné	,aînée	
victorieux	,vainqueur	
carié	,dent	
féminin	,femme	
bizarre	,bizarrerie	
titulaire	,titulaire	
autochtone	,autochtone	,autochtone	
coco	,coco	,coco	
blessé	,blessé	,blessée	
gourmand	,gourmand	,gourmande	
riverain	,riverain	,riveraine	
communiste	,communiste	,communiste	
original	,original	,original	
laid	,laid	,laide	
tentateur	,tentateur	,tentatrice	
anglais	,Anglais	,Anglaise	
breton	,Breton	,Bretonne	
fort	,fort	
hollandais	,Hollandais	,Hollandaise	
bienheureux	,bienheureux	
sud-américain	,Sud-Américain	,Sud-Américaine	
timide	,timide	,timide	
grec	,Grec	,Grecque	
couard	,couard	,couarde	
célèbre	,célébrité	
asiatique	,Asiatique	,Asiatique	
fouetteur	,fouetteur	,fouetteuse	
veuf	,veuf	,veuve	
bossu	,bossu	,bossue	
ordinaire	,ordinaire	
héroïque	,héros	,héroïne	
américain	,Américain	,Américaine	,Américain	,Américaine	
frisé	,frisé	,frisée	
indiscret	,indiscret	,indiscrète	
excentrique	,excentrique	,excentrique	,excentricité	
chrétien	,chrétienne	,chrétien	
anonyme	,anonyme	,anonyme	
espagnol	,Espagnol	,Espagnole	
xénophobe	,xénophobe	,xénophobe	
canadien	,Canadien	,Canadienne	
suisse	,Suisse	,Suisse	,Suissesse	
québécois	,Québécois	,Québécoise	
russophone	,russophone	,russophone	
>>>	S_2
sémantique	,phrase	,mot	
tournevis	,vis	
cafetière	,café	
tragédie	,tragédien	,tragédienne	,acteur	,actrice	
finir	,fin	
thermomètre	,température	
bouchon	,pêcheur	
éprouver	,émotion	,sentiment	;sensation	
multiplier	,multiplicande	
donner le sein	,nourrisson	;bébé	
visiter	,hôte	,hôte	,hôtesse	
molécule	,substance	
plateau	,fusil	;carabine	
jumeau	,bœuf	
prestation	,prestation	
sous l’effet	,cause	
couver	,œuf	
hospitalité	,hôte	,hôte	
appareillable	,appareil	
embarquer	,bateau	
animer	,antenne	
symbolique	,valeur symbolique	
volant	,véhicule	,badminton	
chef d’orchestre	,orchestre	
règlement livraison	,titre	
service	,client	,cliente	
dentiste	,patient	,patiente	,patient	,patiente	
devoir	,dû	
tapis	,sport	
mobiler	,mobiler	
purée	,pomme de terre	
somme	,terme	,montant	
avare	,argent	
pharmacie	,pharmacie	
fax	,fax	
restaurant	,repas	,plat	;cuisine	
valet	,maître	
champ d’investigation	,chercheur	,chercheuse	
grille-pain	,pain	;tartine	,toast	
enregistrer	,enregistrement	
s’empoisonner	,poison	
protéger	,protégé	,protégée	
collaborer	,occupant	
lexique	,langue	
catastrophe	,victime	
haras	,cheval	
longueur	,longueur	
aînesse	,cadette	,cadet	,puîné	,puînée	
lexicographie	,lexique	
intéressé	,intéressant	
>>>	S_1^usual
enseignable	,enseignant	,enseignante	
mendier	,mendiant	,mendiante	
enjôler	,enjôleur	,enjôleuse	
balcon	,immeuble	
apiculture	,apiculteur	,apicultrice	
entêtement	,têtu	,têtue	
scier	,scieur	,scieuse	
philosophie	,philosophe	,philosophe	
péter	,péteur	,péteuse	
alto	,altiste	,altiste	
météo	,météorologiste	,météorologiste	,météorologue	,météorologue	,météorologiste	,météorologiste	,météorologue	,météorologue	
station-service	,pompiste	
imagination	,imaginatif	,imaginative	
filmer	,caméraman	
caprice	,capricieux	,capricieuse	
faire de l’essence	,pompiste	,pompiste	
nettoyage	,chirurgien	,chirurgienne	
installer	,installateur	,installatrice	
mathématiques	,mathématicien	,mathématicienne	
vache	,éleveur	,éleveuse	;vacher	,vachère	
fournir	,fournisseur	,fournisseuse	
autopsie	,médecin légiste	,médecin légiste	
mine	,mineur	
balayer	,balayeuse	,balayeur	
art	,artiste	,artiste	
cultiver	,cultivateur	,cultivatrice	
filet	,pêcheur	,pêcheuse	
piano	,pianiste	,pianiste	
moutarde	,cultivateur	,cultivatrice	
design	,designer	
montrer	,montreur	,montreuse	
tarte	,pâtissier	,pâtissière	
approvisionner	,approvisionneur	,approvisionneuse	
dormir	,dormeuse	,dormeur	
enseigner	,enseignant	,enseignante	
sondage	,sondeur	
tabac	,planteur	;cultivateur	,cultivatrice	;producteur	,productrice	,buraliste	,buraliste	;débitant	,débitante	;marchand	,marchande	
préparer	,cuisinier	,cuisinière	
battre son plein	,mer	
banque	,banquière	,banquier	
laver	,laveuse	,laveur	,lavandière	,laveuse	
préconiser	,pape	
prévision	,prévisionniste	,prévisionniste	
coiffage	,coiffeur	,coiffeuse	
dessiner	,dessinatrice	,dessinateur	
sauciflard	,charcutier	,charcutière	
clairon	,clairon	
boucher	,bouchon	
étoilé	,ciel	
guitare	,guitariste	,guitariste	
>>>	Magn
réfléchir	,mûrement	
galérer	,à mort	
marche	,rapide	
avocate	,grand	<ardent	,fervent	
douzaine	,bon	,gros	
demain	,après-demain	
conte	,à dormir debout	,à dormir debout	
suspense	,haletant	,gros	
savon	,mémorable	;sacré	
certifer	,sur l’honneur	
piano	,pianissimo	
cousin	,proche	
degré	,haut	
père	,vrai	
fesses	,rebondi	,dodu	<gros	,gras	,d’éléphant	
chanter	,fort	<à tue-tête	,à pleins poumons	,à pleine voix	
avoir	,bien	,complètement	
ronflement	,bruyant	,sonore	
joli	,à croquer	,beau	
droit	,comme un i	
lien	,intime	,étroit	
fâché	,hors de ses gonds	
ronfler	,bruyamment	,fort	,comme un sonneur	
dormir	,à poings fermés	,profondément	;comme un loir	,comme une marmotte	,comme une bûche	,comme une masse	,comme une souche	,comme un sonneur	;comme un bébé	
délice	,tuerie	
pédé	,comme un phoque	
camion	,gros	,lourd	
franc	,comme l’or	,très	
mémoire	,éléphant	
sentiment	,net	,fort	,profond	,vif	
collaborer	,étroitement	
enveloppe	,gros	,important	
incident	,accident	
similarité	,grand	,frappant	
souci	,gros	,sérieux	<majeur	
cauchemar	,horrible	
doux	,tout doux	
nostalgie	,grand	,profond	<immense	;déchirant	,poignant	,violent	;incurable	,inconsolable	
se faire chier	,à crever	,comme un rat mort	
tir	,puissant	
problème	,gros	,sérieux	<insurmontable	,difficile	,gros	,sérieux	<majeur	
loup de mer	,vieux	
liaison	,fort	
klaxon	,fort	
vite	,plus _Adv que la musique	,ventre à terre	,plus _Adv que la musique	
ivre	,complètement	,mort	
manger	,beaucoup	;avidement	;goulûment	;copieusement	;à belles dents	,de bon appétit	,de bon cœur	<à se faire péter la panse	,à se faire péter la sous-ventrière	,se faire péter la panse	,comme quatre	,comme un ogre	,énormément	,tout cru	
laver	,de la tête aux pieds	
numéro	,fameux	,sacré	,drôle	
coup de soleil	,fameux	,gros	,méchant	,sacré	,sérieux	,vilain	
>>>	A_2
proche	,prochain	
disputer	,disputé	
pension	,pensionné	
pouvoir	,sous	
préoccuper	,préoccupé	
débat	,en	
électronique	,électronique	
émouvoir	,ému	
comprendre	,compris	,compris	,inclus	,compris	
air	,sur	
creuser	,creusé	
schéma	,schématique	
conservation	,conservé	
tissu	,musculaire	
savoir	,su	,su	
exercer	,exercé	
agacer	,agacé	
consentement	,consenti	
menacer	,menacé	
amour	,amoureux	
observer	,observé	,observé	
accusation	,visé	,en butte	
battre	,battu	
finir	,final	
ébahir	,ébahi	
habitude	,habituel	
suspecter	,suspect	
découragement	,décourageant	
fossette	,creusé	
éblouir	,ébloui	
exposer	,exposé	,exposé	
brûlure	,brûlé	
se distraire	,distrayant	
raisonner	,raisonné	
surveiller	,surveillé	
entretenir	,entretenu	
gonfler	,gonflé	
consentir	,consenti	
désirer	,désirable	
héliporter	,héliporté	
serrer	,serré	
lac	,noyé	
bague	,bagué	
aéroporter	,aéroporté	
miel	,mellifère	,mellifique	
tache	,taché	
couleurs	,à	,sous	
abondant	,abondant	
abattre	,abattu	,abattu	,abattu	
employer	,employé	
>>>	Contr
théorie	,pratique	
directeur	,moteur	
occident	,orient	
je	,tu	
champ	,pré	,ville	
à la voile	,à la rame	
microscopique	,macroscopique	
collaboration	,Résistance	
nom de famille	,prénom	
tête	,pieds	;corps	;jambes	,queue	,queue	
loin	,ici	
soir	,matin	
blonde	,brune	
court sur pattes	,haut sur pattes	,haut sur pattes	,haut sur pattes	
eau	,glace	;feu	
produit	,réactif	
R.E.R	,métro	,métro	
votre	,notre	
macroscopique	,microscopique	,submicroscopique	
plafond	,sol	
croûte	,mie	
escalade	,randonnée	,randonnée	
corps	,âme	,esprit	,bras	;jambes	;tête	,visage	,tête	
genre	,nombre	
fourchette	,cuillère	;couteau	
temps	,espace	
ange	,démon	
tutoiement	,vouvoiement	,voussoiement	
stratégique	,tactique	
chaussures	,chaussons	
analogue	,homologue	
temporel	,spirituel	
audio	,vidéo	
éliminatoire	,finale	
dos	,poitrine	,poitrine	
ici	,là-bas	;ailleurs	,ailleurs	,loin	,là	;ailleurs	
tutoyer	,vouvoyer	,voussoyer	
demoiselle	,dame	
intégration horizontale	,intégration verticale	
quelque chose	,quelqu’un	
récepteur	,émetteur	
liquide	,gaz	,solide	,chèque	
biberon	,seins	
tronc	,jambes	;jambes	,patte	
atterrir	,décoller	
à la rame	,à la voile	
musique	,bruit	,texte	,paroles	;livret	;chorégraphie	
intellectuel	,manuel	
chercher	,trouver	
abdomen	,thorax	,thorax	
>>>	S_0Pred
réticent	,réticence	
original	,originalité	
habile	,habileté	
hésitant	,hésitation	
intuitif	,intuition	
raciste	,racisme	
traître	,trahison	
originel	,origine	
fixe	,fixité	,fixité	
noble	,noblesse	
somnolent	,somnolence	
chaud	,chaleur	,chaleur	
calculateur	,calcul	
varié	,variété	
sapide	,sapidité	;goût	
extravagante	,extravagance	
paresseux	,paresse	
analogue	,analogie	
brusque	,brusquerie	
juste	,justice	
tendre	,tendreté	,tendresse	
nécessaire	,nécessité	
divers	,diversité	
réactif	,réactivité	
vieux	,vieillesse	
pertinent	,pertinence	
lâche	,lâcheté	
salarié	,salariat	
optimiste	,optimisme	
maigre	,maigreur	
étroit	,étroitesse	
tolérant	,tolérance	
certain	,certitude	
stérile	,stérilité	
médiocre	,médiocrité	
jaloux	,jalousie	
xénophobe	,xénophobie	
hypocrite	,hypocrisie	
tyran	,tyrannie	
fidèle	,fidélité	
lent	,lenteur	
mixte	,mixité	
difficile	,difficulté	
cordial	,cordialité	
civil	,civilité	
responsable	,responsabilité	
sérieux	,sérieux	
intense	,intensité	
brutal	,brutalité	
vainqueur	,victoire	
>>>	S_1^prototyp
orbiter	,corps céleste	;astre	
émigration	,aristocratie	
vestiaire	,restaurant	,discothèque	,gymnase	,piscine	
cru	,crudités	
illustrer	,exemple	
foudroyer	,éclair	
plage	,touriste	,touriste	;vacancier	,vacancière	;estivant	,estivante	<baigneur	,baigneuse	;bronzeur	,bronzeuse	,vacancier	,vacancière	
bouché	,oreilles	
soutif	,femme	
double	,fenêtre	
bateau	,chaussures	;col	,décolleté	,encolure	;lit	
poulailler	,poule	,coq	
escalope	,bœuf	,veau	;poulet	
miette	,pain	
fesse	,navire	
moule	,pâte	;gâteau	
condamner	,juge	
discothèque	,client	,cliente	
cible	,tireur	,tireuse	,archer	
lin	,tissu	
assis	,charge	;cotisation	;impôt	;prélèvement	;taxe	
dessous	,femme	
champ magnétique	,aimant	,aimant	
protection hygiénique	,femme	
vitré	,paroi	
givre	,vanille	
kaki	,uniforme	,soldat	,soldat	
cadran	,montre	
choucroute	,charcuterie	;poisson	
cristal	,verre	,carafe	,givre	,glace	,neige	
fusillade	,tireur	,tireuse	
haut-parleur	,téléviseur	;radio	
de bain	,serviette	;maillot	
résiduel	,matière	;valeur	
cravate	,drapeau	
cause	,avocat	
quatre-heures	,enfant	,enfant	
sucre	,canne	,betterave	
angle	,appareil photo	;caméra	
sens	,mot	,phrase	,évènement	,fait	,action	,vie	,existence	
pelouse	,parc	
cailler	,lait	;sang	,présure	
meuh	,vache	
main verte	,jardinier	,jardinière	
page	,livre	,carnet	,cahier	
avalanche	,boue	,pierre	
réseau	,ami	
épluché	,fruit	;légume	
à cheval	,steak	
éclore	,oisillon	,œuf	,fleur	,fleur	
>>>	Redun
mère	,vinaigre	
drap	,lit	
course	,hippique	,cheval	
précipitation	,atmosphérique	
composé	,chimique	
environnement	,informatique	,logiciel	
rive	,toit	
déplacement	,professionnel	
gymnastique	,intellectuel	
comme il faut	,bien	
machine	,laver	
chaussette	,évacuation	
énergie	,physique	
chevaux	,fiscal	
somme	,argent	
dégoût	,physique	
tirage	,photographique	
partie	,génital	
secteur	,économique	
réacteur	,chimique	,nucléaire	
marcher	,au pas	
air	,de musique	
escompte	,règlement	
étreinte	,sexuel	
prise	,électrique	
anniversaire	,de naissance	
objet	,céleste	
fête	,religieux	
duel	,grammatical	
cailler	,de froid	
ticket	,entrée	
navigateur	,Internet	,Web	
diversité	,ethnique	
loin	,dans le temps	
manifestation	,sportif	
grappe	,raisin	
réaction	,chimique	,nucléaire	
boxe	,anglais	
bouteille	,alcool	
toison	,pubien	
matière	,physique	
régime	,politique	,mécanique	,alimentaire	,syntaxique	;grammatical	,alimentaire	
Noël	,chrétien	
balayeuse	,aspirateur	
pompe	,à huile	,à essence	
huile	,alimentaire	
se cailler	,de froid	
animal	,familier	
père	,éternel	,céleste	
flûte	,pain	
>>>	AntiBon
jambes	,faible	,mauvais	,faible	,mauvais	
sens	,contresens	,mauvais	
moral	,à zéro	,dans les chaussettes	
homme politique	,politicard	
jour	,sans	
effet	,méfait	
restaurant	,gargote	
s’entendre	,comme chien et chat	
toilette	,négligé	
vêtement	,usé	;fripé	,râpé	
tête	,de _N de long	
politicien	,politicard	
écrire	,gribouiller	
langage	,baragouin	
nager	,mal	
parler	,baragouiner	,comme une vache espagnole	,baragouiner	
sujet	,chiffon rouge	
écrivain	,gribouilleur	;pisseur de copie	
odeur	,irrespirable	
politicienne	,politicarde	
prendre	,mal	
colline	,abrupt	
vélo	,clou	
couteau	,mauvais	
figure	,de carême	
navire	,mauvais	,rafiot	
relation	,toxique	
mélange	,mariage de la carpe et du lapin	
crier	,braire	,braire	
alcool	,bibine	
avocate	,mauvais	<piètre	;avocaillonne	
négocier	,chipoter	
air	;lourd	;pollué	,vicié	
recevoir	,comme un chien dans un jeu de quilles	
tapis	,élimé	,râpé	,pelé	
couple	,malheureux	
corps	,difforme	
dent	,carié	,pourri	,gâté	,vilain	;déchaussé	;ébréché	<cassé	,chicot	;creux	
pluie	,dévastateur	,dévastateur	
violon	,crin-crin	
chien	,indiscipliné	;agressif	,hargneux	,teigneux	<enragé	
humeur	,de chien	
attitude	,gauche	
écriture	,pattes de mouche	
courriel	,frauduleux	,hameçonnage	,spam	,pourriel	
passager	,clandestin	
linge	,froissé	,souillé	
divorce	,pour faute	;aux torts exclusifs	;par assignation	;aux torts partagés	
gueule	,de _N de long	
thèse	,mauvais	<médiocre	
>>>	Mero
tomate	,tomate cerise	,cœur de bœuf	
forêt	,sous-bois	
piano	,clavier	
fil de lin	,lin	
cheval	,crinière	
graine de lupin	,lupin	
moto	,guidon	;moteur	;réservoir	;roue	;side-car	
chaise	,dossier	,patte	,siège	
chicorée	,chicorée	
bois	,sous-bois	
W.-C.	,siège	,trône	,cuvette	,lunette	,abattant	,couvercle	
novembre	,Toussaint	
autoroute	,chaussée	,voie	,bande de circulation	;bande d’arrêt d’urgence	;péage	;entrée	,sortie	
lentilles	,foyer	
verglas	,glace	;eau	
muscle	,fibre	;tissu	
chemin de fer	,rails	,train	,chemin de fer	
boule de neige	,neige	
bouchon	,liège	
viorne	,cheveu-de-la-Vierge	
glaçon	,glace	,glace	
mélodie	,mélodie	
gentiane	,gentiane	
voie ferrée	,rails	
semaine	,semaine	,week-end	
douche	,bac	,colonne	,douchette	,mélangeur	,mitigeur	,pare-douche	,paroi	,pommeau	,pomme de douche	,porte	,receveur	,rideau	,robinet	,tuyau	
rame	,voiture	
cheminée	,foyer	
fleuve	,méandres	;amont	,aval	;embouchure	;estuaire	,delta	;bouche	;berge	,bord	,rive	
sms	,sms	
substance	,particule	
lavande	,lavande	
fleur	,pétales	,fleur	
mère	,bactérie	
trottinette	,roue	;guidon	,roue	;guidon	
museau	,truffe	,museau	
cube de glace	,glace	
récif corallien	,corail	
gamme	,do	,sol	
théâtre	,scène	,foyer	,coulisse	
zigzag	,tournant	,virage	
brosse	,dos	;poil	,fibre	;manche	,poil	,fibre	;manche	,poil	,fibre	
arbre	,branche	,tronc	;feuille	,feuillage	,couronne	
courriel	,en-tête	,signature	,pièce jointe	,adresse électronique	
colline	,bas	,pied	;flanc	,versant	;haut	<sommet	
bonhomme de neige	,neige	
lune	,croissant	
nuage	,vapeur	
Système solaire	,Soleil	;Terre	,Mars	;Lune	
gorge	,gosier	,gorge	,pipe	
>>>	Fact_0
rideau	,cacher	,masquer	,occulter	,séparer	,diviser	;cacher	,masquer	
campeuse	,camper	
travailleuse	,travailler	
balai	;balayer	
cheval	,marcher	;trotter	;galoper	
bus	,rouler	;circuler	
pâte	,cuire	
couleurs	,flotter	
collabo	,collaborer	,collaborer	
navire	,naviguer	
hélicoptère	,voler	
coureur	,courir	
roue	,tourner	,tourner	
rêveur	,rêver	
skis	,glisser	
aéronef	,voler	
prévision	,se réaliser	
corbeau	,voler	,voler	
mouche	,voler	,voleter	,voltiger	
médecin	,exercer	;consulter	,exercer	;consulter	
antenne	,capter	,recevoir	;émettre	
flocons	,tomber	;voler	;neiger	
dormeuse	,dormir	,dormir	
père	,officier	
dormeur	,dormir	,dormir	
soleil	,briller	,luire	
tombeau	,contenir	,renfermer	,receler	
collaborateur	,collaborer	
casserole	,chauffer	
transporteur	,transporter	
cercueil	,contenir	,renfermer	,receler	
oiseau	,voler	
autocar	,rouler	
rêveuse	,rêver	
escargot	,ramper	,traîner	
campeur	,camper	
tortue	,traîner	
alcoolique	,boire	,boire	
draisienne	,rouler	,circuler	,rouler	
cigarette	,se consumer	
figure	,indiquer	,illustrer	,représenter	
véhicule	,rouler	,se déplacer	;avancer	,circuler	,se déplacer	
placard	,annoncer	<clamer	
numéro	,sortir	,sortir	,paraître	
tombe	,contenir	,renfermer	;receler	
musicienne	,jouer	
fond	,remonter	,remonter	
réactif	,réagir	
sorcier	,envoûter	
chimie	,opérer	,opérer	
>>>	Gener
terrier	,chien	
corneille	,oiseau	,oiseaux	
fer	,métal	
effroi	,sentiment	
ping-pong	,activité	
ottomane	,meuble	;pièce d’ameublement	
vérifieuse	,machine	
lupins	,aliment	;graine	
taraud	,instrument	,outil	
glauque	,couleur	
chignon	,coiffure	
tournesol	,plante	;fleur	
rhinocéros	,animal	;mammifères	
sphère	,volume	
Lune	,astre	,corps céleste	;satellite	
première	,vitesse	
miel	,aliment	,couleur	
appareil électroménager	,appareil	
pièce jointe	,fichier	
orage	,phénomène atmosphérique	
marguerite	,fleur	;plante	
olive	,fruit	,coloré	
colchique	,plante	;fleur	
quarante-cinq	,nombre	
vert	,coloré	,couleur	
noix	,fruit	
coq	,oiseau	
moniale	,religieuse	
guacamole	,purée	
10 kilomètres	,épreuve	;évènement sportif	
point d’exclamation	,signe de ponctuation	
tuberculose	,maladie	
apéro	,boisson	;boisson alcoolisée	
bâtiment	,secteur	
pissenlit	,plante	
criterium	,compétition	;évènement sportif	
chicorée	,plante	;fleur	,aliment	,boisson	,boisson chaude	
eau-de-vie	,boisson	;boisson alcoolisée	
banc	,siège	
uniforme	,vêtement	;habit	,tenue	
treize	,nombre	,équipe	
honneur	,récompense	
coût d’acquisition	,coût	
loques	,vêtements	
cigarette russe	,petit four	,biscuit	
destructeur	,appareil	
carmin	,coloré	,couleur	,colorant	
valeur d’utilité	,valeur	
oxalis	,plante	;fleur	
carpe	,poissons	
>>>	S_loc
tabac	,plantation	,champ	,bureau de tabac	,débit de tabac	,tabac	
volley-ball	,terrain	
prune	,prunier	
articulation	,point	
voter	,bureau de vote	
nager	,piscine	;cours d’eau	;étang	,lac	,mer	,océan	;piscine	
sortir	,sortie	
café	,caféier	
noix	,noyer	
crocodile	,rails	
valoches	,yeux	;visage	
réunion	,salle de réunion	
lessive	,blanchisserie	,pressing	;laverie	;lavoir	;buanderie	
figue de Barbarie	,figuier de Barbarie	
tomate	,tomate	
sous-bois	,bois	,forêt	
villageois	,village	
douche	;douche	,salle de douche	,salle de bain	,salle de douche	,salle de bain	,salle d’eau	,cabinet de toilette	
cuisine	,cuisine	
grappe	,vigne	
curé	,cure	;paroisse	
uriner	,urinoir	;toilettes	
pomme	,pommier	
tombe	,cimetière	
camper	,camping	
border	,bateau	,voilier	
doucher	,douche	;salle de bain	,salle de douche	
datte	,dattier	,palmier dattier	
soucoupe	,soucoupe	
noisette	,noisetier	
Allemagne	,en	
insecte	,insectarium	
fleuve	<lit	
course	,champ de course	,hippodrome	
entrer	,entrée	,entrée	
football	,terrain	;stade	
moustique	,marais	,mare	,marécage	
presse	,presses	;imprimerie	
emprisonné	,prison	
gazon	,gazon	,pelouse	
cheval	,écurie	;box	,stalle	;haras	
enfant	,enfance	,enfance	
ver de terre	,terre	
melon	,melon	
main gauche	,gauche	,gauche	
orchestre	,fosse d’orchestre	
vaisselle	,vaisselier	
figure	,dans	,en plein	
fessier	,fesses	
olive	,olivier	
>>>	Oper_1
concert	,donner	,se produire	
horreur	,éprouver	,ressentir	,avoir	,éprouver	,ressentir	
accident vasculaire cérébral	,avoir	
bœuf	,faire	
mesure	,effectuer	,prendre	,prendre	
plaisir	,avoir	,éprouver	,ressentir	;goûter	
certitude	,avoir	
déprime	,avoir	,éprouver	,ressentir	
ciné	,se faire	
mal	,être	,avoir	,souffrir	
rond de jambe	,faire	
sensation	,avoir	,éprouver	,ressentir	
téléphone	,avoir	,avoir	
poids	,avoir	
causette	,faire	
fleuve	,former	
main verte	,avoir	
tornade	,connaître	,essuyer	,subir	
désert	,traverser	,vivre	,connaître	,affronter	,traverser	,parcourir	,s’enfoncer	
choix	,faire	
vacherie	,faire	,dire	,sortir	
taureau	,être	
fausse route	,faire	,faire	
casserole	,avoir	
coup de frein	,donner	
colle	,poser	
mains propres	,avoir	
ravissement	,éprouver	,ressentir	;goûter	
félicitations	,adresser	,exprimer	
poisson d’avril	,faire	
maladie mentale	,avoir	,souffrir	
produit	,calculer	,effectuer	,faire	
dentition	,faire	
promenade	,faire	,faire	
savon	,donner	,passer	,donner	,passer	
bol d’air	,prendre	
tennis	,faire	;jouer	,faire	,se faire	
partie du corps	,avoir	
coup de fouet	,donner	,mettre	
voyage	,faire	,effectuer	
tournée	,faire	,effectuer	
cinéma	,faire	
tête	,occuper	,être	,figurer	
pluie	,tomber	,retomber	
autoroute	,faire	
pâte	,faire	
repas	,faire	,manger	,prendre	,prendre	,faire	,organiser	
répugnance	,avoir	,éprouver	,ressentir	
siège	,faire	
jaunisse	,avoir	,souffrir	
>>>	Cf
sévérité	,méchanceté	
assiette	,plat	
agoraphobe	,ochlophobe	,ochlophobe	
store	,rideau	
course	,marche	
tendon	,muscle	
source	,eau	
lavande	,thym	
marguerite	,pâquerette	
bar	,pression	
chemin de fer	,métro	,tramway	
rire	,sourire	,sourire	
vapeur	,buée	
il	,elle	
plus vieux métier du monde	,prostitution	
écologique	,naturel	
thé	,café	;tisane	
changement physique	,changement chimique	
air	;vent	
tasse	,verre	,verre	,noyade	
avoir	,être	;aller	
chacun	,chaque	
allonger	,asseoir	
lotus	,nénuphar	
ici	,maintenant	
doigts	,aube	
duodecies	,quinquies	;sexies	
blaireau	,rasoir	
géranium	,pélargonium	
fauteuil	,chaise	
centimètre	,mètre	
annuel	,mensuel	,trimestriel	
talon	,pieds	
TER	,T.G.V.	
muscle	,tendon	
étrangeté	,anomalie	
lever	,réveiller	
analogie	,métaphore	
hublot	,fenêtre	
gelée royale	,miel	
rivière	,voie navigable	
paraphe	,signature	
lavage	,rinçage	,séchage	,rinçage	,séchage	,repassage	,rinçage	,essorage	,séchage	
élocution	,parole	
pâtisserie	,viennoiserie	
avocat	,juriste	
quotient	,division	
T.G.V.	,corail	,TER	
syntaxique	,grammatical	
flûte	,baguette	
>>>	Sing
marches	,marche	
beurre	,noisette	,noix	;motte	
corolle	,pétales	
badminton	,match	,partie	
racaille	,racaille	
sport	,compétition	;tournoi	<championnat	
flottille	,bateau	
tabac	,pied	,paquet	,pot	
graine de lupin	,graine	
pluie	,gouttelette	<goutte	
industrie	,industrie	
sable	,grain	
vent	,brin	<souffle	,bouffée	;courant d’air	
mayonnaise	,flacon	,pot	,tube	
courrier	,courrier	
égouts	,égout	
nouilles	,paquet	
crème	,pot	,tube	
sauciflard	,rondelle	
cheval	,compétition	
dentition	,dent	
pâtes	,paquet	
neige	,flocons	;cristal	;boule	,boule de neige	
clientèle	,client	,cliente	
tissu	,cellule	;fibre	
bol	,coup	
rôti	,tranche	
gâteau	,part	,tranche	
mâture	,mât	
gymnastique	,séance	;gymnastique	,épreuve	<compétition	<championnat	
guerre	,bataille	
tennis	,match	,partie	,tennis	;rencontre	<compétition	,open	,tournoi	
vin	,verre	<bouteille	
rugby	,match	,partie	,rugby	;rencontre	<compétition	,tournoi	<championnat	
saucisson	,rondelle	
bouteille	,verre	
alcool	,verre	<bouteille	
terrorisme	,acte	
ski	,championnat	,compétition	
vinaigre	,bouteille	
rayonnage	,rayon	
feuillage	,feuille	
appareillage	,appareil	
cheveu	,cheveu	
batterie	,arme	
bruyère	,brin	;touffe	
conflit	,bataille	
boxe	<combat	,match	<compétition	,tournoi	<championnat	
football	,match	,partie	,football	;rencontre	<compétition	,tournoi	<championnat	
raisin	,grain	,raisin	;grappe	
>>>	Mult
rabbin	,rabbinat	
chien	,horde	,meute	
musicien	,ensemble	,groupe	,troupe	,orchestre	
médicament	,pharmacopée	
loup	,bande	,horde	,meute	
chèvre	,troupeau	
cheveu	,chevelure	,cheveux	,cheveu	
navire	,flotte	,flottille	
mouton	,troupeau	,cheptel	
bataille	,guerre	,conflit	
os	,ossature	,squelette	
avion	;flotte	
jumelle	,jumelles	
muguet	,tapis	
tabouret	,rangée	
comprimé	,boîte	,flacon	;tube	;plaquette	
seins	,poitrine	;paire	
loi	,code	
journaliste	,équipe	,groupe	;horde	,meute	;presse	;équipe	,groupe	;horde	,meute	;presse	
racaille	,racaille	
dessous	,dessous	
fiche	,fichier	
coccinelle	,nuage	
arme	,armement	
banane	,régime	
symptôme	,syndrome	
œuf	,couvée	
lion	,bande	
lettre	,alphabet	,correspondance	
poisson	,banc	
volcan	,chaîne	
dizaine	,chapelet	,chapelet	
bête à bon Dieu	,nuage	
rock	,rock	
raisin	,raisin	
ciseaux	,paire	
blues	,blues	
poussin	,couvée	
meuble	,mobiler	
abeille	,colonie	,essaim	;horde	,nuage	,nuée	
assiette	,pile	
bœuf	,cheptel	;troupeau	;bétail	
batracien	,batraciens	
vache	,troupeau	;cheptel	
année	,années	
datte	,grappe	,régime	
fleur	,grappe	;inflorescence	;massif	,tapis	;bouquet	
voisin	,voisinage	
rayon	,rayonnage	
expert	,comité	,équipe	,groupe	
>>>	Hypo
douche	,cabine	
pantalon	,jean	;patte d’éléphant	
eau	,eau de pluie	
champ	,objet	
mois	,janvier	,février	,mars	,avril	,mai	,juin	,juillet	,août	,septembre	,octobre	,novembre	,décembre	
crotte	,fiente	,crottin	
marsupial	,kangourou	
siège	;banc	;canapé	;chaise	;fauteuil	;tabouret	
plan d’eau	,étang	,lac	
vents	,bois	,cuivres	
cinéma	;parlant	,sonore	,muet	;en 2 dimensions	,en 2D	,en 3 dimensions	,en 3D	,relief	;noir et blanc	,couleur	
diplôme	,doctorat	
biscuit	,pâtisserie	
compte	,compte	
jour	,lundi	,mardi	,mercredi	,jeudi	,vendredi	,samedi	,dimanche	
dispositif	,additionneur	
wagon	,wagon-lits	,wagon-restaurant	
dimension	,longueur	,largeur	,hauteur	,profondeur	
respiration	,petit chien	
nombre	,entier	,singulier	,pluriel	,duel	
matière	,matière ordinaire	,matière noire	,antimatière	
exclamation	,misère	
boucle	,boucle articulatoire	
connecteur	,implication	
coiffure	,chignon	
femme de loi	,avocate	,magistrate	
escargot	,escargot de Bourgogne	,petit-gris	
champ vectoriel	,fonction	
transports	,transport ferroviaire	
provision	,provision pour risques et charges	
film	,documentaire	;court métrage	,moyen métrage	,long métrage	
champ de foire	,emplacement	
canapé	,canapé-lit	,clic-clac	,convertible	
véhicule roulant	;autobus	,motocyclette	,deux-roues	,moto	,bicyclette	,voiture	,automobile	;auto	,véhicule	,vélo	,bus	,autocar	;car	,train	,tramway	;voiture	,wagon	
cartilage	,cricoïde	,aryténoïde	
engin de navigation	,bateau	
articulation	,articulation temporo-mandibulaire	;articulation crico-aryténoïdienne	,première articulation	,deuxième articulation	,troisième articulation	
document	,enregistrement	
orifice	,narines	
désert	,erg	,reg	
sandwich	,cheeseburger	,croque-monsieur	;hamburger	,hot-dog	,kebab	,pan bagnat	,panini	
pâtisserie	,éclair	,fondant	,opéra	,pièce montée	
épreuve	,bac	
nucléon	,proton	,neutron	
braguette	,fermeture éclair	
nage	,brasse	,brasse-papillon	,crawl	,dos	,dos brassé	,dos crawlé	,nage indienne	
sens	,ouïe	,vue	,odorat	,goût	,toucher	
doigt	,auriculaire	,pouce	
message	,courriel	,sms	
moyen de transport	,véhicule flottant	;véhicule roulant	;véhicule volant	
>>>	Fact_2
avocate	,conseiller	;représenter	;défendre	,défendre	;lutter	,militer	
bateau	,transporter	
casserole	,contenir	
combattant	,combattre	,se battre	
couleur	,colorer	
coiffeuse	,coiffer	;couper les cheveux	
garante	,garantir	
porteur	,porter	
collectionneur	,collectionner	
administrateur	,administrer	
avion	,transporter	
commentatrice	,commenter	
parasite	,profiter	,profiter	
camion	,acheminer	,transporter	
chasseresse	,chasser	
hélicoptère	,transporter	
composant	,composer	
savon	,laver	,nettoyer	,laver	,nettoyer	
boulangère	,faire	;préparer	
bouchon	,boucher	,obstruer	
aspirateur	,aspirer	;avaler	,absorber	,aspirer	,absorber	,avaler	
four	,cuire	,brûler	
facteur	,fabriquer	
car	,transporter	
barbier	,raser	
acheteur	,acheter	
lessive	,laver	,nettoyer	
pluie	,mouiller	,arroser	<laver	<tremper	,détremper	,lessiver	,doucher	<noyer	;transpercer	,traverser	,pénétrer	;alimenter	
concepteur	,concevoir	
présure	,cailler	
semeur	,semer	
accompagnateur	,accompagner	,accompagner	
trieur	,trier	
dentifrice	,laver	,nettoyer	
commentateur	,commenter	
père	,élever	,s’occuper	,prendre soin	,s’occuper	,prendre soin	
chasseuse	,chasser	
étagère	,supporter	
chanteur	,chanter	
avocat	;conseiller	;représenter	;défendre	,défendre	;lutter	,militer	
ami	,aider	;protéger	,aider	;encourager	;protéger	
journaliste	,couvrir	;enquêter	,couvrir	;enquêter	
voiture	,transporter	
vague	,frapper	,heurter	;submerger	
médecin	,examiner	;s’occuper	;soigner	,traiter	,examiner	;s’occuper	;soigner	,traiter	
acheteuse	,acheter	
mécanicienne	,conduire	
navire	,transporter	
agresseuse	,agresser	
accusatrice	,accuser	
>>>	SingS_1
russe	,Russe	,Russe	;russophone	,russophone	
pineraie	,pin	
brosserie	,brosse	
insectes	,insecte	
boche	,Boche	,Boche	
pinière	,pin	
électorat	,électeur	,électrice	
gorge chaude	,rapace	
coréen	,Coréen	,Coréenne	
Australie	,Australien	,Australienne	
allemand	,Allemand	,Allemande	;germanophone	,germanophone	
pinède	,pin	
trésor	,trésor	
orchestre	,musicien	,musicienne	
restaurant	,serveur	,serveuse	
Amérique	,Américain	,Américaine	,Américain	
émigration	,émigré	,émigrée	
mairie	,conseiller municipal	,conseillère municipale	
enfance	,enfant	,enfant	
Espagne	,Espagnol	,Espagnole	
Chine	,Chinois	,Chinoise	
Irlande	,Irlandais	,Irlandaise	
pays	,habitant	,habitante	;citoyen	,citoyenne	,pays	
turc	,Turc	,Turque	
oiseaux	,oiseaux	,oiseau	
bordel	,prostituée	
reptiles	,reptile	
visite	,visiteur	,visiteuse	;participant	,participante	
marine	,marin	
gallois	,Gallois	,Galloise	
germanique	,Germanique	,Germanique	
fichier	,fiche	
active	,actif	
Japon	,Japonais	,Japonaise	,Nippon	,Nippone	
français	,Français	,Française	;francophone	,francophone	
chinois	,Chinois	,Chinoise	;sinophone	,sinophone	
angliche	,Angliche	
Corée du Sud	,Sud-Coréen	,Sud-Coréenne	
suédois	,Suédois	,Suédoise	
portugais	,Portugais	,Portugaise	;lusophone	,lusophone	
Triangle	,étoile	
espagnol	,Espagnol	,Espagnole	;hispanophone	,hispanophone	
gens	,personne	,individu	
œuvre	,œuvre	
gouvernement	,ministre	
famille	,membre	;parent	,membre	,membre	,membre	,membre	,mafioso	
ballet	,danseur	,danseuse	
chleuh	,Chleuh	,Chleuh	,Chleuh	
japonais	,Japonais	,Japonaise	
table	,convive	,convive	,serveur	,serveuse	;cuisinier	,cuisinière	;chef	
>>>	Syn_⊂^sex
familière	,familier	
pompière	,pompier	
interviewée	,interviewé	
opératrice	,opérateur	
générale	,général	
amatrice	,amateur	
bénévole	,bénévole	
idiote	,idiot	
imaginative	,imaginatif	
votante	,votant	
habitante	,habitant	,habitant	
judokate	,judoka	
béni-oui-oui	,béni-oui-oui	
fiancée	,fiancé	
clandestine	,clandestin	
plombière	,plombier	
avare	,avare	
politicarde	,politicard	
amante	,amant	
inscrite	,inscrit	
anglophone	,anglophone	
voisine	,voisin	
marionnettiste	,marionnettiste	
boxeuse	,boxeur	
chiqueuse	,chiqueur	
notaire	,notaire	
malade	,malade	,malade	
philosophe	,philosophe	
pharmacienne	,pharmacien	
meunière	,meunier	
dominatrice	,dominateur	
invitée	,invité	
thésarde	,thésard	
chirurgienne-dentiste	,chirurgien-dentiste	
médecin-chef	,médecin-chef	
enquêtrice	,enquêteur	,enquêteur	
visiteuse	,visiteur	,visiteur	,visiteur	
prisonnière	,prisonnier	
lice	,chien de chasse	
indigène	,indigène	
rabat-joie	,rabat-joie	
dictatrice	,dictateur	
plagiste	,plagiste	
descriptrice	,descripteur	
coupable	,coupable	
observatrice	,observateur	
nettoyeuse	,nettoyeur	,nettoyeur	,nettoyeur	,nettoyeur	
daronne	,daron	
combattante du feu	,combattant du feu	
légiste	,légiste	
