>>>	Syn_∩
moto	;engin	;monture	;pétoire
svelte	,mince
ruelle	,passage	;venelle	,traboule	,passage
navire	,bateau	;bâtiment	,vaisseau	;embarcation	,esquif	;radeau
élévation	,altitude
poignée	,anse	;manche	;prise	,portion
grossièrement	,vulgairement
illustration	,dessin
TER	,corail
ceinture	,sangle
noyer le poisson	,éluder	;botter en touche	,tourner autour du pot	,embrouiller	,louvoyer	,tergiverser	;amuser le tapis
chaussonnier	,cordonnier
cracra	,crado	,malsain	,mauvais	,sale	,malpropre	,crado	,cradingue
emmerder	,casser les couilles	,casser les pieds	,faire chier	;énerver	,faire braire
s’interrompre	,s’arrêter	,s’arrêter
volcan	,champ de mines	,poudrière	,geyser	;festival
galérer	,peiner	,manger de la vache enragée	;manger son pain blanc
gentil	,aimable
vacancière	,touriste
pourfendre	,fendre	,fendre
entrée	,accès	,admission	,antichambre	,vestibule	,billet	,ticket	,données	,article
trésor	,richesse	,coffre-fort	,pièce de collection	,chef d’œuvre	,merveille	,collection	;ramassis	,fortune	,patrimoine	;pactole	,chéri
plus ou moins	,à peu près
normal	,standard	,justifié
excitant	,sexy	;séduisant
marié	,fiancé
tremblant	,trembleur
sire	,seigneur
coup de semonce	,mise en garde
courber	,se pencher
hallucination	,illusion
tempétueux	,agité
passager	,usager	;voyageur
rideau de fer	,frontière
tirer le tapis sous les pieds	,savonner la planche
avion	,appareil	,voyage	,déplacement	;vol	;route
footing	,jogging	,jogging
tout à coup	,tout d’un coup	;soudain
bénédiction	,autorisation
originalité	,nouveauté	,excentricité
péril	,danger	,menace
affirmer	,assurer	,garantir
représenter	,figurer
page	,feuille	,face	,passage
avertisseur	,signal
faire des gorges chaudes	,se moquer
analogon	,analogue
rive	,rivage	;berge	,bord	;coteau	,rivage	,berge	,bord	,littoral	,côte	,littoral	,rivage	,bord	<accotement	,bord	,bordure	,lisière	,bordure	,rebord	,bordure	,marge	,rebord	,bord	,confins	,frontière	,limite
corail	,TER
logement	,habitation
mine	,tronche
poubelle	,corbeille	,dépotoir
récif	,rocher
organisation	,institution
pourrir	,se décomposer	,se putréfier
se taire	,cesser	,ne pas desserrer les dents
aventurière	,baroudeuse	,tête brûlée	;voyageuse
flambant neuf	,neuf	,comme neuf
en fleurs	,fleuri	;en fleurs	,fleuri	;en fleurs
sur les dents	,actif
oreilles	,écoute	,anse	,espion	,espionne
ressentiment	,rancune
cadavre	,mort	,morte
cassé	,fracturé	;en miettes
réaliser	,fabriquer	,faire	,exaucer	,faire	,y aller
groupe	,assemblée	,club
adapté	,adéquat	,approprié	,conforme	,congruent	,idoine
leurre	,appât	,mouche
gaspiller	,dilapider	,engouffrer	,dissiper	,claquer	,croquer	,flamber	;manger son blé en herbe
combat	,bagarre	;bataille	;duel	;corps à corps	,affrontement	,dispute	,lutte
bavardage	,badinage	,causerie	,causette	,palabres	;conversation	,dialogue	;discussion	,entretien	,entrevue	,rencontre	,tête-à-tête	;conciliabule
gaine	,étui	,fourreau
en pleine tête	,en pleine figure	,en pleine gueule	,en pleine poire	,en pleine pomme	,en pleine tronche
communiste	,rouge	,rouge
botter en touche	;noyer le poisson	;répondre
diluer	,allonger
passif	,ressources
taux	,prix
brossé	,dépoli
tramway	,réseau	,système
se rétracter	,revenir
exaucer	,réaliser
échauffer	,chauffer
trésorerie	,finances
escompte	,rabais
hurler	,aboyer
dénationaliser	,privatiser
âcre	,aigre
reculer	,renoncer
paragraphe	,alinéa
aiguiser	,affûter
masse	,tartine
nageuse	,baigneuse
confirmer	,affirmer	,déclarer	,reconnaître	,valider	,prouver
talon	,chien
abîme	,gouffre	,gouffre	,gouffre
misanthrope	,ennemi
imperceptible	,insensible
couvre-chef	,chapeau
centrifuge	,excentrique
>>>	S_0
débattre	,débat	,débat
s’adapter	,adaptation
facial	,face
barrir	,barrissement
remercier	,remerciement
cordialement	,cordialité
universel	,univers
frimer	,frime
hétérosexuel	,hétérosexualité
diabolique	,diable
pierreux	,pierre
défense	,défendre
sucer	,succion	,sucement
adapter	,adaptation
australien	,Australie	,Australie
allergique	,allergie
avancement	,avancer
scier	,sciage
évènementiel	,évènement
hoqueter	,hoquet
poétiquement	,poésie
exploiter	,exploitation
hésiter	,hésitation	,hésitation
glorieusement	,gloire
individuel	,individu
préparer	,préparation	,préparation	,préparation
réhabiliter	,réhabilitation
villageois	,village
affronter	,affrontement
commencer	,commencement
chrétien	,christianisme
s’habiller	,habillement
briser	,bris	,bris
d’amour	,amour
se tenir	,tenue
fournir	,fourniture
raccrocher	,raccrochage
innocemment	,innocence
comptable	,comptabilité	,comptabilité
gestionnaire	,gestion
costal	,côte
barrer	,barrage
kaki	,kaki
emprunter	,emprunt	,emprunt
choisir	,choix
embrasser	,embrassement	,baiser
terreux	,terre
suédois	,Suède	,suédois
naturellement	,nature
bizarrement	,bizarrerie
mémoriel	,mémoire
interrompre	,interruption
marinier	,marine
triompher	,triomphe
voussoyer	,voussoiement
central	,centre	,centre
putschiste	,putsch
contrôlant	,contrôle
violer	,viol	,violation
dépasser	,dépassement
agir	,action
musicalement	,musique
juger	,jugement	,jugement
poursuivre	,poursuite
grincer	,grincement
résonner	,résonance	,résonance
temporal	,tempe
rhytmique	,rythme
écologique	,écologie
prolonger	,prolongation
Compliments	,compliment
débiter	,débit
vestimentairement	,vêtements
héroïquement	,héros
délictueux	,délit
féliciter	,félicitations
affirmer	,affirmation
gratter	,grattage
clore	,clôture
critique	,critique	,critique
se manifester	,manifestation
s’indigner	,indignation
sourire	,sourire
alimenter	,alimentation
grec	,Grèce	,grec
dire	,discours
ionique	,ion
hypothétiquement	,hypothèse
urger	,urgence
combattre	,combat	,bataille	,combat	,combat
futur	,futur
exaspérer	,exaspération
bactérien	,bactérie
s’évader	,évasion
se tasser	,tassement
allonger	,allongement	,allongement
progresser	,progression	,progression	,progression	,progression
contribuer	,contribution
additionner	,addition
apprécier	,appréciation
>>>	A_2Perf
soulager	,soulagé
inonder	,inondé
consommer	,consommé
tordre	,tordu
imposer	,imposé
développer	,développé
souligner	,souligné
corruption	,corrompu
allumer	,allumé	,allumé	,allumé
enterrer	,enterré	,enterré
oublier	,oublié
soumettre	,soumis	,soumis
toaster	,toasté	;grillé
interdire	,interdit
se détendre	,détendu
licencier	,licencié
entendre	,entendu
entourer	,entouré
immortaliser	,immortel	,immortel
élaborer	,élaboré
envelopper	,enveloppé
munir	,muni
retraitement	,retraité
accuser	,accusé
vider	,vidé	;vide
amputer	,amputé
autoriser	,autorisé
dissimuler	,sous le tapis
enfoncer	,enfoncé
garnir	,garni
déplacer	,déplacé
réveiller	,réveillé	,réveillé
amuser	,amusé
engager	,engagé
déchirer	,déchiré
dresser	,dressé	,vertical	,droit
inscrire	,inscrit
éplucher	,épluché
déterminer	,déterminé
plier	,plié
diviser	,divisé
épuiser	,épuisé
installer	,installé
écrire	,écrit
barrer	,barré
sécher	,sec
nationaliser	,nationalisé
empoisonner	,empoisonné
convaincre	,convaincu
salissant	,sale
endormir	,endormi	,endormi
emprisonner	,emprisonné
contraindre	,contraint
baser	,basé
encadrer	,encadré	,encadré
bourrer	,bourré
élargir	,élargi
attendrir	,attendri
insulter	,insulté
accepter	,accepté
menotter	,menotté
promettre	,promis
envahir	,envahi	,envahi
clouer	,cloué	,cloué	,cloué	,cloué
épouvanter	,épouvanté
se casser	,cassé
prénommer	,prénommé
éloigner	,éloigné
obtenir	,obtenu
hacher	,haché
percer	,percé
déconnecter	,déconnecté
définir	,défini
gonfler	,gonflé
décider	,décidé
geler	,glacé
rabattre	,rabattu
voiler	,voilé
exposer	,exposé
brosser	,brossé	,brossé
imaginer	,imaginé
restreindre	,restreint
lisser	,lissé
doubler	,doublé
accomplir	,accompli
boucher	,bouché
hospitaliser	,hospitalisé
exercer	,exercé
ouvrir	,ouvert
défaire	,défait	,défait
affaiblir	,affaibli
animer	,animé	,animé
habiller	,habillé	,habillé
étourdir	,étourdi
neiger	,enneigé	,neigeux
admettre	,admis	,admissible
enregistrer	,enregistré
asseoir	,assis
indiquer	,indiqué
lacer	,lacé
>>>	Anti
avoir chaud	,avoir froid
guerre	,paix
se recoucher	,se relever
inintelligence	,intelligence
incomplètement	,complètement
par-dessus	,par-dessous
impardonnable	,pardonnable
ouvert	,fermé	,fermé
innocence	,culpabilité
efficacité	,inefficacité
lever l’ancre	,jeter l’ancre
rajeunissant	,vieillissant
vieillir	,rajeunir	,rajeunir
à propos	,mal à propos
courir	,expirer
allumé	,éteint	,éteint	,éteint
éveil	,sommeil
faveur	,défaveur
expiration	,inspiration
indirect	,direct
anti-	,pro-
dégueulasse	,impeccable
autoriser	,interdire
pour	,contre
fertile	,infertile
définitif	,provisoire
habile	,malhabile
incertain	,certain	,sûr
craspec	,impeccable
mûr	,vert	;en herbe
indiscret	,discret
exportateur	,importateur	,importateur
absent	,présent
indéfinissable	,définissable
présent	,absent
installer	,désinstaller
pardonnable	,impardonnable
confirmer	,infirmer	,infirmer
matutinal	,vespéral
hétérosexualité	,homosexualité
expirer	,aspirer	,courir
confortable	,inconfortable
valide	,invalide	,invalide
indisponible	,disponible
faiblesse	,force
serrer	,desserrer
admissible	,inadmissible
décharger	,charger
confortablement	,inconfortablement
souvent	,jamais	,rarement	,quelquefois	,parfois	,toujours
accélérer	,ralentir	,décélérer	,freiner	;ralentir	,ralentir	,retarder
usage	,non-usage
pragmatique	,pratique
crade	,impeccable
réactif	,inerte	,inerte
vite	,tard
avancer	,reculer	,reculer
ordinairement	,exceptionnellement
introuvable	,trouvable
lever	,coucher
disgrâce	,grâce
comme un poisson	,comme un boulet	,comme un caillou	,comme un fer à repasser
désagréablement	,agréablement
à l’extérieur	,à l’intérieur	,dedans	,à l’intérieur
s’accélérer	,ralentir
insensible	,sensible	,sensible	,sensible	,sensible
sommeil	,éveil	,veille	,éveil
non audible	,audible
inaccessible	,accessible
trouvable	,introuvable
confirmé	,débutant
probable	,improbable
facultatif	,obligatoire
victoire	,défaite
rester	,partir
lâche	,courageux
allumer	,éteindre	,éteindre
à fond	,au ralenti	,au pas
comme un caillou	,comme un poisson
irréel	,réel
utilité	,inutilité
aveugle	,voyant	,voyante	,voyant
grammaticalité	,agrammaticalité
lexical	,grammatical
dehors	,dedans	,dedans
comme un fer à repasser	,comme un poisson
composé	,corps simple
contentement	,mécontentement
non-coupable	,coupable
fin	,épais	,début	,épais	,début	,épais
infondé	,fondé
défaite	,victoire
discontinu	,continu
foncé	,clair
aspirant	,soufflant
capacité	,incapacité
tristement	,joyeusement
sûr	,incertain
portable	,fixe
endroit	,envers
>>>	S_res
souffler	,souffle
multiplication	,produit	;résultat
étude	,résultat
entasser	,entassement	,entassement
test	,résultat
mesurer	,mesure
jugement	,jugement
blesser	,blessure
glaçage	,glaçage	,glaçage	,glaçage
s’engager	,engagement
coup de foudre	,amour
tordre	,torsion
opération	,résultat	,résultat
cadrer	,cadre	;photographie	,prise de vue	,cadre
négociation	,résultat
pluie	,eau
tempête	,houle
trouer	,trou
polluer	,pollution	,pollution
plisser	,pli
chanter	,chant
bilan	,bilan	;compte de bilan	,bilan
se couper	,coupure
décalage	,décalage
juger	,jugement
s’éprendre	,amour
écrire	,écriture
se fracturer	,fracture
suer	,sueur
tournoi	,résultat
interdire	,interdiction
renverser	,renversement
vote	,résultat
érotiser	,érotisme
se déplacer	,déplacement
confondre	,confusion
encadrer	,encadrement
critique	,critique	,critique
s’éloigner	,éloignement
entassement	,entassement	,entassement	,entassement	,entassement
collectionner	,collection
déchirer	,déchirure
arranger	,arrangement	,arrangement
gonfler	,gonflage
examen	,résultat	,résultat	,résultat
caca	,caca
ranger	,rang	,rangée
dévastation	,dévastation	,dévastation
s’ioniser	,ion	,anion	,cation
évaluation	,résultat
doubler	,double
klaxonner	,klaxon
analyse	,résultat
enquête	,résultat	,résultat
course	,résultat
se brûler	,brûlure
muscler	,muscles
tomate	,tomate
mélanger	,mélange	;mélange
trébucher	,chute
s’endormir	,sommeil
constatation	,constat
coucher de soleil	,nuit
abonner	,abonnement
réaliser	,réalisation
humilier	,humiliation
soustraction	;différence	;résultat
aimanter	,aimant
écarter	,écart	,écart
laver	,lavis	,aquarelle	,lavis
élection	,résultat
mélange	,mélange	,mélange	;mélange
division	,quotient	;résultat
vieillir	,vieillesse
affaiblir	,faiblesse
étourdir	,étourdissement
dévaster	,dévastation
sondage	,résultat
s’enrhumer	,rhume
résumer	,résumé
réunion	,réunion
chambouler	,désordre
copier	,copie	,copie
lavis	,lavis
éplucher	,épluchure
compétition	,résultat
ioniser	,ion	,anion	,cation
expérimentation	,résultat
enfler	,enflure
constater	,constat
maquette	,maquette
condamner	,condamnation
scrutin	,résultat
se décourager	,découragement
orienter	,orientation
addition	,somme	;résultat
extinction des feux	,extinction des feux
aimer	,sexe
caresser	,caresse
déprimer	,déprime	,dépression
>>>	Syn_⊃
mort	,décédé	,défunt	;abattu
récif	,récif corallien
volley-ball	,volley de plage	,beach-volley	,volley de plage	,beach-volley
intérieur	,dedans
très	,fort
matière fécale	,cigare	,colombin
yeux	,mirettes
élire	,voter
attraper	,contracter
attaque	,charge	,hold-up
belle	,belle
chanteuse	,cantatrice	,diva	;voix	;choriste
particule	,atome	,molécule	,élément	,élément
force	,tension
merde	,cigare	,colombin
accord	,convention
partir	,larguer les amarres
trois-quarts	,manteau
soupe	,potage	,velouté
par terre	,au tapis
cellule	,cachot
éprouver	,ressentir
ski	,ski alpin	;ski de descente	;ski de fond	;ski de piste	;ski de randonnée	;ski de vitesse
nom	,nom	,nom de famille	;prénom	;surnom	,nom
nager	,nager	;nageoter	,surnager	;crawler
sucrer les fraises	,trembler
changer	,se changer	,renouveler
aimer	,aimer
graviter	,orbiter
tâche	,sale boulot
pluie	,bruine	,crachin	;ondée	;giboulée	;drache	;cordes
parc	,zoo
vélo	,tandem	;bicross	,BMX	,vélo tout chemin	,VTC	,vélo tout terrain	,VTT
tache de naissance	,tache de vin
croître	,grandir
vents	,instrument à vent
rock	,hard rock
chien	,chiot
bistouquette	,cigare	,phallus
individu	,spécimen
cent	,centaine
bouffer	,déjeuner	;dîner	;goûter	;petit-déjeuner	;souper	;dévorer
conversion	,change
fumer	,cloper	;crapoter
se soustraire	,échapper
couteau	,couteau	,couteau
intéressant	,passionnant
moulin	,moulin à café
justificateur	,justificatif	,justificatif
agacer	,casser les oreilles
bouger	,se déplacer	,se déplacer
somme	,roupillon
criminel	,escroc	,truand	;bandit	,gangster	,voyou	;brigand	;hors-la-loi
conduit	,narine	;pipe
liquide	,boisson
Coréen	,Nord-Coréen	,Sud-Coréen
ministère	,sacerdoce
monnaie	,livre	,lire
résultat	,score
trio	,triangle
braquemart	,cigare	,phallus
orphelin	,pupille	,pupille
cuisses	,genoux
se laver	,se baigner	,se doucher
jumeaux	,siamois
analogue	;analogue
capital	,capital social
valeur mobilière	,titre de participation	,titre de placement
saisir	,empoigner
zob	,cigare	,phallus
ciseau	,burin
paternel	,paternel
procréatrice	,mère
agrandir	,allonger
chose	,objet
rétablir	,remettre les pendules à l’heure
Angliche	,Angliche
dérangé	,fou
corps céleste	,astre	,étoile
braiment	,hi-han
sécher	,fumer
vieux	,père peinard
médecin	,spécialiste
s’isoler	,s’enterrer
courriel	,spam	,pourriel
fixer	,clouer
an	,balais
aller aux toilettes	,aller à la selle
baiser	,tirer un coup
corps simple	,élément
crotte	,cigare	,colombin
crico-	,cricoïde
piquet	,sardine
assassiner	,abattre
facile	,de la tarte	,du gâteau
boîte	,pack
utiliser	,faire usage
sentiment	,émotion
beaucoup	,trop	,tartine	,trésors
réunion	,réunion publique	,conférence
>>>	S_1
beauté	,beauté
collaborer	,collaborateur	,collabo	,collaboratrice	,collabo
emprunter	,emprunteur	,emprunteuse
plante	,pieds
appartenir	,propriété	,possession
épicerie	,épicier	,épicière
prendre le volant	,conducteur
secrétariat	,secrétaire	,secrétaire
bombarder	,bombardier
plage arrière	,véhicule	,navire
piloter	,pilote	;aviateur	,aviatrice
Irlande	,Irlande
coiffure	,coiffeur	,coiffeuse
habit	,religieux	,religieuse
soupière	,soupe
pêcher	,pêcheur	,pêcheuse
plage avant	,véhicule	,navire
aube	,jour	,journée
entraîner	,cause	,entraîneur	,entraîneuse
contredire	,contradicteur	,contradictrice
problème	,problème	,énoncé	,problème
concevoir	,concepteur	,conceptrice
cadavre exquis	,joueur	,joueuse
charcuterie	,charcutier	,charcutière	,charcutier	,charcutière
vêtement	,ouvrier	,ouvrière
sommeil	,dormeur	,dormeuse
abricotier	,abricot
science	,scientifique	,scientifique	;savant	,savante	;chercheur
protestataire	,protestataire	,protestataire
épaule	,viande	,raquette
chaussure	,ouvrier	,ouvrière	,chausseur	,chausseuse
contenu	,contenant
détente	,arme à feu
grignoter	,grignoteur	,grignoteuse
jupon	,femme
vaccinable	,êtres animés
figuier	,figue
dictionnaire	,lexicographe	,lexicographe
achat	,acheteuse	,acheteur
libérer	,libérateur	,libératrice
enceinte	,mère
rue piétonne	,piéton	,piétonne
mode de transport	,usager	,usagère
en excès	,réactif	,réactant
batellerie	,batelier	,batelière
entreprise	,entrepreneur	,entrepreneuse
optimisme	,optimiste	,optimiste
limitant	,réactif	,réactant
affluent	,fleuve
bicyclette	,cycliste	,cycliste	,cycliste	,cycliste
adolescent	,adolescent	,adolescente
lice	,chasseur	,chasseuse	,chasseresse
habiter	,habitant	,habitante
tourisme	,touriste	,touriste
peigne	,animal
allaiter	,mère	;nourrice
bulletin de vote	,votant	,votante	;électeur	,électrice
perdre	,perdant	,perdante
volume	,son
barbe	,barbu
gentillesse	,gentil	,gentille
documentaire	,documentariste	,documentariste
nager	,nageur	,nageuse	,nageur	,nageuse
mise en scène	,metteur en scène	,metteur en scène
résider	,résidant	,résidante
maladie	,malade	,malade	,malade	,malade
Japon	,Japon
neuf	,neuf
épidémie	,maladie
Nouvelle-Zélande	,Nouvelle-Zélande
jouer	,joueur	,joueuse
rétroviseur	,véhicule
laver	,eau
timidité	,timide	,timide
rigoler	,rigolard	,rigoleur
impôt	,impôts
méfait	,malfaiteur	,malfaitrice
infrarouge	,rayon
manie	,maniaque	,maniaque
cambrioler	,cambrioleur	,cambrioleuse
foyer	,séisme
solide	,matière	,substance	,substance
hétérosexualité	,hétérosexuel	,hétérosexuelle
bénévolat	,bénévole	,bénévole
réaction	,réactif	,réactant
reflex	,appareil photo
piège	,piégeur	,piégeuse
s’agiter	,agité	,agitée
porcherie	,cochon
sexe	,femme	,homme
conception	,concepteur	,conceptrice	,concepteur	,conceptrice
camion	,chauffeur	,conducteur	,conductrice
oreilles	,cochon	,porc	,bol	;casserole	,cocotte	,fauteuil
con	,con
monarchie	,monarchiste	,monarchiste
analyser	,analyseur	,analyste	,analyste
carré	,troupe	,bataillon
récoltant	,récoltant	,récoltante
tramway	,passager	,passagère	;voyageur	,voyageuse	,usager	,usagère
éduquer	,éducateur	,éducatrice
>>>	Conv_21
recevoir	,visiter
amuser	,s’amuser
retentir	,retentir	,retentir
créancière	,débitrice
alors	,car
divertir	,se divertir
renverser	,passer
adoptif	,adoptif	,adoptif
se désintéresser	,désintéresser
conséquence	,cause
agacer	,s’agacer
partir	,avoir
s’ébahir	,ébahir
antérieur	,postérieur
résultat	,cause
posséder	,appartenir
intégrer	,s’intégrer	,s’intégrer
en conséquence	,car
alimenter	,marcher
donc	,car
commencer	,commencer	,ouvrir	,commencer	,s’ouvrir
piquer	,se piquer	,piquer	,piquer
se rappeler	,revenir
créancier	,débiteur
entrer	,comprendre
terminer	,se terminer	,se terminer
toucher	,connaître
ouvrir	,commencer
angoisser	,angoisser	,angoisser
désespérer	,désespérer	,désespérer	,se désespérer
résulter	,causer
manger la laine sur le dos	,se laisser bouffer
inquiéter	,s’inquiéter
mourir	,tuer	,emporter
par conséquent	,car
connaître	,toucher
se terminer	,terminer	,terminer
couvrir	,se couvrir
creusé	,creusé	,creusé
intéresser	,s’intéresser
aîné	,cadet
s’appliquer	,appliquer
effet	,cause
s’amuser	,amuser
craindre	,effrayer
expliquer	,s’expliquer
s’affoler	,affoler
s’affaiblir	,affaiblir
s’expliquer	,expliquer
se désoler	,désoler
s’occuper	,occuper
se désespérer	,désespérer
s’alarmer	,alarmer
à droite	,à gauche
accueillir	,se trouver
se coucher	,coucher	,coucher	,coucher	,coucher
se piquer	,piquer
passer	,renverser
causer	,résulter	,tenir
se divertir	,divertir
avoir	,aller	,partir
se composer	,composer
désintéresser	,se désintéresser
se souvenir	,revenir
tenir à cœur	,tenir à cœur	,tenir à cœur
se laisser bouffer	,manger la laine sur le dos
occuper	,s’occuper
affaiblir	,s’affaiblir
transformer	,subir
affoler	,s’affoler
coucher	,se coucher	,se coucher	,se coucher	,se coucher
colorer	,se colorer
au-dessous	,au-dessus
déclencher	,se déclencher
derrière	,devant
au-dessus	,au-dessous
s’agacer	,agacer
abriter	,s’abriter
s’intégrer	,intégrer	,intégrer
appauvrissement	,appauvrissement	,appauvrissement
visiter	,recevoir
s’abriter	,abriter
déprimer	,déprimer	,déprimer
manquer	,manquer	,manquer	,manquer	,manquer
tenir	,maintenir	,tenir	,tenir
cause	,conséquence	,effet	,résultat
aller	,avoir
quand bien même	,bien que
s’intéresser	,intéresser
car	,donc	,en conséquence	,par conséquent
revenir	,se souvenir	,se rappeler
cadet	,aîné
marcher	,faire	,alimenter
appartenir	,posséder
alarmer	,s’alarmer
passionner	,se passionner
ébahir	,s’ébahir
désoler	,se désoler
se déclencher	,déclencher
en dessous	,en dessus
>>>	A_0
limite	,limite	,à
normalement	,normal
météo	,météorologique	,météo
port	,portuaire
république	,républicain
contester	,contestataire
cheveu	,capillaire
centre	,central	,central
alphabet	,alphabétique
banalement	,banal
médias	,médiatique
triangle	,triangulaire	,triangulaire	,triangulaire
subtilement	,subtil
souterrainement	,souterrain
malhonnêteté	,malhonnête
schématiquement	,schématique
cercle	,circulaire
Corée du Sud	,sud-coréen
analogie	,analogique
italien	,italien
majorité	,majoritaire
gloire	,glorieux
masse	,massique
arrière	,arrière
vastement	,vaste
magie	,magique
document	,documentaire
étranger	,étranger
cycliste	,cycliste	,cycliste
paresseusement	,paresseux
espagnol	,espagnol
concept	,conceptuel
ascèse	,ascétique
silencieusement	,silencieux
fonction	,fonctionnel
soustraire	,soustractif
conflit	,conflictuel
Suède	,suédois
chimie	,chimique
partie	,partiel
ciel	,céleste
liquide	,liquide
rhumatisme	,rhumatismal
carré	,carré	,carré
blanc	,blanc
autoroute	,autoroutier
citoyenne	,citoyen
s’aplatir	,aplati
reptile	,reptilien
nationalement	,national
fair-play	,fair-play
dictature	,dictatorial
scéniquement	,scénique
Bretagne	,breton
mai 68	,soixante-huitard
actuellement	,actuel
pluriel	,pluriel
infiniment	,infini
supplémentairement	,supplémentaire
noir	,noir
mâchoires	,maxillaire
univers	,universel
ostentatoirement	,ostentatoire
alcool	,alcoolique
journaliste	,journalistique	,journalistique
étudiant	,estudiantin	,étudiant
énergiquement	,énergique
territorialement	,territorial
Russie	,russe
Amérique	,américain	,américain
chèvre	,caprin
avocate	,avocassier
judicieusement	,judicieux
collaborer	,collaborateur
crime	,criminel	,criminel
nombril	,ombilical
franchement	,franc	,franc
crâne	,crânien
grammaire	,grammatical	,grammairien
passagèrement	,passager
anarchiste	,anarchiste	,anarchiste
héroïquement	,héroïque
tard	,tardif
impec	,impeccable	,impec
docteure	,doctoral
monarchie	,monarchique
partiellement	,partiel
collégien	,collégien
Canada	,canadien
promptement	,prompt
mémoire	,mémoriel	,mnémonique
patience	,patient
respectueusement	,respectueux
orpheline	,orphelin	,orphelin
pasteur	,pastoral
rose	,rose
férocement	,féroce
groupe	,groupal
dos	,dorsal
bien	,bon	,bien
>>>	Able_1
russe	,russophone
chinois	,sinophone
se soumettre	,soumis
ramper	,rampant	,rampant
agresser	,agressif
sport	,sportif
compensation	,compensatoire
tenter	,tentateur	;tentant
ruse	,rusé
se casser	,cassant
amuser	,amusant
éducation	,éducable
accélérer	,accélérateur
envahir	,envahissant
épouvanter	,épouvantable
mordre	,mordeur
éruption	,éruptif
guérir	,guérissant
autorité	,autoritaire
réagir	,réactif
bagarre	,bagarreur
questionner	,questionneur
jouer	,joueur
incendie	,incendiaire
crainte	,craintif
bavarder	,bavard
causer	,causant	,causeur
entreprendre	,entreprenant
sale	,salissant
partager	,partageur
charité	,charitable
tempête	,exposé
exciter	,excitant
résister	,résistant
inventer	,inventif
compenser	,compensatoire
tolérer	,tolérant
étouffer	,étouffant
voler	,volant
calcul	,calculateur
fable	,fabulateur
mourir	,mortel
rigoler	,rigoleur
permettre	,permissif
attirer	,attractif
astuce	,astucieux
observer	,observateur
se débrouiller	,débrouillard
convaincre	,convaincant
blague	,blagueur
dormir	,somnolent
ébahir	,ébahissant
portugais	,lusophone
exploser	,explosible
s’évaporer	,évaporable
peur	,peureux
cogner	,cogneur
suspecter	,suspicieux
coopérer	,coopératif
rouler	,roulant
distraire	,distrayant
pleurer	,pleureur
réaction	,réactif
rudoyer	,rude
anglais	,anglophone
tracasser	,tracassier
flatter	,flatteur
s’entêter	,têtu	<entêté
flamber	,inflammable
travailler	,bosseur	,travailleur
rire	,rieur
malade	,maladif
inspirer	,inspirant
frousse	,froussard
service	,serviable
coopération	,coopératif
fabuler	,fabulateur
détruire	,destructif
en imposer	,imposant
exiger	,exigeant
pécher	,peccable
créer	,créatif
oublier	,oublieux
allemand	,germanophone
désespérer	,désespérant
crier	,criard
désobéir	,désobéissant
espagnol	,hispanophone
perturber	,perturbant	,perturbant
voyage	,voyageur
s’emporter	,coléreux	,colérique	,soupe au lait
voyager	,voyageur
écœurer	,écœurant
dommages	,dommageable
caprice	,capricieux
se suicider	,suicidaire
soupçonner	,soupçonneux
distinguer	,distinctif
casser	,cassant
craindre	,craintif
>>>	Able_2
appliquer	,applicable	,applicable
participer	,participatif
rembourser	,remboursable
prouver	,prouvable
contester	,contestable
libérer	,libérable
prononcer	,prononçable
adopter	,adoptable
communiquer	,communicable
orienter	,orientable
nier	,niable
administrer	,administrable	,administrable
importer	,importable
détruire	,destructible	,destructible
décrire	,descriptible
voir	,visible
adaptable	,adapter
cafard	,cafardeux
raconter	,racontable
se marier	,mariable
élire	,éligible
épouvante	,épouvantable
repérer	,repérable
déprimer	,déprimant
calcul	,calculable
sympathie	,sympathique	,sympa
consommation	,consommable
augmenter	,augmentable
imagination	,imaginable
traduire	,traduisible
habiter	,habitable
améliorer	,améliorable
transporter	,transportable	,transportable
déplier	,dépliable	,dépliant
connaître	,connaissable
attaquer	,attaquable
agacement	,agaçant
expliquer	,explicable
honteux	,honteux
vacciner	,vaccinable
analyser	,analysable
écouter	,écoutable
angoisse	,angoissant
loger	,logeable
rabattre	,rabattable
oublier	,oubliable
avouer	,avouable
danser	,dansable
bicyclette	,cyclable
adapter	,adaptable
maîtriser	,maîtrisable
nettoyer	,nettoyable	,nettoyable	,nettoyable	,nettoyable
évaluer	,évaluable
éviter	,évitable
glisser	,glissant
écraser	,écrasable
douter	,douteux
tourner	,tournant
compréhension	,compréhensible
défendre	,défendable
exprimer	,exprimable
contrôler	,contrôlable	,contrôlable
tuer	,tuable
diviser	,divisible
diffuser	,diffusible	,diffusable
réparer	,réparable
bouffer	,comestible	,mangeable
pardonner	,pardonnable
louer	,locatif	;louable
organiser	,organisable
cafardeux	,cafardeux
classer	,classable
reproduire	,reproductible
respirer	,respirable
utiliser	,utilisable
laver	,lavable	,lavable
entendre	,audible
paralysie	,paralysant
vérifier	,vérifiable
comparer	,comparable
rigoler	,rigolo
observer	,observable
solution	,soluble
promouvoir	,promouvable
prolonger	,prolongeable
distribuer	,distribuable
attraper	,attrapable
anxiété	,anxiogène
atteindre	,atteignable
mesurer	,mesurable
allonger	,allongeable
détester	,détestable
s’amuser	,amusant
réalisation	,réalisable	,réalisable
croire	,crédible	,crédible
opposer	,opposable
exporter	,exportable
tempête	,exposé
composition	,composable
compenser	,compensable	,compensable
>>>	Anti_∩
écarter	,accepter	,serrer	,choisir
similarité	,différence	;contraste	;dissemblance
encombré	,dégagé
mince	,gros	,obèse
entre les lignes	,noir sur blanc	;en toutes lettres	;explicitement
décolorer	,colorer	,colorer	,colorer	,colorer	,colorer
aube	,crépuscule
identiquement	,différemment
accélérer	,ralentir
bilan initial	,bilan de renouvellement
régional	,national
arriver	,quitter
jeûner	,manger	,bouffer
démêler	,emmêler
amical	,compétitif
encadrer	,désencadrer
liquide	,gazeux	,solide	,gaz	,solide
gratuitement	,à titre onéreux
petit	,long
se poser	,s’envoler
indansable	,dansant
interrompre	,laisser aller	,finir
chaleureux	,froid
dans le sang	,pacifiquement
avoir pied	,se noyer
inclinable	,fixe
se marier	,divorcer
ouvrir la route	,bloquer
parfaire	,bâcler
fantastiquement	,irréellement
détendre	,replier
vallée	,colline
boulimie	,anorexie
boulevard	,empêchement
s’achever	,commencer
quelque part	,nulle part
obésité	,maigreur
réservé	,libre
droit	,courbe
quitter	,arriver	,conserver
écourter	,allonger	,prolonger
silence	,information
pauvre	,riche
protecteur	,ennemi
ignorant	,averti
rétrécir	,s’allonger	,diminuer
diluer	,concentrer
décomplexé	,complexé
d’abord	,accessoirement
réel	,extraordinaire	;imaginaire
près	,exactement	,précisément
s’activer	,ne pas lever le petit doigt
prolonger	,écourter
battre de l’aile	,fonctionner
normal	,pathologique
table	,buffet	,buffet
déplacé	,convenable	,comme il faut
détestable	,adorable
lever	,baisser	,abaisser	,baisser	,instaurer	,dépérir	,s’étioler	,abaisser	,baisser	,rabattre	,dissoudre
chimique	;naturel	;écologique
gazeux	,liquide	,solide
aride	,humide
reste	,totalité
pré-opératoire	,post-opératoire
filer un mauvais coton	,remonter la pente
rêve	,cauchemar
sale	,net	,propre
déglutition	,fausse route
femme mariée	,célibataire
têtu	,accommodant	,arrangeant	,conciliant	,flexible	,souple
défenseur	,ennemi
dégagé	,encombré
clairsemé	,abondant
égoïsme	,altruisme
allonger	,rapetisser	,diminuer	,raccourcir	,réduire	,diminuer	,réduire	,abréger	,écourter	,raccourcir	,réduire	,diminuer	,raccourcir	,concentrer	,raccourcir	,replier
élargir	,diminuer
manger	,jeûner	,ne pas manger	,articuler	,restituer
couché	,debout	,debout	,levé	,sur pied	,debout	,verticalement	,debout
raccourcir	,agrandir	,allonger	,rallonger	,allonger
totalité	,partie
suivant	,dernier
cocagne	,famine
davantage	,moins
léger	,gros
terrestre	,extraterrestre
autour	,loin
ambitieux	,modeste
lumineux	,bête	,idiot
tourner rond	,marcher sur la tête
opposition	,analogie
paralytique	,valide
bonté	,méchanceté
intelligent	,bête	,idiot
comprendre	,nager
refroidir	,refroidir	,chauffer
replier	,déplier	,allonger	,étendre	,détendre	,tendre	;déployer
se pencher	,s’incliner
divorce	,mariage
illusion	,réalité
rengainer	,dégainer
>>>	Real_1
plateau	,porter	;apporter	,transporter	,manger
cheval	,manger
marche	,faire	,participer	<ouvrir	,fermer	,faire	,composer	,monter
ancre	,jeter
pioche	,piocher
couleurs	,afficher	;arborer	,porter
escargot de Bourgogne	,élever	;ramasser
conflit	,avoir maille à partir
allée	,se promener
obstacle	,franchir	;escalader
personnel	,bosser	,œuvrer	,travailler	,travailler
la pluie et le beau temps	,parler
bus	,conduire
carte de visite	,donner	,laisser
accent	,mettre	,accentuer	,mettre	,accentuer
marche arrière	,passer
manteau	,avoir	,porter
pipe	,fumer
pont	,traverser
canapés	,manger
office	,remplir
bifteck	,manger	,gagner
cerf-volant	,faire voler
couleur	,appliquer	;étaler	;mettre	;teindre	;colorer	;colorier	,porter
tempête	,affronter	,braver	,défier	,lutter	,faire face
gifle	,donner	,mettre	,donner
pédale	,appuyer	,actionner	,appuyer
yaourt	,manger	,manger
mail	,se promener
robe	,avoir	,porter	,porter
nuisette	,avoir	,porter	;dormir
petit-gris	,élever	;ramasser
canapé	,asseoir	,occuper
régime	,suivre
toilette	,avoir	,porter
pédales	,appuyer
trottinette	,faire	,jouer	,se déplacer	,rouler
fonction	,remplir	,servir	,remplir	,remplir
administrateur	,administrer
piano	,jouer
limite d’âge	,atteindre
claque	,donner	,mettre
fesses	,s’asseoir
chemin de fer	,emprunter	,prendre	,utiliser
bêche	,bêcher
bureau	,travailler	,travailler	,travailler
biberon	,donner
chaussons	,avoir	,porter	,avoir	,porter
lac	,remplir
ascenseur social	,bénéficier	,profiter
toasteur	,toaster
champagne	,boire	,déguster
aile	,battre	,voler	;planer
conte de fées	,raconter
serviette	,essuyer	,sécher	,avoir	,porter
dette	;honorer	,régler	;acquitter	,payer
promenade	,se promener
orbite	,décrire	,orbiter
vêtement	,porter	;avoir
jour	,éclairer
continent	;demeurer	,habiter	,séjourner	,vivre
urine	,uriner	,pisser
jour des Morts	,célébrer	,commémorer
relâche	,faire
course	,courir	;courir	;disputer	,assister	<jouer	,parier	,gagner
quatre-heures	,goûter
parfum	,porter
boisson chaude	,boire
aimer	,aimer
bouchon d’oreille	,mettre
alcool	;consommer	;boire	,picoler	,boire	,picoler	,s’alcooliser
guidon	,tenir	;tourner
mouche	,avoir	,porter	,avoir	,porter
expérience	,expérimenter	,expérimenter
klaxon	,actionner	,klaxonner
serpillière	,passer
cadenas	,cadenasser
râpe	,râper
bélier	,enfoncer
carton rouge	,sortir	;dégainer	;brandir
animal	,avoir	,posséder
dent	,laver	,brossé	,entraîner	,montrer les dents
maison	,habiter
cercueil	,avaler	,boire	,consommer	,picoler
torchon	,passer
mesure	,prendre
soupe	,manger	,avaler
chiffre	,écrire	,tracer	,chiffrer
rôle	,remplir
xylophone	,faire	,jouer
mission	,remplir
soutif	,porter
seins	,donner	,allaiter	,donner le sein	;montrer	,dévoiler
vin	,consommer	;déguster	;boire	,picoler
proverbe	,citer
drap	,dormir
roupillon	,piquer
quarantaine	,respecter
brosse	,passer
balai	,passer	;manier	;jouer	,passer
>>>	V_0
gémissements	,gémir
collaboration	,collaborer	,collaborer
aplatissement	,aplatir
explication	,expliquer	,expliquer	,expliquer	,expliquer
résignation	,se résigner
voussoiement	,voussoyer
habitation	,habiter
désespoir	,désespérer	,désespérer
dépannage	,dépanner
épluchage	,éplucher	,éplucher
élaboration	,élaborer
vieillissement	,vieillir
heurt	,heurter
contradiction	,contredire
accomplissement	,accomplir	,s’accomplir	,accomplir	,s’accomplir
apitoiement	,s’apitoyer
équivalence	,équivaloir
suffrage	,voter
chuchotis	,chuchoter
sortie	,sortir
entretien	,s’entretenir	,entretenir
barrissement	,barrir
consolation	,consoler
plongeon	,plonger
exploitation	,exploiter
gâchis	,gâcher
croyance	,croire
rédaction	,rédiger
permission	,permettre
accord	,s’accorder
justification	,justifier
semis	,semer
appréciation	,apprécier
exaspération	,exaspérer
fourniture	,fournir
impression	,imprimer	,imprimer
relecture	,relire
conduite	,se conduire	,conduire	,conduire	,conduire	,conduire
prétention	,prétendre
identification	,identifier
succession	,succéder
ronflement	,ronfler
marche	,marcher	,marcher	,marcher	,marcher
déjeuner	,déjeuner
respiration	,respirer
usure	,user
louvoiement	,louvoyer
grignotage	,grignoter
trahison	,trahir
jouissance	,jouir	,jouir
destination	,destiner
opération	,opérer
hésitation	,hésiter	,hésiter
amaigrissement	,maigrir
ajustement	,ajuster
remerciement	,remercier
insistance	,insister
parution	,paraître
pansement	,panser
habillement	,s’habiller	,habiller
arrachage	,arracher
résurrection	,ressusciter
détournement	,détourner	,détourner
protestataire	,protester
crevaison	,crever
destruction	,détruire	,détruire
rassemblement	,rassembler
haine	,haïr	,haïr
labour	,labourer
tentation	,tenter
avance	,avancer
berçant	,bercer	,bercer
dégagement	,dégager
massacre	,massacrer
étirement	,s’étirer
tabassage	,tabasser
vaccination	,vacciner
manque	,manquer	,manquer	,manquer	,manquer	,manquer
maîtrise	,maîtriser
baragouinage	,baragouiner	,baragouiner
tordu	,tordre
consultation	,consulter
résonance	,résonner	,résonner
accrochage	,accrocher
hébergement	,héberger	,héberger
prévention	,prévenir
balade	,se balader
signature	,signer
angoisse	,angoisser	,s’angoisser
désespéré	,désespérer
aéroporté	,aéroporter
transfert	,transférer	,transférer
depuis	,commencer
annonce	,annoncer
prévision	,prévoir
aide	,aider
soupçon	,soupçonner
compassion	,compatir
rupture	,rompre	,se rompre
critique	,critiquer	,critiquer
>>>	S_3
baromètre	,temps
bouchère	,client	,cliente
réaction	,réaction	,réaction
téléspectatrice	,télévision
loyer	,location
voter	,élection
prénommer	,prénom
député	,circonscription
tirage	,tirage
parier	,mise
vocabulaire	,langue
déshabiller	,habits	,vêtements
somme	,somme
dieu	,culte
abandonner	,sportif	,sportive
nourrir	,nourriture
télévision	,téléspectateur	,téléspectatrice
expédier	,destinataire	,destinataire
téléphone	,opérateur
victoire	,bataille	;guerre
comprimé	,substance active
visser	,vis
accusation	,objet	;motif
produit	,consommateur
encadrer	,cadre
vendre	,acheteur	;acheteuse
arracher	,arracheuse
coup de grâce	,coup de grâce
travailler	,employeur	,employeuse	,patron	,patronne	;employeur
collège	,collégien	,collégienne
consolation	,consolation
subvention	,subvention
poissonnerie	,client	,cliente
louange	,louange
couvre-feu	,heure
sentiment	,sentiment
récompense	,récompense
empoisonner	,poison
tourner	,acteur	,actrice
charcuterie	,client	,cliente
enveloppe	,destinataire	,destinataire	,bénéficiaire	,bénéficiaire
mairie	,administré	,administrée
accès	,accès
course	,taxi	;fiacre
financement	,financement
admiration	,objet	,source
clinique	,soins
armer	,arme	;armement
piéger	,piège
débiteur	,dette
remplaçant	,compétition
multiplier	,multiplicateur
unanimité	,élection	;vote
administrable	,administrateur
botter les fesses	,faute
tailler	,vêtement
compte	,banque
cirer	,cire
baser	,base
habiller	,habits	,vêtements
grandeur	,unité de mesure
ministre	,gouvernement	,état
différence	,différence
voler	,volé
mesure	,mesure	,mesure
leçon	,élève	,élève	,collégien	,collégienne	,lycéen	,lycéenne	,étudiant	,étudiante
menuisière	,bois
améliorer	,amélioration
boulangère	,client	,cliente
emprunté	,emprunteur	,emprunteuse
similitude	,similitude	,point commun
pâtisserie	,cliente	,client
accentuation	,accent	,accent
inspecteur	,inspection
bombarder	,bombe	,bombardier
décharger	,chargement
boulanger	,client	,cliente
exonérer	,taxe
coup de feu	,arme à feu
diriger	,direction
coiffage	,peigne	,brosse
teindre	,teinture	,coloration
lectorat	,éditeur
louer	,locataire	,locataire	,locataire	,locataire
musique	,auditeur	,auditrice
facture	,client	,cliente
bagage	,domaine	,discipline
drame	,comédien	,comédienne
rapporter	,rapport
hypermarché	,client	,cliente	,clientèle
visiter	,affaires	;charité
tracasser	,tracasserie
compensation	,compensation
combat	,sport de combat
épicerie	,client	,cliente
analogie	,analogie	,point commun
fonder	,fondement
juge	,tribunal
bilan	,patient
roi	,sujet	,sujette
>>>	A_1
agrammaticalité	,agrammatical
flotter	,flottant
appauvrir	,appauvrissant
orage	,traverser	,orageux
bel homme	,bel homme
excentricité	,excentrique	,excentrique	,excentrique	,excentré
rabat-joie	,rabat-joie
Turquie	,turc
étrangeté	,étrange
rapidité	,rapide	,rapide
fixité	,fixe	,fixe
symbole	,symbolique
ne plus être	,mort
avare	,avare	,avare
diriger	,directeur	,dirigeant
sinophone	,sinophone	,sinophone
ivrogne	,ivrogne	,ivrogne
flocons	,en
se résigner	,résigné
présence	,présent
saint	,saint
tomber	,tombant
casser les couilles	,casse-couilles
huppe	,huppé
bienveillance	,bienveillant
Amérique	,américain
marcher	,en marche	,allumé	,en service
pédé	,pédé
joie	,joyeux
curiosité	,curieux	,curieux
apeurer	,apeuré
exploser	,explosif
perfection	,parfait
illusoirement	,illusoire
précéder	,précédent
coopérer	,coopérant
nécessaire	,nécessaire
religiosité	,religieux
carré	,carré
extrême	,extrême
sexe	,sexué
majorité	,majoritaire	,majeur
imparité	,impair
douche	,à	,sous
pudeur	,pudique
oubliettes	,à
savoir	;capable	;savant
songer	,songeur
envelopper	,enveloppant
voyant	,voyant
pénétrer	,pénétrant
Breton	,breton
mécontentement	,mécontent
tuberculose	,tuberculeux
riche	,riche	,riche
couardise	,couard
sueur	,en	;mouillé
tyran	,tyrannique
âge	,âgé	,âgé	,âgé
ne tenir qu’à un cheveu	,fragile
ivrognesse	,ivrogne
agacement	,agacé
moderne	,moderne	,moderne
titulaire	,titulaire
dangerosité	,dangereux
ignorer	,ignorant
boitement	,boiteux
grâce	,gracieux
méchanceté	,méchant	,méchant
islam	,musulman
s’inquiéter	,inquiet
exemple	,exemplaire
s’ébahir	,ébahi
compréhension	,compréhensif
collaboration	,collaborateur
faire attention	,attentif
guillemets	,entre
sapidité	,sapide
paralysie	,paralysé	;paralytique
bienheureux	,bienheureux
déclarer	,déclarant
débuter	,débutant	,débutant
défendre	,défensif
solidité	,solide	,solide
accident	,accidenté
Bretonne	,breton
trébuchement	,trébuchant
violence	,violent	,violent	,violent
protester	,protestataire
États-unien	,états-unien
début	,débutant
souci	,soucieux
odeur	,odorant
exactitude	,exact
crainte	;saisi	<plein	,hanté	,obsédé
adolescente	,adolescent
près	,proche	,proche
Grèce	,grec
barbe	,barbu
surprendre	,surprenant
>>>	S_2^prototyp
moudre	,café	,blé
s’asseoir	,chaise	,fauteuil	,siège
main droite	,instrument de musique
dépression	;fluide	;gaz	,liquide
pâte	,pain	,pizza	,gâteau	,tarte	,biscuit	,beignet	,chou	,crêpe	,gaufre
placarder	,avis	,affiche
débit	,bois
tuile	,amande
passer	,passage	,passage
porteur	,chèque
pompe	,produit
menottes	,main	,poignet	,bras	;prisonnier	,prisonnière
depuis	,date	;moment	,moment
enveloppe	,lettre	,document
automobile	,automobile
traite	,vache
coton	,plaie
soufflé	,fromage	,chocolat
chou	,crème
théâtre	,accident	;drame
fauteuil	,conseil	;conseil d’administration
bouché	,bouchon
escargot	,raisin
célébrante	,mariage	;messe
soucoupe	,tasse
vissé	,chaise
tablette	,chocolat
amarre	,bateau
main gauche	,instrument de musique
réserviste	,armée	,police
machine à coudre	,tissu
célébrer	,mariage	;messe
vestiaire	,cliente	,client
enregistré	,registre
lire	,livre	;magazine
border	,lit	;drap	,couverture	,enfant	,enfant
fromage	,brebis	,chèvre	,vache
miellerie	,miel
réduire	,image	,photographie
fondant	,chocolat
assise	,siège
chausson	,pomme
transporté	,admiration
lait	,nourrisson	;bébé	,enfant	,enfant	,nouveau-né	,nouvelle-née	;petit	,petite
nappe	,table
plan	,film
élément	,société	,armée
effiler	,cheveu	,cheveux
avion	,passager	,passagère	,voyageur	,voyageuse	;cargaison	,fret
factrice	,courrier	,lettre	;colis	,paquet	,clavecin	;flûte	;orgue	;piano
chaussée	,véhicule roulant	,véhicule
bol	,soupe
mise en scène	,photographe	,photographe
condamner	,accusé	,accusée
peindre	,peinture
casque	,ordinateur	,télévision	,baladeur
averse	,neige	;grêle	;pluie	;cendre
facteur	,courrier	,lettre	;colis	,paquet	,clavecin	;flûte	;orgue	;piano
ébloui	,lumière
avoir des nouvelles	,avocat
boulangère	,pain	;viennoiserie
gratter	,guitare	,gratte
aspirateur	,poussière
cultiver	,plante
moelleux	,chocolat	,citron	,orange
partie	,chasse	,pêche
bracelet	,chevilles	;poignet
compatir	,douleur	;malheur	;tristesse
patient	,médecin	,médecin	,docteur	,docteure
orbiter	,astre	;étoile
bétonné	,béton
table	,restaurant	,auberge
lin	,huile	;huile
bruyère	,pipe
résultat	,compétition
escalader	,montagne	;rocher	,col	,côte
téléphone	,répondant	,répondante
détourner	,regard
architecture	,construction	,bâtiment
peigner	,cheveux
adoption	,loi
symptomatique	,maladie
éclairé	,lampe
personne	,âgé	,seul
victime	,maladie	;accident	;catastrophe
signature	,courriel
avoir	,propriété
analogie	,organe
assis	,siège	,fauteuil	,chaise
s’allonger	,lit
rôti	,bœuf	,porc
porter	,vêtement	;pièce d’habillement
nez	,fruit	,fruit rouge	,cerise	,framboise	;épice
profaner	,tombe
mobiler	,pièce
arrêt	,bus
recouvert	,tissu
piloter	,avion	,avionnette	,hélicoptère	,auto	,automobile	,voiture	;bateau
simplification	,fraction	,expression
s’éponger	,front
>>>	Syn_⊃^sex
malchanceux	,malchanceuse
gourmand	,gourmande
inconnu	,inconnue
boit-sans-soif	,boit-sans-soif
informaticien	,informaticienne
chef de bord	,chef de bord
cornichon	,cornichonne
directeur	,directrice
faussaire	,faussaire
poète	,poétesse
toilier	,toilière
passant	,passante
chrétien	,chrétienne
passionné	,passionnée	,passionnée
jazzman	,jazzwoman
parent	,parente
siffleur	,siffleuse
rival	,rivale
obèse	,obèse
enseignant	,enseignante
renard	,renarde
débutant	,débutante
candidat	,candidate
bagarreur	,bagarreuse
karatéka	,karatéka	,karatékate
blessé	,blessée
méchant	,méchante
singe	,guenon
demandeur	,demanderesse	,demandeuse
priseur	,priseuse
provocateur	,provocatrice
Sud-Coréenne	,Sud-Coréen
blagueur	,blagueuse
rédacteur	,rédactrice
interviewé	,interviewée
volleyeur	,volleyeuse
hospitalisé	,hospitalisée
pizzaiolo	,pizzaiola
paralytique	,paralytique
lanceur	,lanceuse
client	,cliente
traducteur	,traductrice
notaire	,notaire
guetteur	,guetteuse
chéri	,chérie	,chérie
supérieur	,supérieure
fromager	,fromagère
actionnaire	,actionnaire
aviculteur	,avicultrice
démolisseur	,démolisseuse
citoyen	,citoyenne
ravisseur	,ravisseuse	,ravisseuse
cabochard	,cabocharde
dominateur	,dominatrice
soldat	,soldate	,soldat
vérificateur	,vérificatrice
citadin	,citadine
bavard	,bavarde
collaborateur	,collaboratrice	,collaboratrice	,collabo
panseur	,panseuse
bodybuilder	,bodybuildeuse
petit	,petite
joggeur	,joggeuse
nain	,naine	,naine
gosse	,gosse	,gosse
élu	,élue
militaire	,militaire
linguiste	,linguiste
débitant	,débitante
trouillard	,trouillarde
bossu	,bossue
laveur	,laveuse	,laveuse
démonteur	,démonteuse
caravanier	,caravanière
politique	,femme politique
misogyne	,misogyne
encadreur	,encadreuse
interprète	,interprète	,interprète
mouton	,brebis
administrateur	,administratrice
SDF	,SDF
sans-logis	,sans-logis
Australien	,Australienne
actif	,active
boucher-charcutier	,bouchère-charcutière	,bouchère-charcutière
nageur	,nageuse	,nageuse
héros	,héroïne	,héroïne
Nord-Coréen	,Nord-Coréenne
écrivain	,écrivaine
adoptant	,adoptante
acquéreur	,acquéreuse
démocrate	,démocrate
fondeur	,fondeuse
répondant	,répondante
altiste	,altiste
perturbateur	,perturbatrice
pêcheur	,pêcheuse
jeûneur	,jeûneuse
riverain	,riveraine
monarchiste	,monarchiste
>>>	Adv_0
cordial	,cordialement
supérieur	,supérieurement
origine	,originellement
diable	,diaboliquement
direct	,directement
intellectuel	,intellectuellement
évident	,évidemment
ordinaire	,ordinairement
hypocrite	,hypocritement
fille	,filialement
habituel	,habituellement
exception	,exceptionnellement	,exceptionnellement
nécessaire	,nécessairement
entier	,entièrement
tardif	,tard
allusif	,allusivement
exactitude	,exactement
volontaire	,volontairement
probable	,probablement
excepter	,exceptionnellement
juste	,justement
agréable	,agréablement
sage	,sagement
réalité	,réellement
uniforme	,uniformément
évidence	,évidemment
concept	,conceptuellement
curieux	,curieusement	,curieusement
lamentable	,lamentablement
splendide	,splendidement
brosse	,en	,à
adroit	,adroitement	,adroitement
courant	,couramment
national	,nationalement
instant	,instantanément
antérieur	,antérieurement
rigide	,rigidement
lâche	,lâchement
aucun	,aucunement
aimable	,aimablement
pudique	,pudiquement
artificiel	,artificiellement
superbe	,superbement
médiocre	,médiocrement
sinistre	,sinistrement
humble	,humblement
voix	,vocalement
anonyme	,anonymement
synthétique	,synthétiquement
atomique	,atomiquement
continuité	,continûment
musculaire	,musculairement
nuit	,nuitamment
ingrat	,ingratement
limite	,limite
adorable	,adorablement
invincible	,invinciblement
geste	,gestuellement
dynamique	,dynamiquement
individu	,individuellement
technique	,techniquement
ingratitude	,ingratement
molécule	,moléculairement
cerveau	,cérébralement
poésie	,poétiquement
généreux	,généreusement
formel	,formellement	,formellement	,formellement	,formellement
région	,régionalement
authentique	,authentiquement
drame	,dramatiquement
partiel	,partiellement
automatique	,automatiquement
force	,fort	,fortement
corporel	,corporellement
inconscient	,inconsciemment
vaste	,vastement
naïveté	,naïvement
continuel	,continuellement
matin	,matinalement
après-coup	,après coup
effectif	,effectivement
élastique	,élastiquement
violent	,violemment
honnête	,honnêtement	,honnêtement	,honnêtement
intime	,intimement
exprès	,expressément
anormal	,anormalement
lenteur	,lentement
bizarre	,bizarrement
frère	,fraternellement
similaire	,similairement
précoce	,précocement
intense	,intensément
implicite	,implicitement
moyen	,en moyenne	,moyennement
sourd	,sourdement
père	,paternellement
collectif	,collectivement
dieu	,divinement
profession	,professionnellement
>>>	S_instr
prêcher	,sermon
triangle	,baguettes
punaiser	,punaise
matraquer	,matraque
laver	,douche	,baignoire	,lavabo
coup de poing	,coup de poing
sucer	,bouche	,lèvres	,bouche
escalader	,bicyclette	,vélo
vol	,avion
coiffeuse	,ciseaux	;brosse	,peigne	;sèche-cheveux
médecin	,stéthoscope	,stéthoscope
bain	,baignoire
imaginer	,imagination
respirer	,nez	,narines	,narine
voyager	,avion	,autocar	,train	,voiture
allaiter	,seins
empoigner	,main
doucher	,douche
zapper	,télécommande
s’éventer	,éventail
déboucher	,tire-bouchon
boulangère	,pétrin	;four
sentir	,nez	;nez
observer	,microscope	,loupe	,lunette
donner le sein	,seins
jogging	,baskets
éventer	,éventail
dentiste	,davier	;fraise	;roulette	,davier	;fraise	;roulette
musique	,instrument de musique	,instrument de musique	,instrument de musique
crucifier	,croix
plein	,pompe
basket	,ballon	;panier
boucher	,couteau	;crochet	,esse
piquer	,seringue
klaxon	,klaxon
flûte	,flûte
seller	,selle
articuler	,articulateur
tennis	,balle	;raquette	;filet
se doucher	,douche
lavis	,pinceau
battre	,fouet	,batteuse
volley-ball	,ballon	;filet
klaxonner	,klaxon
ramer	,rame	,rame
douche	,douche	;fleur de douche
téléphoner	,téléphone
tout oreilles	,oreilles
plage	;parasol	,paillasse	,tapis de plage	;maillot	,serviette	;bouée	,palmes	,masque	,tuba
karaté	,kimono	,karatégi
escalade	,bicyclette	,vélo
aller	,moyen de transport
goût	,langue	;papilles	;palais
moudre	,moulin	;moulin à café
orchestre	,instrument de musique
football	,ballon	;buts	,cage
se réveiller	,réveil
bêcher	,bêche
gauche	,main gauche
pompier	,camion	;lance	;bouche d’incendie	,camion	;lance	;bouche d’incendie
ping-pong	,balle	;raquette	;ping-pong	,table de ping-pong
boulanger	;pétrin	;four
hold-up	,arme
voler	,aile	,avion	,avion
adapter	,adaptateur
uriner	,urinoir	;toilettes
se laver	,lavabo	,baignoire	,douche	;savon	,gel douche
courriel	;boîte mail	;serveur
imprimer	,presse	;imprimante
entendre	,oreilles
faire de l’essence	,pompe
violon	,archet
dormir	,lit
voiture	,voiture
coudre	,dé à coudre	;machine à coudre	,machine à coudre
coiffeur	,ciseaux	;brosse	,peigne	;sèche-cheveux
droit	,main droite
mécanicien	,outil
communication	,téléphone
clôturer	,clôture
radio	,radio
mesure	,mètre	,règle	;instrument de mesure
poignarder	,poignard
renifler	,nez	;nez
chant	,larynx	,corde vocale
nourrir	,seins
coup de couteau	,couteau
rugby	,ballon	;buts	,poteaux
cirer	,cire	,cirage
pieuter	,lit	,pieu	,paddock	,pageot
harnacher	,harnais
trajet	,bus	,tramway
skier	,skis
crayonner	,crayon
tourner	,caméra
se baigner	,baignoire
boxe	,gants
crime	,arme
condamner	,jugement	,verdict
toilette	,gant de toilette	,linge	,objet	,parure	;gel douche	,produit	,savon	;affaires	,nécessaire
>>>	Syn_⊂
ski de fond	,skis	,ski
chef-lieu	,ville
tomate cerise	,tomate
gymnastique	,séance
hard rock	,rock
barbu	,poilu	,sexe
se lever du pied gauche	,se lever
primaire	,enseignement
se remettre	,se mettre
analogie	,analogie	,similarité
enfant	,fruit	,produit	,fruit	,produit	,jeune
aéronef	,véhicule
abbé	,prêtre
chiffon rouge	,sujet
herbe	,drogue
vif	,grand
coup de poing	,coup
parallèle	,droite
eau de mer	,eau
en venir aux mains	,se battre
main gauche	,main	,main	,jeu
piquette	,vin
directoire	,organe
présomption	,supposition
navet	,film
carrosse	,voiture
ski de piste	,skis	,ski
chasser les mouches	,parer
apôtre	,disciple	,partisan
intervalle	,écart
corsaire	,pantalon
détraqué	,déréglé	,déréglé
barre franche	,instrument
triomphal	,enthousiaste
stratégique	,important
départ	,lieu
chaussons	,chaussures
baril	,quantité
aliter	,allonger
se livrer	,faire
essence de térébenthine	,essence
vin de glace	,vin
auto-tamponneuse	,véhicule
chant	,partie
capteur	,antenne
blanchir	,devenir	,changer	,peindre
pétrel-tempête	,pétrel
raison	,cause
subdivision	,division	,partie
toasté	,grillé
en portefeuille	,plié
déconvenue	,déception
fortune	,somme	,évènement
coup d’œil	,regard
coma	,sommeil	,léthargie
défunt	,mort	,mort
fonder	,créer
brune	,cigarette
renforcer	,rendre
réprimer	,empêcher
craspec	,sale	,sale	,sale	,sale
crise économique	,crise
avis	,annonce
catastrophe naturelle	,catastrophe
cheveux d’ange	,pâtes
nageoter	,nager
état mental	,état psychique
minorer	,diminuer
rigoler	,rire
pleuvoir	,tomber
macchabée	,corps
pigeon	,victime	,chéri	,chérie	,trésor
amas	,accumulation
charbon	,matière
douze	,douzaine
aplati	,nonchalant	,détruit
regard	,ouverture
chagrin	,cuir
guêpier	,nid
patrimoine d’affectation	,patrimoine
pré carré	,domaine
chute	,reste	,déplacement
point de vue	,lieu	,lieu
superbe	,beau
tête dure	,entêtement
immergé	,recouvert
agoraphobe	,phobique	,phobique
aux cent coups	,inquiet
crédit-bail	,location
à fleur de peau	,sur	,sensible
giboulée	,averse	,pluie
traduction	,équivalent
baragouiner	,parler	,parler	,parler
déformation professionnelle	,habitude
république	,état
rougeur	,tache
peloton	,groupe	,groupe
nez	,avant	,cap
maison centrale	,prison
premier entré, premier sorti	,calcul
>>>	Syn
photographique	,photo
texto	,sms
bus	,autobus
furibond	,furibard
express	,expresso
réseau express régional	,R.E.R
baiser	,bisou
non audible	,inaudible
sèche	,cancéreuse	,cibiche	,cigarette	,clope	,garo	,tige	,schmer
dictionnaire	,dico
nues	,nuage
pompier	,pomplard	,sapeur-pompier	,pin-pon	,pipe	,turlute	,fellation	,femme pompier	,sapeur-pompier	,pompière	,sapeuse-pompière
cafard	,blatte
banc de mesure	,banc de test
écolo	,écologiste	,écologiste
rugbyman	,rugbywoman
sweat	,sweat-shirt
professeur	,prof
succinct	,sommaire
pillard	,pilleur
boulangerie	,boulange
goguenots	,gogues	,tartisses	,cagoinces	,chiottes	,cabinets	,toilettes	,W.-C.	,waters	,water-closet	,petit endroit	,vécés	,wawas	,cabinet d’aisances	,commodités	,lieux d’aisances	,sanitaires	,gogues	,tartisses	,cagoinces	,chiottes	,pipi-room	,tinettes	,vécés	,wawas	,cabinets	,petit coin	,toilettes	,W.-C.	,waters	,water-closet	,cabinet d’aisances	,commodités	,lieux d’aisances	,sanitaires
haute société	,haute
éructation	,rot
popotin	,paire de fesses	,cul	,derrière	,panier	,arrière-train	,postérieur	,séant	,miches	,pétard	,croupe	,croupion	,fessier	,derche	,lune
pull	,pull-over
avancée	,avance
jam-session	,jam	,bœuf
gastrique	,stomacal
paternel	,dab	,daron	,pater	,père
batraciens	,amphibiens
bouquet	,bosquet
poubelle	,corbeille
folle	,tante	,tantouze	,tapette	,tata
frangine	,sœurette	,sœur
valeur intrinsèque	,valeur réelle
femme médecin	,docteure	,médecin	,doc	,toubib	,doctoresse
système d’alarme	,alarme
coup de téléphone	,appel	,coup de bigophone	,coup de fil
louage	,location
dix mille	,10 000
musulman	,islamique
étron	,crotte	,caca	,merde
préparation alimentaire	,préparation
nombril	,ombilic
veste	,gamelle	,râteau
submicroscopique	,microscopique
champagne	,champ
F7	,sept-pièces	,T7
F5	,cinq-pièces	,T5
modif	,modification
océane	,océanique
avoir le vent en poupe	,avoir le vent dans le dos	,avoir le vent dans les voiles
trois	,3	,3	,3	,3
quelqu’un	,qqn
Les mains en l’air!	,Haut les mains !
se dégarnir	,se déplumer
binouze	,bière
crado	,crasseux	,cracra	,cradingue	,craspec	,crade	,cradoque	,cracra	,crade	,cradingue	,cradoque	,cracra	,crade	,cradingue	,cradoque	,craspec	,crasseux	,cracra	,crade	,cradingue	,cradoque	,crasseux	,crasseux	,crade	,cracra	,crade	,cradingue	,cradoque	,craspec	,cradingue	,cracra	,crade	,craspec
douche dorée	,pluie dorée
barbe	,barbouze
personnel	,perso
peur	,frousse	,trouille
chasseresse	,chasseuse
coco	,communiste	,rouge	,communiste	,rouge	,communiste	,rouge	,communiste	,rouge	,noix de coco	,cocotier
angélique	,d’ange
stop	,auto-stop
confiote	,confiture
sœurette	,frangine	,sœur
hosto	,hôpital
table de nuit	,table de chevet
affaires	,business
lac	,citerne	,sinus
boisson	,alcool	,alcoolisme
émigrant	,émigré
renoncement	,abandon
gamine	,gosse	,enfant	,gosse	,enfant
bouée	,pneu
coupe-tif	,merlan	,coiffeur	,coiffeuse
laid	,moche
-phobie	,phobie	,phobie
verge	,pénis	,bistouquette	,braquemart	,manche	,membre	,nouille	,teub	,bite	,pine	,queue	,zob	,biroute	,chibre	,moineau	,quéquette	,zigounette	,zizi
carte de crédit	,carte bleue
paysannerie	,paysannat
homme politique	,politique
rhinocéros	,rhino
l’air de rien	,sans en avoir l’air
sms	,texto
200	,deux cents
hâtif	,rapide
supportrice	,supporter
en 2 dimensions	,en 2D
bicross	,BMX
mère porteuse	,mère d’emprunt	,mère de substitution
coup de bigophone	,coup de fil	,appel	,coup de téléphone
kaki	,plaqueminier
tuer père et mère	,vendre père et mère
sommeiller	,dormir	,dormir
sans en avoir l’air	,l’air de rien
situé	,sis
>>>	S_1Pred
extraterrestre	,extraterrestre	,extraterrestre
voyant	,voyant	,voyante
espagnol	,Espagnol	,Espagnole
américain	,Américain	,Américaine	,Américain	,Américaine
sourd	,sourd	,sourde	,bruit
mâle	,mâle
pauvre	,pauvre	,pauvre
féminin	,femme
couard	,couard	,couarde
aveugle	,aveugle	,aveugle
gourmand	,gourmand	,gourmande
lusophone	,lusophone	,lusophone
vieux	,vieux	,vieille
boulimique	,boulimique	,boulimique
rival	,rival	;rivale
anglais	,Anglais	,Anglaise
insulaire	,insulaire	,insulaire
mineur	,mineur	,mineure
asiatique	,Asiatique	,Asiatique
criminel	,crime	,crime	,crime
jeune	,jeune	,jeune
turc	,Turc	,Turque
suédois	,Suédois	,Suédoise
inconnu	,inconnu	,inconnue
agressé	,agressé	,agressée
juif	,juif	,juive
fouetteur	,fouetteur	,fouetteuse
moche	,moche	,moche	;mocheté
breton	,Breton	,Bretonne
coréen	,Coréen	,Coréenne
germanique	,Germanique	,Germanique
excentrique	,excentrique	,excentrique	,excentricité
boche	,Boche	,Boche
franc	,Franc
tyrannique	,tyran
débutant	,débutant	,débutante
obèse	,obèse	,obèse
aîné	,aîné	,aînée
belge	,Belge	,Belge
anonyme	,anonyme	,anonyme
germanophone	,germanophone	,germanophone
alcoolique	,alcoolique	,alcoolique
célibataire	,célibataire	,célibataire
connerie	,con
célèbre	,célébrité
ordinaire	,ordinaire
italien	,Italien	,Italienne
femelle	,femelle
affirmatif	,affirmative
nul	,nul	,nulle
autochtone	,autochtone	,autochtone
canadien	,Canadien	,Canadienne
titulaire	,titulaire
gazeux	,gaz
hospitalisé	,hospitalisé	,hospitalisée
handicapé	,handicapé	,handicapée
merveilleux	,merveille
puni	,puni	,punie
bon	,bon
victorieux	,vainqueur
héroïque	,héros	,héroïne
grec	,Grec	,Grecque
arabe	,Arabe	,Arabe
blessé	,blessé	,blessée
chrétien	,chrétienne	,chrétien
mauvais	,mauvais
vivant	,vivant	;vivante
riverain	,riverain	,riveraine
québécois	,Québécois	,Québécoise
favori	,favori	,favorite
bavard	,bavarde	,bavard
frisé	,frisé	,frisée
orphelin	,orphelin	,orpheline	,orphelin	,orpheline	,orphelin
xénophobe	,xénophobe	,xénophobe
muet	,muet	,muette
adulte	,adulte	,adulte
mexicain	,Mexicain	,Mexicaine
enfant	,enfant	,enfant
hollandais	,Hollandais	,Hollandaise
timide	,timide	,timide
rusé	,rusé	,rusée
indiscret	,indiscret	,indiscrète
idiot	,idiot	,idiote
original	,original	,original
court	,vin
bossu	,bossu	,bossue
futé	,futé	,futée
long	,vin
prédateur	,prédateur
débrouillard	,débrouillard	,débrouillarde
rouge	,rouge	,rouge
imbécile	,imbécile	,imbécile
acquéreur	,acquéreur
européen	,Européen	,Européenne
bouddhiste	,bouddhiste	,bouddhiste
pair	,nombre	;chiffre
miraculé	,miraculé	,miraculée
irlandais	,Irlandais	,Irlandaise
laid	,laid	,laide
carié	,dent
>>>	S_2
s’appeler	,nom	,nom
erreur	,erreur	,erreur
ameublement	,pièce d’ameublement	;meuble
médicament	,maladie	,trouble
prévision	,prévision	,prévision
fusil	,cible
poids	,poids
bureau	,personnel	,ordinateur
téléphone	,correspondant	,correspondante
vilain	,vilenie
symbolique	,valeur symbolique
souvenir	,souvenir
car	,passager	,passagère	,usager	,usagère	;voyageur	,voyageuse
bouche d’égout	,égout
éplucheur	,fruit	,légume
semeur	,semence	;graine
colis	,contenu
trayeuse	,lait
toasteur	,pain	;tartine	,toast
chèque	,montant
aîné	;cadette	,puînée	,puîné	,cadet
chirurgienne	,chirurgie
église	,fidèle
équivalent	,équivalent
réagir	,produit
tailler	,pipe
exclure	,individu
sac	,sac	;contenu
chien de chasse	,chasse
résultat	,calcul	,opération
crayon	,lèvres	;paupières
champ d’investigation	,chercheur	,chercheuse
haras	,cheval
imposer	,contribuable	,contribuable
mettre les petits plats dans les grands	,hôte	,hôte	;visiteur	,visiteuse	;convive	,convive	,visiteur	,visiteuse
insecticide	,insecte
hospitalité	,hôte	,hôte
factrice	,courrier
lexicographie	,lexique
week-end	,semaine
gribouillage	,gribouillage	,gribouillis	,gribouillage
défaite	,gagnant	,gagnante	;vainqueur
avocate	,client	,cliente	,cause
pelage	,peau
en garder sous la pédale	,course
honte	,honte
station	,activité
plage	,enregistrement
graine	,semeur	,semeuse
empoisonné	,poison
sous l’effet	,cause
timonier	,bateau
cinéaste	,film
crime	,victime	,victime
metteur en scène	,film	,film
posséder	,possession	;propriété	,bien
avare	,argent
arbitrer	,match
confidence	,confident	,confidente
commérage	,commérage
afficher	,affiche
cafetière	,café
clinique	,patient	,patiente
se prénommer	,prénom
rayon	,miel
sentir	,odeur
soutien-gorge	,poitrine	,seins
souris	,ordinateur
inviter	,invité	,invitée
service	,client	,cliente
enterrer	,mort	,morte	;cadavre
faculté	,université
papa	;enfant
drame	,sujet
pot	,mise
débat	,sujet	,objet	,objet	,thème	,sujet
purée	,pomme de terre
contracter	,maladie
enlever	,victime
empreinte	,organe	;os
semeuse	,semence	;graine
médecin	,patient	,patiente	,patient	,patiente
téléspectateur	,télévision
spectacle	,spectateur	,spectatrice
tomber	,moment
fleuri	,fleur
illustré	,illustration
goût	,goût
multiplier	,multiplicande
dimension	,dimension
époux	,époux	,mari
transférer	,sentiment
priseur	,tabac
baguettes	,instrument à percussion
télévision	,diffuseur
menuisier	,meuble
député	,électeur	,électrice
menuisière	,meuble
complot	,victime
mobiler	,mobiler
>>>	S_1^usual
segment	,droite
maquiller	,maquilleur	,maquilleuse
faire de l’essence	,pompiste	,pompiste
lessive	,laveuse	,lavandière
champ	,paysan	,agriculteur	,agricultrice	,paysanne
aide	,aide	,aide
ouest	,Amérique du Nord
brosser	,peintre	,peintre
chiant	,chieur	,chieuse
banque	,banquière	,banquier
sport	,sportif	,sportive
génial	,génie
consommer	,consommateur	,consommatrice
ring	,boxe	,catch
autoroute	,usager	,usagère
roue	,véhicule
mentir	,menteur	,menteuse
anxiété	,anxieux	,anxieuse
enseignable	,enseignant	,enseignante
sagesse	,sage
tarte	,pâtissier	,pâtissière
poème	,poète	,poétesse
toilettage	,toiletteur	,toiletteuse
souder	,soudeur	,soudeuse
solitude	,solitaire	,solitaire
rongeur	,rongeur
toiletter	,toiletteur	,toiletteuse
violence	,violent
filet	,pêcheur	,pêcheuse
coupage de cheveux en quatre	,coupeur de cheveux en quatre	,coupeuse de cheveux en quatre
tennis	;joueur	,joueuse	,tennisman	,tennisman	,tenniswoman
enculer les mouches	,enculeur de mouches	,enculeuse de mouche
ronflements	,ronfleur	,ronfleuse
balayer	,balayeuse	,balayeur
casser les couilles	,casse-couilles	,casse-couilles
marathon	,marathonien	,marathonienne
diffuser	,diffuseur
sculpter	,sculpteur	,sculptrice	,sculpteure
boucher	,bouchon
coiffage	,coiffeur	,coiffeuse
explorer	,explorateur	,exploratrice
battre son plein	,mer
blague	,blagueur	,blagueuse
éplucher	,éplucheur	,éplucheuse
sondage	,sondeur
diagnostic	,diagnosticien	,diagnosticienne	,diagnostiqueur	,diagnostiqueuse
concombre	,cultivateur	,cultivatrice
guignol	,marionnettiste	,marionnettiste
architecture	,architecte	,architecte
longueur	,athlète	,athlète
mathématiques	,mathématicien	,mathématicienne
pois	,cultivateur	,cultivatrice
saucisse sèche	,charcutier	,charcutière
traduction	,traducteur	,traductrice
sauce	,saucier
fabuler	,fabulateur	,fabulatrice
tabac	,planteur	;cultivateur	,cultivatrice	;producteur	,productrice	,buraliste	,buraliste	;débitant	,débitante	;marchand	,marchande
foie	,bœuf	,veau
gond	,porte
caricature	,caricaturiste	,caricaturiste
traduire	,traducteur	,traductrice
haricot	,cultivateur	,cultivatrice
malchance	,malchanceux	,malchanceuse
lavoir	,lavandière
drame	,dramaturge	,dramaturge
riz	,riziculteur	,rizicultrice
licencié	,salarié	,salariée
guichet	,guichetier	,guichetière
trouille	,trouillard	,trouillarde
gribouiller	,gribouilleur	,gribouilleur
autocar	,chauffeur	,conducteur	,conductrice
conte	,conteur	,conteuse	;conteur	,conteuse
moutarde	,cultivateur	,cultivatrice
colère	,coléreuse	,coléreux	,colérique	,colérique
cousu	,couturier	,couturière
apiculture	,apiculteur	,apicultrice
imagination	,imaginatif	,imaginative
inspection	,inspecteur	,inspectrice
imprimerie	,imprimeur	,imprimeuse	,imprimeur	,imprimeuse
pansement	,panseur	,panseuse
caprice	,capricieux	,capricieuse
tambour	,joueur	,joueuse	,tambour
s’obstiner	,obstiné	,obstinée
scier	,scieur	,scieuse
vigne	,vigneron	,vigneronne
collection	,livre
chou	,cultivateur	,cultivatrice
chirurgie	,chirurgien	,chirurgienne
photographier	,photographe	,photographe
sprint	,sprinter	,sprinteuse
station-service	,pompiste
plumes	,oiseau
volley-ball	;joueur	,joueuse	,volleyeur	,volleyeuse
raser	,barbier
cheval	,éleveur	,éleveuse	,palefrenier	,palefrenière	,cavalier	,cavalière	;écuyer	,écuyère
bonbec	,confiseuse	,confiseur
mine	,mineur
mimer	,mime	,mime
questionner	,questionneur	,questionneuse
boiter	,boiteux	,boiteuse
>>>	Magn
mal à propos	,fort	,très
pioncer	,comme un sonneur	,comme un loir
similaire	,relativement	<très	,sensiblement	<exactement	<identique
surveillance	,étroit
rouge	,ardent	,brillant	,vif	;foncé	,sombre	,ardent	,brillant	,vif	;foncé	,sombre	,tout	;cramoisi	;écarlate	;pourpre	,tout	;comme un coq	,comme un coquelicot	,comme un homard	,comme une écrevisse	,comme une pivoine	,comme une tomate	;cramoisi	;écrevisse	;pourpre	;rougeaud	;rubicond	;écarlate	;sanguin
père	,vrai
nombre	,grand	,grand	,élevé	,bon
sommeil	,profond	,de plomb	;lourd	;sans rêves	,très	,vraiment	,profond	,de plomb	,lent	,lourd	,profond
maladie	,douloureux	<grave	,malin	<incurable	,inguérissable	<mortel	<foudroyant	,vrai	,grave	,vrai
demain	,après-demain
haine	,mortel
tempête	,gros	,fort	,violent	<terrible	,effroyable	,furieux	,gros	,violent	,gros	,fort	,violent	<terrible	,effroyable	,furieux	,violent
se fâcher	,tout rouge
intéressé	,fort	,très
commémorer	,en grande pompe
mal	;bien	,très	,de chien	,de chien	,de chien
joli	,à croquer	,beau
engagement	,sur l’honneur
klaxon	,fort
colère	,grand	,gros	,noir	;rage
gribouillis	,illisible
franchement	,très	;en tout [Y]
long	,tout en longueur	;comme un jour sans pain	,comme un jour sans pain	,comme un jour sans pain
malade	,gravement	<comme un chien	<à crever	,complètement
goût	,aiguisé	,développé	,boulimie
drôle	,à se rouler par terre
maigre	,comme un clou	,squelettique
loup de mer	,vieux
à propos	,fort	,très
cuisine	,sacré
couleur	,ardent	,brillant	,vif	;foncé	,sombre	,puissant
ronflement	,bruyant	,sonore
avocat	,grand	<ardent	;fervent
spécialiste	,grand	;expert
fond	,fin	,fin	,fin
tonnerre	,assourdissant	<épouvantable	,assourdissant	<épouvantable
chanter	,fort	<à tue-tête	,à pleins poumons	,à pleine voix
collaborer	,étroitement
réagir	,fortement	,violemment	,vivement
assis	,bien	<solidement	,bien	,solidement
frisson	,grand	,grand
union	,étroit	,intime
suspense	,haletant	,gros
rapide	,bien	<très	,très	,bien	,très	<comme l’éclair	,comme le vent	,très
aube	,clair	,lumineux
rapidement	,à la vitesse de [Y]
faim	,de loup
mordre	,à belles dents	,à pleines dents
ronfler	,bruyamment	,fort	,comme un sonneur
gagner	;haut la main
expérience	,riche
mélancolie	,sombre
moyen	,très	,médiocre
vaguelette	,vague
gribouillage	,illisible
enveloppe	,gros	,important
grave	<gravissime	,très
penser	,mûrement
observation	,strict
malaise	,profond
silence	,de plomb
torchon	,vrai
certifer	,sur l’honneur
en colère	,très	,furieux
pagaille	,gros	,joyeux	,sacré
insolation	,vif
dormir	,à poings fermés	,profondément	;comme un loir	,comme une marmotte	,comme une bûche	,comme une masse	,comme une souche	,comme un sonneur	;comme un bébé
excentricité	,fort
bâiller	,aux corneilles
admiration	,grand
vibrer	,fortement
lent	,de tortue
rebond	,fort	,net
fossette	,profond
joie	,grand	,immense	,allégresse	,grand
cadrer	,bien	<parfaitement
ego	,surdimensionné
chiffre	,élevé
route	,long
flot	,geyser	,torrent
émotion	,fort	,grand
bien	,grand	<immense	<fou	,très	,rudement	<terriblement	<mieux	;très	<parfaitement	,admirablement	,à merveille	,formidablement	,merveilleusement	,formidablement	,remarquablement	,mieux	,meilleur	,très
lumineux	,éclatant	,resplendissant	;éblouissant
fou	,à lier
s’allonger	,démesurément	,considérablement	,indéfiniment	,indéfiniment
muet	,comme une tombe
fatigué	,épuisé
histoire	,à dormir debout
dépendance	,étroit
fleuve	,immense	,interminable
analogie	,singulier	,saisissant	,évident	,remarquable	,singulier	<frappant	,saisissant	,évident	,fort	,remarquable	,profond	,grand	<étroit	<absolu	,complet	,parfait
hier	,avant-hier
horreur	,saint
célébrer	,en grande pompe
armé	,jusqu’aux dents
bordel	,gros	,joyeux	,sacré
numéro	,fameux	,sacré	,drôle
évènement historique	,grand
manger	,beaucoup	;avidement	;goulûment	;copieusement	;à belles dents	,de bon appétit	,de bon cœur	<à se faire péter la panse	,à se faire péter la sous-ventrière	,se faire péter la panse	,comme quatre	,comme un ogre	,énormément	,tout cru
ronflements	,bruyant	,sonore
>>>	A_2
savoir	,su	,su
serrer	,serré
pouvoir	,sous
localisation	,localisé
désespérer	,désespéré
couleurs	,à	,sous
occupation	,occupé
supplément	,supplémentaire
habiter	,habité
faute	,fautif
erreur	,erroné
illustrer	,illustré
dominer	,dominé
employer	,employé
manger	,mangé
débat	,en
ébahir	,ébahi
disputer	,disputé
lac	,noyé
concerner	,concerné
éclairer	,éclairé
défaite	,gagnant	;vainqueur	;victorieux
pollution	,polluant
obliger	,obligé
exporter	,exporté
clouer au lit	,cloué au lit
exagérer	,exagéré	,exagéré
livrer	,livrable
consentement	,consenti
former	,formé
connaissance	,connu
essouflé	,essouflant
éblouir	,ébloui
franc	,franc
héliporter	,héliporté
cercueil	,décédé	,défunt	,mort
découragement	,décourageant
déprimer	,déprimé
chiffre	,chiffré
sport	,sportif
sinistre	,sinistré
cousu main	,cousu main	,cousu main
amour	,amoureux
électronique	,électronique
creuser	,creusé
s’appauvrir	,appauvrissant
exploiter	,exploité
brûlure	,brûlé
emprise	,sous
éducation	,éducateur
habitation	,habité
conserver	,conservé
occuper	,occupé	,occupé	,occupé	,occupé
surmonter	,au-dessous
suspecter	,suspect
attrait	,attrayant
aliter	,alité
poison	,empoisonné
raisonner	,raisonné
gauche	,gauche
exécuter	,exécuté
composer	,composé
surveiller	,surveillé
menacer	,menacé
devoir	,dû
déchirer	,déchiré
exercer	,exercé
exposer	,exposé	,exposé
haleter	,haletant
gonfler	,gonflé
tissu	,musculaire
origine	,originaire
décevoir	,déçu
considérer	,considéré
abattre	,abattu	,abattu	,abattu
inspirer	,inspiré	,inspiré
accusation	,visé	,en butte
béton	,bétonné
barrer	,barré
remplir	,rempli
Enfer	,damné
vents	,à
écouter	,écouté
épreuve	,éprouvé
fracture	,fracturé
schéma	,schématique
éprouvé	,éprouvant
plaisir	,plaisant
habitude	,habituel
plage	,de
désirer	,désirable
recouvrir	,recouvert	,recouvert
bénévolat	,bénévole
étouffer	,étouffé	,étouffé	,étouffé	,étouffé
considération	,considéré
miel	,mellifère	,mellifique
antenne	,à	,sur	,en ondes
menottes	,menotté
comprendre	,compris	,compris	,inclus	,compris
électricité	,électrique
>>>	Contr
équivalence	,implication
quelqu’un	,quelque chose
d’abord	,enfin	,ensuite	,puis
gorge	,nuque	,vallée	;plateau	,terrasse	,bouche	;bouche
bouche	,gorge
dictature	,démocratie	,démocratie
sein droit	,sein gauche
blonde	,brune
depuis	,vers
théorie	,pratique
droitier	,gaucher	,gaucher
feu	,eau	;glace
se coucher	,se lever
paradis	,Enfer	;purgatoire
dame	,demoiselle
tribord	,bâbord
Corée du Sud	,Corée du Nord
monarchique	,démocratique	,républicain
maillot de corps	,slip
Monsieur	,Madame
qualitatif	,quantitatif
demoiselle	,dame
santé	,maladie
monologue	,dialogue
esclave	,maître
nuage	,soleil
surface	,fond
chier	,pisser
horizontale	,verticale
dent	,griffes
pied de page	,en-tête
loin	,ici
sorcière	,fée
à froid	,à chaud
tronc	,jambes	;jambes	,patte
sel	,poivre
sémantique	,forme
éliminatoire	,finale
poulailler	,parterre
verglas	,neige
R.E.R	,métro	,métro
cave	,grenier
boudoir	,champagne
entre	,autour
veille	,lendemain
muscle	,graisse	;nerf
Corée du Nord	,Corée du Sud
aérien	,terrestre	;aquatique	,marin	,terrestre	;maritime
cash	,chèque
loup	,chien
mental	,écrit
pipi	,caca
gaz	,liquide	,solide
vent	,courant
se lever	,s’allonger	,se coucher	,se coucher	,s’allonger
science	,technologie
sapin	,pin
hiver	,été
brune	,blonde
implication	,équivalence
entamé	,entier
démocratique	,monarchique
agricole	,urbain
continent	;mer	;île
prochain	,actuel
moyen	,exceptionnel	,extraordinaire	;nul
récepteur	,émetteur
marcher	,ramper	;courir
chimie	,physique
pile	,face
brouillon	,propre
poésie	,prose
maintenant	,après	,avant	,plus tard
monarchie	,démocratie	,république	,démocratie	,république
silence	,bruit
zizi	,zézette
col	,décolleté
vide	,plein
volant	,rampant
nationalement	,internationalement
main droite	,main gauche	,main gauche	,main gauche
flore	,faune
tragique	,comique	,comique
vents	,cordes	;percussions
tactique	,stratégique
carré	,cercle	,rond
quantité	,qualité
eau de mer	,eau douce
champ	,pré	,ville
rampant	,volant
coût de sortie	,coût d’entrée
nerf	,muscle
mode	,sport
produit	,réactif
ceinture	,bretelles
moteur	,directeur
étoile	,soleil
violon alto	,violon
cru	,cuit
matière	,esprit	,âme	;forme	,énergie
>>>	S_0Pred
patient	,patience
chagrin	,chagrin
supérieur	,supériorité
dangereux	,dangerosité
hétérosexuel	,hétérosexualité	,hétérosexualité
brutal	,brutalité
religieux	,religiosité
vacant	,ardeur
pur	,pureté
propre	,propreté	,propreté	,propreté
majeur	,majorité	,majorité
impartial	,impartialité
discret	,discrétion
splendide	,splendeur
localisé	,localisation
intime	,intimité	,intimité
solitaire	,solitude	,solitude
malchanceux	,malchance
bénévole	,bénévolat
débrouillard	,débrouillardise
anonyme	,anonymat
présent	,présence
flou	,flou
constant	,constance
adroit	,adresse
vulgaire	,vulgarité
sport	,sportivité
utile	,utilité
raciste	,racisme
sérieux	,sérieux
respectueux	,respect
étourdi	,étourderie
bienheureux	,bonheur
têtu	,entêtement
noble	,noblesse
normal	,normalité
indulgent	,indulgence
insuffisant	,insuffisance
flegmatique	,flegme	,flegme
pertinent	,pertinence
salarié	,salariat
continu	,continuité
vainqueur	,victoire
objectif	,objectivité
abonné	,abonnement
génial	,génie
impair	,imparité
joyeux	,joie
silencieux	,silence
xénophobe	,xénophobie
chauve	,calvitie
aigre	,aigreur	,aigreur
homosexuel	,homosexualité
naïf	,naïveté
réactif	,réactivité
transpirant	,transpiration
alcoolique	,alcoolisme
avancé	,avancement
convaincu	,conviction
vengeur	,vengeance
mobile	,mobilité
fertile	,fertilité
misogyne	,misogynie
élégant	,élégance	,élégance
extravagante	,extravagance
oblique	,obliquité
injuste	,injustice
épais	,épaisseur
égal	,égalité
régulier	,régularité
disponible	,disponibilité
excentrique	,excentricité	,excentricité	,excentricité	,excentricité	,excentricité	,excentricité
tyran	,tyrannie
cruel	,cruauté
indiscret	,indiscrétion
méchant	,méchanceté
poli	,politesse
froid	,froideur
limpide	,limpidité
vraisemblable	,vraisemblance
talentueux	,talent
fantastique	,fantastique
grammatical	,grammaticalité
conscient	,conscience	,conscience
saint	,sainteté	,sainteté	,sainteté
mécontent	,mécontentement
exact	,exactitude
bête	,bêtise
grossier	,grossièreté
analogue	,analogie
commode	,commodité
sourd	,surdité
intense	,intensité
rabat-joie	,rabat-joie
frais	,fraîcheur	,fraîcheur
grave	,gravité
optimiste	,optimisme
cordial	,cordialité
incommode	,incommodité
horizontal	,horizontalité
>>>	S_1^prototyp
serpent de mer	,journaliste	,journaliste
zinzinuler	,fauvette	,mésange
nucléaire	,énergie
accoudoir	,fauteuil
téter	,bébé	;nourrisson
kératine	,ongles	,poil	,cheveu	,ongles
escalope	,bœuf	,veau	;poulet
virtuose	,musicien	,musicienne
pendule	,horloge	,pendule
possessif	,déterminant
goûter	,enfant	,enfant	,enfant
gauche	,partie du corps
bzz	,abeille	,mouche
glace	,cuisinier	,pâtissier
fibre	,aliment
écriture	,lettre
bosquet	,fleur
soie	,couteau
page	,livre	,carnet	,cahier
flash	,appareil photo
voler	,véhicule volant
honneur	,dieu	,Dieu
discothèque	,client	,cliente
cloche	,chapeau
apprendre	,enseignant	,enseignante	,professeur	,professeure	,instituteur	,institutrice	,maître	,maîtresse	;instructeur	,instructrice	;formateur	,formatrice
cube de glace	,boisson
carapace	,tortue
amont	,fleuve	,rivière
ampoule	,médicament
égouts	,ville
éclore	,oisillon	,œuf	,fleur	,fleur
spirale	,cahier
hanter	,esprit	,fantôme
découvrir	,chercheur
quatre-heures	,enfant	,enfant
parole	,locuteur
essaimer	,abeille
clé	,robinet	,sol	;fa
siège	,armée	,troupe
positif	,organiste
cadran	,montre
abat-jour	,lampe	,ampoule	,lampadaire
tour	,château
coquille	,mollusques	,coquillage	,noix	,épée	,boxeur
illustrer	,exemple
champ magnétique	,aimant	,aimant
encadrer	,loi	,règlement
célébrer	,prêtre
bouclier	,soldat
lin	,tissu
mellification	,abeilles
cabine	,bateau
sur l’honneur	,serment
serviette	,femme
clouer au lit	,maladie
flocons	,céréales
rinçage	,lave-vaisselle
kaki	,uniforme	,soldat	,soldat
essence	,automobiliste	,automobiliste
bouclier humain	,prisonnier	;otage	,otage
menottes	,policier	,policière
chien	,fusil	;pistolet	,revolver
galbe	,partie du corps	;mollets	,seins
marcher	,appareil	;véhicule
pompes	,cérémonie
de bain	,serviette	;maillot
être	,être
rouille	,blé
majorité	,électeur	,électrice
cours	,fleuve	,rivière
grailler	,corbeau	,corbeau
tempête	,neige	;vent	;grêle	;pluie
Un [X] peut en cacher un autre.	,train	,tramway	,tram
soutif	,femme
pelouse	,parc
pigeonner	,poitrine	,seins
résiduel	,matière	;valeur
prescrire	,médecin	,médecin
plier	,membre	,membre
miette	,pain
pâteux	,pâte	,pâte	,bouche
cadavre	,bouteille	,canette
braiment	,âne
croasser	,corbeau	,corbeau
mégot	,cigarette	,cigare	,cigarillo
roue à aubes	,bateau	;moulin
poissonneux	,étang
juger	,juge	;tribunal	,juge	;tribunal
messe	,prêtre	,curé
joues	,marteau
jupe	,voiture	,automobile	,voiture	,wagon	,locomotive
parterre	,fleur	,théâtre
centime	,euro
vêtement	,couturier	,couturière
pompe à fric	,escroc
quartier	,ville
extinction des feux	,clairon
élément de langage	,communicant
coussin	,canapé	;fauteuil
averse	,larme
>>>	Redun
environnement	,informatique	,logiciel
office	,religieux
figure	,schématique	,littéraire	;style
sujet	,syntaxique	;grammatical
anniversaire	,de naissance
précipitation	,atmosphérique
loin	,dans le temps
chèque	,bancaire
marche	,athlétique	,au pas	,à pied	,électoral
diversité	,ethnique
père	,éternel	,céleste
tampon	,hygiénique
chef	,cuisine
partenaire	,sexuel	,sexuel
réacteur	,chimique	,nucléaire
empreinte	,digital	,dentaire
conjoncture	,économique
manteau	,terrestre
drap	,lit
grappe	,raisin
boxe	,anglais
jumeaux	,deux
serveur	,informatique
liaison	,chimique	,amoureux	,intime
se cailler	,de froid
plage	,horaire
réactif	,chimique	,chimique
Noël	,chrétien
voie	,ferré
congrégation	,religieux
terrorisme	,intellectuel
tapette	,mouche
navigateur	,Internet	,Web
pile	,électrique
blague	,tabac
désirer	,physiquement	,sexuellement
bout de chou	,petit
toilette	,funèbre	,funéraire	,mortuaire	;dernier	,ultime
circulation	,sanguin
vapeur	,eau
triangle	,pubien	,signalisation
couple	,mathématique
déchirement	,musculaire
droit commun	,régime
ticket	,entrée
dégoût	,physique
pompe	,à huile	,à essence
procédure	,judiciaire
rive	,toit
coté	,Bourse
réactivité	,chimique
droite	,politique
urne	,funéraire
instrument	,de musique
tapis	,souris	,roulant
excentricité	,orbital
thèse	,doctorat	,doctoral
compte	,bancaire
train	,bois
fond	,sonore
coureur	,à pied	,automobile	,de femmes	,de jupons
numéro	,téléphone	,périodique	,rue
régime	,politique	,mécanique	,alimentaire	,syntaxique	;grammatical	,alimentaire
aube	,matinal
fibre	,alimentaire
dizaine	,chapelet	,chapelet
Pâque	,juif
boîte aux lettres	,électronique
poitrine	,féminin
traduire	,justice
infarctus	,myocarde
rencontre	,sportif
balayeuse	,aspirateur
réactant	,chimique
lait	,maternel
pays d’accueil	,touristique
tomber	,par hasard
fil	,linge
nombre	,grammatical
plateau	,jeu
carte	,à jouer
États-Unis	,Amérique
équation	,chimique	,chimique
machine	,laver
épreuve	,sportif
mouche	,artificiel
apitoiement	,sur soi-même
sentiment	,amoureux
manifestation	,sportif
dés	,à jouer
genre	,grammatical
carré	,infanterie
note	,de musique
tabouret	,pieds
débranchement	,électrique
amour	,sexuel	;physique	,physique
réunion	,sportif
brevet	,invention
tableau	,blanc	;noir
comme il faut	,bien
>>>	AntiBon
négocier	,chipoter
nuage	,lourd	,menaçant	,lourd	,menaçant
violon	,crin-crin
chaussons	,usé	,usé
vêtements	,usé	;fripé	,râpé	;fripes	,guenilles	,loques
nappe	,sale	,taché	,contaminé	;pollué
tapis	,élimé	,râpé	,pelé
thèse	,mauvais	<médiocre
couple	,malheureux
temps	,mauvais	<de chien
navire	,mauvais	,rafiot
prêcher	,prêcher un converti
vélo	,clou
ostensible	,ostentatoire
environnement	,hostile
lit	,grabat
manteau	,élimé	,râpé	,usé
lac	,sombre	,impur	,boueux	,fangeux	;noir	,opaque	;houleux
colline	,abrupt
jour	,sans
avocate	,mauvais	<piètre	;avocaillonne
crier	,braire	,braire
élève	,mauvais	,cancre	,mauvais	,cancre
chiffre	,mauvais
couteau	,mauvais
médecin	,mauvais	;médicastre	,mauvais	;médicastre
aller	,mal
bouche	,pâteux
chien	,indiscipliné	;agressif	,hargneux	,teigneux	<enragé
installé	,mal
bouteille	,mauvais
restaurant	,gargote
linge	,froissé	,souillé
mouchoir	,sale
tête	,de _N de long
marcher	,mal	;au ralenti
dormir	,à la dure	,mal	,insuffisamment
boisson alcoolisée	,bibine	;pipi de chat
vin	,âpre	,gâté	,mauvais	,piqué	,piquette	,vinasse
politique	,mauvais	<catastrophique	,désastreux	,politicard
homme politique	,politicard
humeur	,de chien
dessin	,gribouillage
assiette	,cassé	,ébréché	,fêlé
figure	,de carême
réponse	,Normand
journaliste	,mauvais	,folliculaire	,journaleux	,plumitif	;pisse-copie	,pisseur de copie	,mauvais	,folliculaire	,journaleuse	;pisse-copie	,pisseuse de copie
vêtement	,usé	;fripé	,râpé
moral	,à zéro	,dans les chaussettes
fond	,bas-fond	,vieux	,mauvais	,méchant
air	;lourd	;pollué	,vicié
bicyclette	,clou
recevoir	,comme un chien dans un jeu de quilles
relation	,toxique
toilette	,négligé
rêve	,mauvais	<horrible	;cauchemar
prendre	,mal
rapport	,toxique
femme politique	,politicarde
parler	,baragouiner	,comme une vache espagnole	,baragouiner
formes	,disgracieux
théatre	,de boulevard
croûte	,dur
assis	,mal
écrivain	,gribouilleur	;pisseur de copie
langue	,jargon
politicien	,politicard
odeur	,irrespirable
sentir	,mauvais
finir	,bâcler
pluie	,dévastateur	,dévastateur
dent	,carié	,pourri	,gâté	,vilain	;déchaussé	;ébréché	<cassé	,chicot	;creux
repas	,immangeable	,indigeste	;gras
corps	,difforme
rouge	,gros	;qui tache
passager	,clandestin
chaussettes	,troué	;usé
écrit	,gribouillage
film	,navet
pull	,troué	,usé
théâtre	,de boulevard
se lever	,se lever du pied gauche
chaussures	,usé	;éculé
forme	,petit	<mauvais	,petit	,mauvais
triangle	,infernal
gueule	,de _N de long
écrire	,gribouiller
écriture	,pattes de mouche
mélange	,mariage de la carpe et du lapin
gosse	,sale	;chiard	,sale
serviette	,humide	<mouillé	;sale
nager	,mal
sujet	,chiffon rouge
atmosphère	,vicié
année	,sans	,sans
divorce	,pour faute	;aux torts exclusifs	;par assignation	;aux torts partagés
sens	,contresens	,mauvais
personnel	,incompétent	,incompétent
sommeil	,agité	,détraqué	,mauvais	,perturbé	,troublé
manger	,mal	,gras
>>>	Mero
abattant	,couvercle	,lunette
lac	,bord	,rive
thorax	,sternum	;côte
bride	,sous-gorge
cube de glace	,glace
pluie	,eau de pluie
forêt	,sous-bois
banc	,dossier	,siège
gymnastique	,pompe
voiture	,moteur	,réservoir	;coffre	;volant	,tableau de bord	,pédale	;siège	,ceinture	;roue	,train	;habitacle	,compartiment	;siège	,couchette	,brancard	,essieu	,roue	,marchepied
trottoir	,bateau
lin	,fil de lin	,lin
gueule	,museau
glace	,eau	,sucre	,sucre glace
main	,dos
avion	,aile	,hélice	,moteur	,réacteur	,train d’atterrissage	;cockpit	;siège	,ceinture	;soute	;queue	;carlingue	,fuselage
gorge	,gosier	,gorge	,pipe
autoroute	,chaussée	,voie	,bande de circulation	;bande d’arrêt d’urgence	;péage	;entrée	,sortie
rame	,voiture
chaise	,dossier	,patte	,siège
mélodie	,mélodie
douche	,bac	,colonne	,douchette	,mélangeur	,mitigeur	,pare-douche	,paroi	,pommeau	,pomme de douche	,porte	,receveur	,rideau	,robinet	,tuyau
gentiane	,gentiane
navire	,coque	,pont	,cale	,hublot	,soute	;proue	,étrave	;poupe	,étambot
poitrine	,seins	;sternum	,lard
semaine	,semaine	,week-end
cheval	,crinière
haricot	,haricot	,haricot
chemin de fer	,rails	,train	,chemin de fer
éléphant	,trompe
roue à aubes	,aube
air	,oxygène
volcan	,cheminée	;caldera	;flanc	,versant	;cratère
fleur	,pétales	,fleur
bouchon	,liège
récif corallien	,corail
cou	,gorge	,gorge
nez	,bout	;dos	;lobe	;narines	,trou de nez	;racine	;os	;aile
avenue	,chaussée	,voie	;trottoir
novembre	,Toussaint
chicorée	,chicorée
bois	,sous-bois
glaviot	,salive
omelette	,œuf
boîte aux lettres	,boîte d’envoi	,boîte de réception
soupe au lait	,lait
tortue	,bec	;carapace
viorne	,cheveu-de-la-Vierge
graine de lupin	,lupin
colline	,bas	,pied	;flanc	,versant	;haut	<sommet
lupins	,lupin
trottinette	,roue	;guidon	,roue	;guidon
arbre	,branche	,tronc	;feuille	,feuillage	,couronne
R.E.R	,R.E.R
tomate	,tomate cerise	,cœur de bœuf
lentilles	,foyer
terrier	,entrée	,gueule	,ouverture	,trou	;couloir	;cavité
pieds	,plante
mot	,lettre
flocons	,cristal
crachat	,salive
Système solaire	,Soleil	;Terre	,Mars	;Lune
églantier	,églantine
rivière	,méandres	;amont	,aval	;berge	,bord	,rive	;gué	,fermoir
patate	,patate
ongles	,kératine
tabouret	,pied	,siège
soutif	,bonnet
rayon	,alvéole
ciel	,septième ciel
museau	,truffe	,museau
tortue de mer	,bec	;carapace	;nageoire
soutien-gorge	,bonnet
rosier	,rose
balai	,manche	,pommeau
tramway	,tramway
désert	,sable	,dune	,pierre	,roche
mamelles	,tétons
courriel	,en-tête	,signature	,pièce jointe	,adresse électronique
cheminée	,foyer
mère	,bactérie
route	,chaussée	,voie	;bord	;revêtement
glaçon	,glace	,glace
fil de lin	,lin
fleuve	,méandres	;amont	,aval	;embouchure	;estuaire	,delta	;bouche	;berge	,bord	,rive
substance	,particule
corps	;atome	,élément	,molécule
château de cartes	,carte
boulevard	,voie	,chaussée	;trottoir
muscle	,fibre	;tissu
plan comptable général	,bilan
piano	,clavier
nuage	,vapeur
lavande	,lavande
week-end	,samedi	,dimanche
siège	,dossier	,pied	,siège
étang	,bonde	;bord
pomme de terre	,pomme de terre
bonhomme de neige	,neige
tortue marine	,bec	;carapace	;nageoire
>>>	Fact_0
tramway	,circuler	,se déplacer	,rouler	;fonctionner	,marcher
voiture	,rouler	;avancer	,circuler	;se déplacer	,rouler
véhicule	,rouler	,se déplacer	;avancer	,circuler	,se déplacer
campeur	,camper
camionnette	,circuler	,rouler
aéronef	,voler
balayeuse	,balayer
moustique	,voler
escargot	,ramper	,traîner
muscle	,agir	;se contracter
cycliste	,pédaler	,pédaler
corbeau	,voler	,voler
skis	,glisser
pâte	,cuire
transporteur	,transporter
réactif	,réagir
dormeur	,dormir	,dormir
rideau	,cacher	,masquer	,occulter	,séparer	,diviser	;cacher	,masquer
crocodile	,marcher	;nager	;ramper
boulanger	,boulanger
bateau	,naviguer
cheval	,marcher	;trotter	;galoper
campeuse	,camper
avocate	,exercer
lac	,se déverser	,stagner	;se répandre	,se déverser	,s’étaler	,s’écouler	,se décharger
vélo	,rouler	;circuler
placard	,annoncer	<clamer
numéro	,sortir	,sortir	,paraître
véhicule volant	,voler
guêpe	,voler
travailleur	,travailler
bicyclette	,rouler	,circuler
écureuil	,grimper	,sauter	,conserver	,garder	;économiser
chant	,retentir	,retentir	,retentir
mouche	,voler	,voleter	,voltiger
collabo	,collaborer	,collaborer
lunette	,grossir
chimie	,opérer	,opérer
travailleuse	,travailler
balai	;balayer
cheveux	,pousser
collaboratrice	,collaborer
navire	,naviguer
bus	,rouler	;circuler
oiseau	,voler
parturiente	,accoucher
alcoolique	,boire	,boire
père	,officier
flocons	,tomber	;voler	;neiger
pompier	,intervenir	,intervenir
volcan	,exploser	,exploser
métro	,circuler	,rouler	,fonctionner	,marcher
bronzeur	,bronzer
concert	,retentir
cigare	,se consumer
collaborateur	,collaborer
sorcier	,envoûter
dormeuse	,dormir	,dormir
archéologue	,fouiller
cœur	,battre
coureuse	,courir
rêveuse	,rêver
soleil	,briller	,luire
plage	,se dérouler	,jouer
train	,rouler	,circuler	,avancer	,se déplacer
figure	,indiquer	,illustrer	,représenter
musicien	,jouer
coureur	,courir
tricycle	,rouler	,circuler
corps	,fonctionner
magie	,opérer
car	,rouler
cercueil	,contenir	,renfermer	,receler
bouilloire	,chauffer
prévision	,se réaliser
fleuve	<couler
cigarette	,se consumer
avion	,voler
couple	,embrasser	;enlacer
draisienne	,rouler	,circuler	,rouler
musicienne	,jouer
couleurs	,flotter
tombeau	,contenir	,renfermer	,receler
médecin	,exercer	;consulter	,exercer	;consulter
autocar	,rouler
casserole	,chauffer
artiste	,se produire	,se produire
camion	,circuler	,rouler
tortue	,traîner
nageur	,nager
roue	,tourner	,tourner
prédiction	,se réaliser
antenne	,capter	,recevoir	;émettre
montgolfière	,s’élever	;voler
boulangère	,boulanger
marche	,retentir	,sonner
avocat	,exercer
douche	,couler	,fonctionner
chien	,percuter
oreilles	,entendre
>>>	Gener
dos crawlé	,nage
souci	,sentiment
planète rouge	,planète
herbe	,plante
nuque	,partie du corps
rouge-gorge	,oiseau	,oiseaux	;passereaux
enterrement	,cérémonie
vin de table	,boisson	;boisson alcoolisée
malaise	,sensation	,sentiment
torse	,partie du corps	,sculpture
garance	,plante
oxalis	,plante	;fleur
prix de revient moyen pondéré	,méthode de calcul
bière	,boisson	;boisson alcoolisée	,boisson	;boisson alcoolisée
roulette	,instrument
animal de compagnie	,animal
coquille	,partie du corps
main gauche	,partie du corps	,partie du corps
rongeur	,animal
bosse	,contusion
île flottante	,entremets	,dessert	,radeau
rhum	,boisson	;boisson alcoolisée
ver	,animal
animé	,vivant
crapaud	,batracien	;amphibiens	,batraciens	,fauteuil
flûte traversière	,instrument de musique
yacht	,bateau
état psychique	,état
tigre	,fauves
ozone	,gaz
hippisme	,sport
lave-auto	,établissement
impasse	,voie
huit	,nombre
Wimbledon	,quartier	,tournoi
convertible	,meuble	;pièce d’ameublement
arrière	,localisé
mésange charbonnière	,oiseau	,oiseaux	;passereaux
pic	,outil
financier	,gâteau
petit chien	,respiration
seringat	,plante	;fleur
choucroute	,aliment	,plat
vers	,espèce	,famille
nauséeux	,sensation
mouche à miel	,insecte	,insectes
T5	,habitation	,logement
68	,mouvement social
bonnet	,pièce d’habillement
banc	,siège
poignard	,arme blanche
apéro	,boisson	;boisson alcoolisée
poirier	,arbre
cerise	,fruit
grille-pain	,appareil	,appareil électroménager
soixante	,nombre
tombeau	,monument
main	,partie du corps	,partie du corps	,faute
colibri	,oiseau	,oiseaux
lilas	,plante	,fleur	;arbuste	,coloré
allée	,voie
TER	,train
gavial	,reptile	,reptiles
Turquie	,pays
faux bourdon	,insecte	,insectes
passage	,déplacement	,déplacement	,déplacement	,voie
rue piétonnière	,voie
digitale	,plante	;fleur
gerbe d’or	,plante	;fleur
velours	,tissu
volume	,espace	,grandeur
polluant	,substance
gentiane	,plante	;fleur	,boisson	,boisson alcoolisée	;apéritif
Orsay	,ville
T2	,habitation	,logement
bourre-pipe	,instrument
spleen	,sentiment
capitaine	,officier
fourrure	,vêtement
sandale	,chaussures
fougère	,plante
nièce	,parente
plateau technique	,équipement
croire	,penser
commandant	,officier
cicatrice	,lésion
chocolat	,substance alimentaire	,boisson	;boisson chaude
jogging	,vêtements
salade	,légume
miel	,aliment	,couleur
chaise de bébé	,chaise
jumeau	,muscle
estomac	,organe	;partie du corps
fibre	,substance
sculpture	,œuvre
pou	,insecte	,insectes	;parasite
bronchite	,maladie
Thérèse	,prénom	;nom
400 mètres	,épreuve	;évènement sportif
tuile	,petit four	,biscuit
>>>	S_loc
sentiment	,cœur	,cœur
couché	,lit
Kiwi	,Nouvelle-Zélande
coiffeuse	,salon
basket	,terrain
diable	,Enfer
figue	,figuier
plein	,station-service
neige	,écran
rugby	,terrain	;stade
algue	,mer	,mer	;étendue d’eau
cuisine	,cuisine
figure	,dans	,en plein
gymnastique	,salle	;gymnase	,salle	;gymnase
voter	,bureau de vote
vélo	,vélodrome
lapin	,terrier
camper	,camping
figue de Barbarie	,figuier de Barbarie
sans domicile fixe	,rue	;rue	;rue	;rue
lotus	,yoga
rouge	,rougeur
lombric	,terre
entrer	,entrée	,entrée
traboule	,Lyon
exemple	,exemplier
thé	,théier
articulation	,point
pompe	,station-service	;garage
main droite	,droite	,droite
corail	,mer	;récif corallien
guêpe	,nid	,guêpier
judo	,tapis	,tatami	;dojo	,salle
cigare	,bureau de tabac	,tabac	,débit de tabac	;cave à cigares
cernes	,yeux	;visage
poule	,poulailler
encre	,encrier
père	,couvent
sport	,salle	;terrain	;palais des sports
volley-ball	,terrain
eau	,cours d’eau	;étendue d’eau
dormir	,dortoir
garagiste	,garage	,garage
curé	,cure	;paroisse
poches	,yeux	;visage
tasse	,tasse
abeille	,nid	,ruche
tennis	,court	,terrain	,tennis
chaussures	,boîte	;meuble
noix de coco	,cocotier
olive	,olivier
laver	,lavoir	,laverie	,buanderie	,buanderie	,lavomatique	,douche	,lavabos	,salle de bain	,salle d’eau	,salle de douche
promenade	,prison
banane	,bananier
éléphant de mer	,mer
crime	,lieu	,scène
Belgique	,en
cheval	,écurie	;box	,stalle	;haras
lièvre	,terrier
orphelin	,orphelinat
corps	,caserne
aboutir	,aboutissement
chair de poule	,peau
uriner	,urinoir	;toilettes
réagir	,réacteur	,réacteur	,réacteur
papetier	,papeterie	,papeterie
vote	,urne
Allemagne	,en
course	,champ de course	,hippodrome
poire	,poirier
urinoir	,urinoir	;toilettes
vache	,étable	,vacherie
sandwich	,sandwicherie
orchestre	,fosse d’orchestre
rideau	,scène
lessive	,blanchisserie	,pressing	;laverie	;lavoir	;buanderie
border	,bateau	,voilier
villageoise	,village
orange	,oranger
assiette	,assiette
boulanger	,fournil
cerise	,cerisier
orpheline	,orphelinat
nuage	,ciel	;horizon
tortue marine	,mer	,océan	;eau de mer
faire de l’essence	,station-service
langue	,bouche
crocodile	,rails
vitrine	,vitrine
à l’eau	,eau	,eau
insecte	,insectarium
raisin	,vigne
bronchite	,poumons
récif corallien	,mer
tombe	,cimetière
herbe	,pelouse
parfum	,flacon
coton	,cotonnier
rue	,rue
lait	,seins
>>>	Oper_1
VTC	,faire
les jambes mortes	,avoir
plaisir	,avoir	,éprouver	,ressentir	;goûter
basket	,faire	;jouer	,faire	,se faire
coup de fourchette	,avoir
couleurs	,avoir
BMX	,faire
coup par coup	,faire
coquille	,avoir	,posséder
haut-le-cœur	,avoir
maladie de la vache folle	,avoir	,souffrir
calembour	,dire	,faire
chant	,faire
éclair	,cracher	,jeter	,lancer	,projeter	,lancer	,jeter
bronchite	,avoir	,souffrir
vélo tout chemin	,faire
chat dans la gorge	,avoir
dentition	,faire
cravate	,faire	,donner
tournée	,faire	,effectuer
produit	,calculer	,effectuer	,faire
mère	,être	,être	,être
volte-face	,faire	,faire
amour	,avoir	,éprouver	,porter	,ressentir	,avoir	,éprouver	,porter	,ressentir
les jambes molles	,avoir
cauchemar	,faire
compliment	,présenter
coup d’État	,commettre	,faire	,perpétrer
jaunisse	,avoir	,souffrir
coup double	,faire
pipe	,faire	,tailler
prédiction	,faire	,lancer
deux poids et deux mesures	,avoir	,faire
mal de l’air	,avoir	,éprouver	,ressentir
coup de froid	,avoir	,souffrir
cri	,faire	,pousser	,lancer	,jeter	,émettre	,lâcher
toilette	,être	,faire	,procéder	,réaliser	,se livrer	,faire	,procéder	,faire	,procéder
chair de poule	,avoir
don	,faire
honneurs de la presse	,avoir	,recevoir
jalousie	,avoir	,éprouver	,ressentir
coup de cœur	,avoir
émotion	,éprouver	,ressentir
marche nordique	,faire
ouf	,pousser
tuberculose	,avoir	,souffrir
coup	,donner	,faire	,jouer	,faire
coup de couteau	,asséner	,donner
taureau	,être
longueur	,faire
chantage	,faire	,exercer	,se livrer	,recourir	,user	,pratiquer	,faire	,exercer	,se livrer	,recourir	,user	,pratiquer
prévision	,faire
demi-tour	,faire
bâtons dans les roues	,mettre	,jeter	,foutre
messe	,célébrer	,dire	;officier
angine de poitrine	,avoir	,souffrir
coup de collier	,donner
maladie honteuse	,avoir	,souffrir
marche arrière	,faire
majorité	,appartenir	,faire partie
pouvoir	,avoir	,exercer	,posséder	,tenir
cheval	,faire
cinéma	,faire
priorité	,avoir	,avoir
maladie	,avoir	,souffrir	,avoir	,avoir	,avoir	,avoir
poil dans la main	,avoir
frayeur	,avoir	,éprouver	,ressentir
peur	,avoir	,éprouver	,ressentir
coup de pied	,donner
badminton	,faire	;jouer	,faire	,se faire
cheveu	,avoir	,porter
sermon	,prononcer	,faire
horreur	,éprouver	,ressentir	,avoir	,éprouver	,ressentir
devinette	,poser
admiration	,avoir	,éprouver	,ressentir
félicitations	,adresser	,exprimer
risque	,courir
cours	,assurer	,dispenser	,donner	,faire
concert	,donner	,se produire
effroi	,avoir	,éprouver	,ressentir
la tête ailleurs	,avoir
corps	,appartenir	,faire partie	,relever	,appartenir	,faire partie	,relever	,avoir	,posséder
tête	,occuper	,être	,figurer
coup de frein	,donner
air	,avoir
vélo tout terrain	,faire
cadavre	,être
distinction	,avoir
mains sales	,avoir
tasse	,boire
carcinome mammaire	,avoir	,souffrir
bouc émissaire	,être	,servir
bougeotte	,avoir
recul	,prendre
tête près du bonnet	,avoir
bouclier humain	,servir	,agir
ciné	,se faire
manche	,actionner	,utiliser
mélancolie	,souffrir	,avoir	,éprouver	,ressentir	,causer	,inspirer	,susciter
curiosité	,avoir	,éprouver	,ressentir
>>>	Cf
serpillière	,éponge
belladone	,médicament	;poison
passé	,futur
églantine	,rose
il	,elle
gavial	,crocodile
batterie	,pile
xénophobie	,hostilité	;intolérance
store	,rideau
poursuite	,procès
alligator	,crocodile
prémolaire	,molaire
climat	,environnement
étrangeté	,anomalie
être	,avoir
yeux dans les yeux	,main dans la main
cœur	,carreau
cervelle	,cerveau
syntaxe	,grammaire
enflammé	,incandescent	,rouge
bouclier	,épée	,glaive
volant	,guidon	,aérien
shampooing	,savon
coupable	,victime	,victime
lune	,mois
timbre	,son	,cloche
jour des Morts	,Toussaint
bas	,chaussettes
porte-monnaie	,portefeuille
main dans la main	,yeux dans les yeux
ingambe	,jambes
moyen	,grand	,petit
mi	,do	,ré	,fa	,sol	,la	,si
avertissement	,sanction
lotus	,nénuphar
bijou	,parure
longueur	,mesure	;point
environnement	,climat
marcher	,nager	,ramper	,voler
abcès	,ampoule
miel	,gelée royale
Toussaint	,jour des Morts
nuque	,tête	;épaules
oxalis	,oseille
corail	,anémone de mer
hélice	,aube
pompe à chaleur	,radiateur
glace	,vitre
perspective	,relief
muscle	,tendon
direction	,destination
seins	,fesses
air	;vent
givre	,neige
lapin	,lièvre
rideau	,store
relief	,perspective
barbouze	,barbe
averse	,orage	;ciel
billet	,argent
selle	,harnais
imprimante	,presse	;scanneur
susceptibilité	,colère
coquillage	,crustacés
placard	,cagibi
paille	,tige
portée	,couvée	,nichée
métro	,chemin de fer	,tramway
échelle	,escabeau
équerre	,règle
nez	,bouche	;gorge
amour	,Vénus
sien	,mien
pasteur	,prêtre	,imam
sec	,déshydraté
hublot	,fenêtre
thé	,café	;tisane
doigt	,sabot
harnais	,selle
foudre	,orage	;tonnerre
unanimité	,majorité
énigme	,problème
planche à pain	,poitrine
pompe	,distributeur
viennoiserie	,pâtisserie
datte	,figue
absolu	,vérité
gelée royale	,miel
annuel	,mensuel	,trimestriel
noyade	,tasse
cravate	,nœud papillon	,écharpe
suite	,derrière
sourire	,rire	,rire
crustacés	,coquillage
talon	,pieds
scanneur	,imprimante
doigts	,aube
imam	,prêtre	,pasteur	,pope
nappe	,serviette
agoraphobe	,ochlophobe	,ochlophobe
>>>	Sing
cartouche	,paquet	,cigarette
raisin	,grain	,raisin	;grappe
ping-pong	,match	,partie	,ping-pong	;rencontre	<compétition	,tournoi
mayo	,flacon	,pot	,tube
végétation	,végétal
bruyère	,brin	;touffe
semaine	,jour
mayonnaise	,flacon	,pot	,tube
escalier	,marche
sport	,compétition	;tournoi	<championnat
soupe	,assiette	,assiettée	;bol
tarte	,part
nouilles	,paquet
encre	,cartouche
yaourt	,pot	,yaourt	<boîte	,pack	,paquet
denture	,dent
ponctuation	,signe de ponctuation
jogging	,jogging
moutarde	;flacon	,pot	,tube	,verre
cornichon	,rondelle	,tranche
glace	,cristal	;glaçon	;bloc	,boule	,pain	;glaçon	;cube de glace
crinière	,crin	,cheveu
marches	,marche
magistrature	,magistrat	,magistrate
musculature	,muscle
tabac	,pied	,paquet	,pot
or	,pépite
bière	,bouteille	,canette	,verre	,bière	,bock	,canette	,chope	,demi	<pinte	<pack
cheveu	,cheveu
boxe	<combat	,match	<compétition	,tournoi	<championnat
titulature	,titre
pâtes	,paquet
appareillage	,appareil
mobiler	,meuble
ligne de titres	,titre
législation	,loi
rock	,rock
chevelure	,cheveu
courrier	,courrier
flottille	,bateau
alcool	,verre	<bouteille
tramway	,ligne
randonnée	,randonnée
huile	,bouteille
laser	,rayon
maladie	,attaque	,crise
poivre	,grain
concombre	,rondelle	,tranche
mâture	,mât
feu	,coup de feu
champagne	,coupe	,flûte	,verre	,champagne	<bouteille
matraquage	,coup de matraque
années	,année
pain	,miette	<bout	,morceau	,tranche
jambon	,tranche
cours	,séance	,cours
groupe	,membre
miel	,pot
lentilles	,boîte	,paquet
espèce chimique	,entité chimique
pelage	,poil
cheveux	,cheveu
muguet	,brin
pharmacopée	,médicament
corolle	,pétales
sucre	;grain	<cuillerée	,pincée	;morceau	,sucre	<pain	;sachet
rugby	,match	,partie	,rugby	;rencontre	<compétition	,tournoi	<championnat
judo	,combat	<compétition	,tournoi	<championnat
rayonnage	,rayon
gymnastique	,séance	;gymnastique	,épreuve	<compétition	<championnat
valetaille	,valet
voirie	,voie
sable	,grain
racaille	,racaille
sauciflard	,rondelle
ski	,championnat	,compétition
beurre	,noisette	,noix	;motte
couettes	,cheveu
maïs	,grain	<boîte
volley-ball	,match	,partie	,volley-ball	;rencontre	<compétition	,tournoi	<championnat
basket	,match	,partie	,basket	;rencontre	<compétition	,tournoi	<championnat
cresson	,botte
branchage	,branche
vin	,verre	<bouteille
papier	,feuille
rabbinat	,rabbin
escalade	,escalade
sel	,grain
pluie	,gouttelette	<goutte
tissu	,cellule	;fibre
averse	,goutte
opéra	,air
lessive	,cuillère	,dose	,poignée	;dosette	,pastille	<baril	,bidon	,boîte	,bouteille	,carton	,flacon	,paquet
métro	,ligne
feuillage	,feuille
ketchup	,bouteille	,flacon
industrie	,industrie
code	,loi
terminologie	,terme
graine de lin	,graine
>>>	Mult
cours	,cours
volcan	,chaîne
bête à bon Dieu	,nuage
musicienne	,ensemble	,groupe	,troupe	,orchestre
égout	,égouts
musicien	,ensemble	,groupe	,troupe	,orchestre
employée	,personnel
bœuf	,cheptel	;troupeau	;bétail
bandit	,bande	,gang	,horde
expert	,comité	,équipe	,groupe
menottes	,paire
patron	,patronat
fleur	,grappe	;inflorescence	;massif	,tapis	;bouquet
jumelle	,jumelles
mouton	,troupeau	,cheptel
sous-vêtement	,sous-vêtement
amour	,amours
Chleuh	,peuple
oiseau	,volée
vache	,troupeau	;cheptel
pompier	,caserne	,caserne
navire	,flotte	,flottille
rabbin	,rabbinat
part	,capital
jumeau	,jumeaux
bateau	,flottille	,flotte
chèvre	,troupeau
mouche	,nuage	,nuée
blues	,blues
lecteur	,lectorat
punaise	,colonie
paysan	,paysannat	,paysannerie
ministre	,gouvernement	,ministère	,cabinet
batracien	,batraciens
loi	,code
chaussettes	,paire
marche	,escalier	,marches
guêpe	,colonie	,essaim	,horde	;nuage	,nuée
pièce de vaisselle	,vaisselle
bruyère	,tapis
courrier	,courrier
éléphant	,troupeau
lettre	,alphabet	,correspondance
voisin	,voisinage
cliente	,clientèle
appareil	,appareillage
corbeau	,bande	,colonie	;nuée	,bande	,colonie	;nuée
pétales	,corolle
personnel	,personnel
herbe	,touffe
seins	,poitrine	;paire
symptôme	,syndrome
paysanne	,paysannat	,paysannerie
jambes	,paire
ciseaux	,paire
tabouret	,rangée
dessous	,dessous
injure	,chapelet
vents	,orchestre	,ensemble
diamant	,rivière
client	,clientèle
chiffon	,tas
jour	,semaine	,semaine	<mois	,mois
outil	,panoplie	,outillage
poussin	,couvée
dent	,dentition	,denture	,dentelure
muguet	,tapis
loup	,bande	,horde	,meute
industrie	,industrie
journaliste	,équipe	,groupe	;horde	,meute	;presse	;équipe	,groupe	;horde	,meute	;presse
datte	,grappe	,régime
criminel	,bande	,gang	;crime organisé	,mafia	,milieu	,pègre	,syndicat du crime
touche	,clavier
pin	,pinède	,pineraie	,pinière
coup de matraque	,matraquage
coup de feu	,feu
musique	,musique	,musique
mât	,mâture
avion	;flotte
cerise	,poignée
faux ami	,lexique	,vocabulaire
oignon	,botte	;filet
végétal	,flore	,végétation
chaise	,rangée
année	,années
dizaine	,chapelet	,chapelet
famille	,mafia
employé	,personnel
abeille	,colonie	,essaim	;horde	,nuage	,nuée
médicament	,pharmacopée
carte	,jeu	,paquet
banane	,régime
nuage	,masse	,amas	,amoncellement	,entassement	;couche
sardine	,banc
racaille	,racaille
meuble	,mobiler
saucisse	,chapelet
poil	,pelage
gendarme	,gendarmerie
saleté	,saleté
>>>	Hypo
instrument à percussion	,tambour
douche	,cabine
cinéma	;parlant	,sonore	,muet	;en 2 dimensions	,en 2D	,en 3 dimensions	,en 3D	,relief	;noir et blanc	,couleur
briquet	,briquet-tempête
moyen de transport	,véhicule flottant	;véhicule roulant	;véhicule volant
mot	,gros mot	,mot magique
plan d’eau	,étang	,lac
véhicule	,automobile	,auto	,voiture	;autocar	,car	,autobus	,bus	;camion	,poids lourd	;camionnette	,fourgonnette
course	;marathon	,semi-marathon	,50 mètres	,100 mètres	,200 mètres	,400 mètres	,800 mètres	,1500 mètres	,5000 mètres	,10 000 mètres	,10 kilomètres	;rallye
cycle	,vélo	,bicyclette	,tricycle	,tandem
champignon	,cèpe
wagon	,wagon-lits	,wagon-restaurant
sens	,ouïe	,vue	,odorat	,goût	,toucher
pantalon	,jean	;patte d’éléphant
siège	;banc	;canapé	;chaise	;fauteuil	;tabouret
émonctoire	,narines
maquillage	,rouge à lèvres
pain	,pain polaire
flûte	,flûte de Pan	,flûte traversière	,flûte à bec
respiration	,petit chien
volley	,volley de plage	,beach-volley	,volley de plage	,beach-volley
eau	,eau de pluie
gâteau	,palet
volume	,cube	,sphère
obstacle	,haie	,rivière
fonction	,dérivée
transports	,transport ferroviaire
bilan	;bilan instrumental	,bilan standardisé	;bilan écologique	;bilan de renouvellement	;bilan d’investigation	,bilan de contrôle	;bilan pré-opératoire	,bilan post-opératoire	;bilan pré-implantation
téléphone	,téléphone portable	,fixe	,mobile	,portable
champ scalaire	,fonction
date	,treize	;trente
biscuit	,pâtisserie
engin de navigation	,bateau
contraceptif	,pilule
voilier	,jonque
canapé	,canapé-lit	,clic-clac	,convertible
geste	,doigt d’honneur
porte	,porte à tambour
sport	,sport aérien	;sport d’hiver	;sport de combat	;sport de glisse	;sport mécanique	;sport nautique
désert	,erg	,reg
document	,enregistrement
champ vectoriel	,fonction
examen	,bac
escargot	,escargot de Bourgogne	,petit-gris
véhicule flottant	,bateau	,navire	,bâtiment
logiciel	,utilitaire	;aspirateur	,gestionnaire
outil	,aiguisoir	,cisaille	,clé	,enclume	,fraise	,marteau	,pelle	,pic	,pince	,pioche	,poinçon	,rabot	,râteau	,scie	,tenailles	,tournevis	,truelle	,vilebrequin
jeu	,larigot
instrument de mesure	,mètre
bateau	,bac	,barge	,bateau-citerne	,bateau-mouche	,brise-glace	,cargo	,chalutier	,drakkar	,ferry	,frégate	,galère	,paquebot	,péniche	,pétrolier	,transbordeur	,vedette	,voilier	,yacht
pierre fine	,grenat
provision	,provision pour risques et charges
pierre précieuse	,diamant	,émeraude	,rubis	,saphir	,diamant
appendice	,antennes
vitesse	,première	,deuxième	,troisième
pompe	,pompe	,pompe
homme de loi	,avocat	,magistrat
évènement	,évènement sportif
saison	,printemps	,été	,automne	,hiver
articulateur	,langue	,lèvres	,mâchoires	,mandibule
dent	,canine	;incisive	;molaire	;prémolaire	,canine	;incisive	;molaire	;prémolaire
épreuve	,bac
savon	,savon de Marseille	,savon d’Alep	,savon blanc	,savon noir
drogue	,herbe
doigt	,auriculaire	,pouce
nucléon	,proton	,neutron
orchestre	,fanfare	,harmonie
connecteur	,implication
signe	,poissons	,taureau
jour	,lundi	,mardi	,mercredi	,jeudi	,vendredi	,samedi	,dimanche
handicap	,patte folle
film	,documentaire	;court métrage	,moyen métrage	,long métrage
coordonnées	,mail
nœud	,nœud de vache
régime réel	,régime réel normal	,régime réel simplifié
parties intimes	,partie
nage	,brasse	,brasse-papillon	,crawl	,dos	,dos brassé	,dos crawlé	,nage indienne
champ	,objet
signe de ponctuation	,point	,point d’exclamation	,virgule
particule subatomique	,proton	,électron	,neutron
marsupial	,kangourou
matière	,matière ordinaire	,matière noire	,antimatière
violon	,alto	,violon alto
saint	,saint patron
guitare	,guitare sèche	;guitare électrique
appartement	,meublé	;penthouse	;garçonnière	;studio	;loft	;duplex	;triplex	;quadruplex	,une-pièce	;F1	,T1	;deux-pièces	,F2	,T2	;trois-pièces	,F3	,T3	;quatre-pièces	,F4	,T4	;cinq-pièces	,F5	,T5	;six-pièces	,F6	,T6	;sept-pièces	,F7	,T7	;huit-pièces	,F8	,T8	;neuf-pièces	,F9	,T9	;dix-pièces	,F10	,T10
tâche ménagère	,ménage	,repassage
sacrement	,baptême
niveau d’articulation	,première articulation	,deuxième articulation	,troisième articulation
crotte	,fiente	,crottin
discipline	,sport	,sprint
dispositif	,additionneur
piano	,piano droit	,piano à queue	,piano crapaud
particule	,particule subatomique
message	,courriel	,sms
cartilage	,cricoïde	,aryténoïde
sexualité	,sexualité de groupe
arme blanche	,épée
navire	,brise-glace	,cargo	,chalutier	,drakkar	,ferry	,frégate	,galère	,navire-usine	,paquebot	,pétrolier	,transbordeur	,yacht	;contre-torpilleur	,cuirassé	,porte-avions	,torpilleur
cimetière	,tombe
>>>	Fact_2
bouchon	,boucher	,obstruer
aide	,aider	,aider
mécanicienne	,conduire
administrateur	,administrer
trieuse	,trier
journaliste	,couvrir	;enquêter	,couvrir	;enquêter
accompagnatrice	,accompagner	,accompagner
présure	,cailler
semeur	,semer
semeuse	,semer
savon	,laver	,nettoyer	,laver	,nettoyer
administratrice	,administrer
chat	,attraper	;toucher
opéra	,donner
accusateur	,accuser
médecin	,examiner	;s’occuper	;soigner	,traiter	,examiner	;s’occuper	;soigner	,traiter
guirlande	,agrémenter	,embellir
caractéristique	,caractériser
boulangère	,faire	;préparer
chercheur	,chercher
agresseur	,agresser
bouchère	,couper	,découper	;débiter	;dépecer
représentation	,représenter
collectionneur	,collectionner
père	,élever	,s’occuper	,prendre soin	,s’occuper	,prendre soin
voiture	,transporter
chasseur	,chasser
tempête	,s’abattre	;balayer	;frapper
factrice	,fabriquer
garante	,garantir
avion	,transporter
arbitre	,arbitrer
acheteuse	,acheter
tornade	,bousculer	,secouer	<dévaster	,secouer
tyran	,tyranniser
soleil	,illuminer
commentatrice	,commenter
tramway	,desservir
parasite	,profiter	,profiter
bus	,transporter
ennemi	,détester	;nuire	,combattre	,lutter	;s’opposer	;nuire
bocal	,contenir
boulanger	,faire	;préparer
nappe	,recouvrir
criminel	,commettre	,se livrer
bol	,contenir
mère	,élever	,s’occuper	,prendre soin	;allaiter	,donner le sein	,nourrir	,s’occuper	,prendre soin
combattant	,combattre	,se battre
pluie	,mouiller	,arroser	<laver	<tremper	,détremper	,lessiver	,doucher	<noyer	;transpercer	,traverser	,pénétrer	;alimenter
four	,cuire	,brûler
camionnette	,transporter
garant	,garantir
avocat	;conseiller	;représenter	;défendre	,défendre	;lutter	,militer
ami	,aider	;protéger	,aider	;encourager	;protéger
accompagnement	,accompagner
dentifrice	,laver	,nettoyer
concepteur	,concevoir
dent	,mordre	;croquer	;broyer	,s’emboîter	,broyer	,déchirer
bateau	,transporter
autocar	,transporter
étagère	,supporter
chanteur	,chanter
accompagnateur	,accompagner	,accompagner
muscle	,mouvoir
triangle	,signaler
barbier	,raser
dents	,couper	,scier	;broyer
camion	,acheminer	,transporter
boucher	,couper	,découper	;débiter	;dépecer
coiffeuse	,coiffer	;couper les cheveux
acheteur	,acheter
couleur	,colorer
commentateur	,commenter
conceptrice	,concevoir
car	,transporter
agresseuse	,agresser
voyou	,agresser	,tabasser	;racketter	,voler
bastion	,protéger
aspirateur	,aspirer	;avaler	,absorber	,aspirer	,absorber	,avaler
facteur	,fabriquer
composant	,composer
chasseresse	,chasser
peloton de tête	,mener
navire	,transporter
mécanicien	,créer	,inventer
avocate	,conseiller	;représenter	;défendre	,défendre	;lutter	,militer
arracheur	,arracher
casserole	,contenir
chanteuse	,chanter
hélicoptère	,transporter
véhicule	,véhiculer	,transmettre
vague	,frapper	,heurter	;submerger
trieur	,trier
combattante	,combattre	,se battre
accusatrice	,accuser
chasseuse	,chasser
coiffeur	,coiffer	;couper les cheveux
bandit	,commettre	,se livrer
orchestre	,jouer	,interpréter	;repéter
vétérinaire	,examiner	;s’occuper	;soigner	,traiter	,examiner	;s’occuper	;soigner	,traiter
>>>	SingS_1
États-Unis	,Américain	,Américaine	;États-unien	,États-unienne
active	,actif
portugais	,Portugais	,Portugaise	;lusophone	,lusophone
restaurant	,serveur	,serveuse
germanique	,Germanique	,Germanique
poissons	,poisson
patronat	,patron	,patronne
pineraie	,pin
ballet	,danseur	,danseuse
chinois	,Chinois	,Chinoise	;sinophone	,sinophone
pays	,habitant	,habitante	;citoyen	,citoyenne	,pays
bordel	,prostituée
français	,Français	,Française	;francophone	,francophone
espagnol	,Espagnol	,Espagnole	;hispanophone	,hispanophone
fratrie	,frère	,sœur
marine	,marin
centre aéré	,enfant
Irlande	,Irlandais	,Irlandaise
Triangle	,étoile
équipage	,membre
angliche	,Angliche
mairie	,conseiller municipal	,conseillère municipale
Corée du Sud	,Sud-Coréen	,Sud-Coréenne
gallois	,Gallois	,Galloise
gens	,personne	,individu
gouvernement	,ministre
œuvre	,œuvre
Portugal	,Portugais	,Portugaise
faune	,animal
coréen	,Coréen	,Coréenne
paysannerie	,paysan	,paysanne
anglais	,Anglais	,Anglaise	;anglophone	,anglophone
suédois	,Suédois	,Suédoise
reptiles	,reptile
enfance	,enfant	,enfant
carré	,fantassin	,soldat	,femme soldat	,militaire	,militaire
Grande-Bretagne	,Britannique	,Britannique
Italie	,Italien	,Italienne
forêt	,arbre
famille	,membre	;parent	,membre	,membre	,membre	,membre	,mafioso
boche	,Boche	,Boche
Corée	,Coréen	,Coréenne
nippon	,Nippon	,Nippone
noms	,noms
synagogue	,rabbin
flore	,végétal
pinède	,pin
turc	,Turc	,Turque
clavier	,touche
portée	,petit
pinière	,pin
équipe	,membre
Belgique	,Belge	,Belge
russe	,Russe	,Russe	;russophone	,russophone
Chine	,Chinois	,Chinoise
occupant	,occupant
Nouvelle-Zélande	,Kiwi
personnel	,employé	,employée	,membre	,personnel
oiseaux	,oiseaux	,oiseau
vers	,ver
Corée du Nord	,Nord-Coréen	,Nord-Coréenne
Bretagne	,Breton
brosserie	,brosse
émigration	,émigré	,émigrée
conseil municipal	,conseiller municipal	,conseillère municipale	,conseiller municipal	,conseillère municipale
aire de jeux	,enfant	,enfant
Australie	,Australien	,Australienne
italien	,Italien	,Italienne
lexique	;mot	;lexème
allemand	,Allemand	,Allemande	;germanophone	,germanophone
direction	,directeur	,directrice
visite	,visiteur	,visiteuse	;participant	,participante
japonais	,Japonais	,Japonaise
insectes	,insecte
breton	,Breton	,Bretonne
grec	,Grec	,Grecque
collection	,vêtement
bureau	,secrétaire	,trésorier	,trésorière	,employé	,employée	,collègue	;collègue
putsch	,putschiste
Canada	,Canadien	,Canadienne
électorat	,électeur	,électrice
lectorat	,lecteur	,lectrice
paysannat	,paysan	,paysanne
Allemagne	,Allemand	,Allemande
Amérique	,Américain	,Américaine	,Américain
orchestre	,musicien	,musicienne
Moyen-Âge	,médiéval
maison close	,prostituée
Turquie	,Turc	,Turque
gorge chaude	,rapace
table	,convive	,convive	,serveur	,serveuse	;cuisinier	,cuisinière	;chef
chleuh	,Chleuh	,Chleuh	,Chleuh
exemplier	,exemple
Japon	,Japonais	,Japonaise	,Nippon	,Nippone
réserve	,réserviste	,réserviste
trésor	,trésor
fichier	,fiche
théâtre	,comédien	,comédienne	,acteur	,actrice
Espagne	,Espagnol	,Espagnole
salariat	,salarié	,salariée
>>>	Syn_⊂^sex
suppliante	,suppliant
médecin	,médecin
menteuse	,menteur
Américaine	,Américain	,Américain
résidente	,résident
goûteuse	,goûteur
chieuse	,chieur
apicultrice	,apiculteur
protectrice	,protecteur
montreuse	,montreur
joggeuse	,joggeur
immigrée	,immigré
apprenante	,apprenant
entêtée	,entêté
chasseresse	,chasseur
blanchisseuse	,blanchisseur
savante	,savant
commerçante	,commerçant
dramaturge	,dramaturge
ado	,ado	,adolescent
optimiste	,optimiste
amatrice	,amateur
sondée	,sondé
tisseuse	,tisseur
maniaque	,maniaque
secouriste	,secouriste
parlementaire	,parlementaire
blagueuse	,blagueur
misogyne	,misogyne
kidnappeuse	,kidnappeur
guide	,guide
députée	,député
méchante	,méchant
sportive	,sportif
baroudeuse	,baroudeur
droitière	,droitier
payse	,pays
indiscrète	,indiscret
agressée	,agressé
téléspectatrice	,téléspectateur
témoin	,témoin
compagne de route	,compagnon de route
petite amie	,petit ami
empotée	,empoté
éducatrice	,éducateur	,éduc	,éducateur
caravanière	,caravanier	,caravanier
rugbyman	,rugbyman
employée	,employé
Chleuh	,Chleuh	,Chleuh
universitaire	,universitaire	,universitaire
jardinière	,jardinier
russophone	,russophone
cueilleuse	,cueilleur
bossue	,bossu
piétonne	,piéton
gérante	,gérant
paresseuse	,paresseux
exploitante	,exploitant
cyclotouriste	,cyclotouriste
constructrice	,constructeur
promeneuse	,promeneur
bijoutière	,bijoutier
interprète	,interprète	,interprète
metteur en scène	,metteur en scène
Canadienne	,Canadien
juive	,juif
bienheureuse	,bienheureux
accusatrice	,accusateur
passante	,passant
dirlo	,dirlo
festivalière	,festivalier
laveuse	,laveur	,laveur
générale	,général
religieuse	,religieux
timide	,timide
malheureuse	,malheureux
météorologue	,météorologue
camarade	,camarade
supportrice	,supporter
conne	,con
étourdie	,étourdi
émettrice	,émetteur	,émetteur	,émetteur
femme médecin	,médecin
rouge	,rouge
rabat-joie	,rabat-joie
habitante	,habitant	,habitant
formatrice	,formateur
Suisse	,Suisse
gagnante	,gagnant
sans domicile fixe	,sans domicile fixe
incendiaire	,incendiaire
législatrice	,législateur
unijambiste	,unijambiste
pipière	,pipier
banquière	,banquier
randonneuse	,randonneur
gourmande	,gourmand
favorite	,favori
lâche	,lâche
conceptrice	,concepteur
