débattre : Débat
s’adapter : Adaptation
facial : Expression
barrir : Barrière
remercier : Merci
cordialement : Cordialité
universel : Univers
frimer : Honte
hétérosexuel : Sexualité
diabolique : Diable
pierreux : Pierre
défense : Défendue
sucer : Sein
adapter : Adaptation
australien : Australie
allergique : Allergène
avancement : Avance
scier : Scie
évènementiel : Événement
hoqueter : Hou Hou
poétiquement : Poésie
exploiter : Ressource
hésiter : Hésitation
glorieusement : Glorie
individuel : Personne
préparer : Préparation
réhabiliter : Réforme
villageois : Village
affronter : Confrontation
commencer : Début
chrétien : Église
s’habiller : Vêtement
briser : Fragilité
d’amour : Amour
se tenir : Prise
fournir : Approvisionnement
raccrocher : Cable
innocemment : Innocence
comptable : Compte
gestionnaire : Gestion
costal : Côte
barrer : Barrière
kaki : Pomme
emprunter : Prêt
choisir : Sélection
embrasser : Baiser
terreux : Terre
suédois : Suède
naturellement : Nature
bizarrement : Étrangeté
mémoriel : Mémorial
interrompre : Pausage
marinier : Marine
triompher : Victoire
voussoyer : Voûte
central : Centre
putschiste : Coup
contrôlant : Contrôle
violer : Loi
dépasser : Limite
agir : Action
musicalement : Musique
juger : Sentence
poursuivre : Chasse
grincer : Crépitement
résonner : Écho
temporal : Temps
rhytmique : Rythme
écologique : Environnement
prolonger : Durée
Compliments : Fleur
débiter : Débit
vestimentairement : Vêtement
héroïquement : Action
délictueux : Crime
féliciter : Felicitations
affirmer : Déclaration
gratter : Crête
clore : Fleur
critique : Rapport
se manifester : Apparition
s’indigner : Colère
sourire : Smile
alimenter : Nourriture
grec : Greece
dire : Parole
ionique : Acid
hypothétiquement : Hypothèse
urger : Urge
combattre : Bataille
futur : Époque
exaspérer : Fureur
bactérien : Bacille
s’évader : Fuite
se tasser : Nappe
allonger : Branche
progresser : Cheminement
contribuer : Aide
additionner : Somme
apprécier : Prise
